geoid,tot.pop18,male.pop18,fem.pop18,med.inc18,mean.inc18,mean.inc18.moe,zcta
8600000US00601,13491,6518,6973,13092,18893,1780,00601
8600000US00602,31121,15101,16020,16358,25019,1706,00602
8600000US00603,38794,18637,20157,16603,28089,2197,00603
8600000US00606,5185,2580,2605,12832,16419,1814,00606
8600000US00610,21766,10375,11391,19309,26909,1770,00610
8600000US00612,48085,21972,26113,18171,25370,1372,00612
8600000US00616,9033,4365,4668,16018,24096,3644,00616
8600000US00617,18790,8700,10090,16735,23260,1906,00617
8600000US00622,5690,2504,3186,15206,30086,9805,00622
8600000US00623,33833,15940,17893,16280,24191,1641,00623
8600000US00624,17413,8404,9009,17578,24897,1681,00624
8600000US00627,25844,12235,13609,16831,26926,2839,00627
8600000US00631,1327,644,683,9681,16698,4398,00631
8600000US00637,18256,8387,9869,16887,25245,1954,00637
8600000US00638,13121,6310,6811,14916,22000,2880,00638
8600000US00641,22068,10566,11502,16795,22726,1480,00641
8600000US00646,28963,13599,15364,29320,47960,3986,00646
8600000US00647,4631,2351,2280,13674,17027,1931,00647
8600000US00650,11562,5508,6054,19631,24338,2403,00650
8600000US00652,2872,1414,1458,21650,27835,4173,00652
8600000US00653,8653,3924,4729,12915,18700,2854,00653
8600000US00656,14864,7015,7849,16902,23295,1480,00656
8600000US00659,32416,15304,17112,17201,27665,2203,00659
8600000US00660,13282,5993,7289,19394,27632,3085,00660
8600000US00662,32219,15382,16837,17180,24342,1830,00662
8600000US00664,11593,5699,5894,15253,20670,2297,00664
8600000US00667,19181,9214,9967,13766,19838,1683,00667
8600000US00669,20489,9955,10534,14816,22513,2484,00669
8600000US00670,6725,3311,3414,13427,20065,2816,00670
8600000US00674,31518,14559,16959,19211,27906,1762,00674
8600000US00676,28967,13986,14981,14146,23261,3343,00676
8600000US00677,11704,5572,6132,21673,28509,2654,00677
8600000US00678,20734,9827,10907,16200,24348,2978,00678
8600000US00680,38508,17847,20661,13911,24073,1873,00680
8600000US00682,25931,12415,13516,15029,28033,2126,00682
8600000US00683,24528,11644,12884,15523,24587,2334,00683
8600000US00685,30524,14721,15803,14617,22279,2201,00685
8600000US00687,24360,11967,12393,20589,27362,1907,00687
8600000US00688,10002,5127,4875,17231,23143,1826,00688
8600000US00690,4417,1941,2476,17622,25981,4389,00690
8600000US00692,27839,13054,14785,19094,33845,3318,00692
8600000US00693,43235,20285,22950,19119,27788,1666,00693
8600000US00694,69,41,28,,,,00694
8600000US00698,29116,13666,15450,15019,21994,1059,00698
8600000US00703,20969,10040,10929,17129,26613,3135,00703
8600000US00704,6277,3012,3265,14293,19703,2551,00704
8600000US00705,18483,8728,9755,19516,27468,2458,00705
8600000US00707,8790,4276,4514,19596,25494,4456,00707
8600000US00714,13954,6309,7645,17095,21803,1971,00714
8600000US00715,2424,1177,1247,13070,17954,4308,00715
8600000US00716,22758,10401,12357,18818,34864,3919,00716
8600000US00717,13054,5694,7360,12251,23360,1930,00717
8600000US00718,19709,9119,10590,19318,24985,2150,00718
8600000US00719,23067,11201,11866,19757,25912,1946,00719
8600000US00720,16540,8137,8403,13408,20729,2101,00720
8600000US00723,13992,6751,7241,15826,22598,2056,00723
8600000US00725,64421,28903,35518,20920,32734,1558,00725
8600000US00727,43697,20246,23451,31401,44456,3020,00727
8600000US00728,31770,15734,16036,19047,26589,1614,00728
8600000US00729,40493,19040,21453,20920,32349,2543,00729
8600000US00730,24844,11840,13004,15431,27953,3301,00730
8600000US00731,9924,4758,5166,17083,28562,5822,00731
8600000US00735,10014,4533,5481,19184,32298,6847,00735
8600000US00736,38416,18449,19967,21000,30071,1442,00736
8600000US00738,24135,11035,13100,19404,29302,3028,00738
8600000US00739,28765,13603,15162,20098,30552,2034,00739
8600000US00740,1188,527,661,13136,16074,3110,00740
8600000US00741,3998,1729,2269,22073,26864,3130,00741
8600000US00745,40946,19459,21487,22782,30823,1828,00745
8600000US00751,16374,7675,8699,17567,23747,1775,00751
8600000US00754,30167,14522,15645,18895,27659,2140,00754
8600000US00757,16927,8010,8917,17640,27372,2750,00757
8600000US00765,6867,3432,3435,15271,22694,3312,00765
8600000US00766,18017,8620,9397,19746,29675,5059,00766
8600000US00767,27244,12966,14278,15999,22901,1791,00767
8600000US00769,30791,14715,16076,19928,27878,1908,00769
8600000US00771,29259,13696,15563,21499,30202,2537,00771
8600000US00772,15585,7067,8518,15658,21300,1376,00772
8600000US00773,14734,6835,7899,20829,29220,2077,00773
8600000US00775,1034,512,522,23281,27801,3545,00775
8600000US00777,31174,14543,16631,19139,25608,1502,00777
8600000US00778,36583,17053,19530,33763,49325,4851,00778
8600000US00780,8726,3969,4757,24287,39409,8272,00780
8600000US00782,14281,6999,7282,12492,17780,1557,00782
8600000US00783,26051,12472,13579,14748,21241,1553,00783
8600000US00784,31956,15598,16358,16680,25005,2164,00784
8600000US00786,348,177,171,,32691,14662,00786
8600000US00791,38800,18105,20695,19793,31091,3223,00791
8600000US00794,22075,10729,11346,15970,22969,2497,00794
8600000US00795,34640,16237,18403,20700,29181,2065,00795
8600000US00901,5705,3130,2575,20943,66882,12542,00901
8600000US00906,170,94,76,102917,95583,25897,00906
8600000US00907,14267,6880,7387,33167,67930,8801,00907
8600000US00909,4065,1875,2190,16875,30136,3803,00909
8600000US00911,6297,2896,3401,32833,56272,8089,00911
8600000US00912,4849,2164,2685,22268,37092,5253,00912
8600000US00913,5247,2044,3203,6878,18381,4039,00913
8600000US00915,20841,9918,10923,13839,21287,3163,00915
8600000US00917,15319,7081,8238,14307,29188,6772,00917
8600000US00918,13163,5948,7215,23434,41252,3652,00918
8600000US00920,13913,6241,7672,25841,34757,2402,00920
8600000US00921,26733,11401,15332,19358,30302,2705,00921
8600000US00923,19184,8281,10903,14241,24911,4504,00923
8600000US00924,37799,15761,22038,18832,31658,2293,00924
8600000US00925,6372,2989,3383,9468,21623,6703,00925
8600000US00926,78332,35082,43250,34781,59260,2931,00926
8600000US00927,11451,5288,6163,33502,54472,5416,00927
8600000US00934,60,26,34,,,,00934
8600000US00936,812,312,500,,,,00936
8600000US00949,58971,27084,31887,26392,35713,1708,00949
8600000US00950,0,0,0,,,,00950
8600000US00951,0,0,0,,,,00951
8600000US00952,6362,2820,3542,14911,21856,2193,00952
8600000US00953,55895,26486,29409,29146,42449,1952,00953
8600000US00956,52809,24319,28490,23149,31000,1207,00956
8600000US00957,31029,13597,17432,24612,34386,1719,00957
8600000US00959,38130,16757,21373,30049,40487,2406,00959
8600000US00960,2184,2150,34,,,,00960
8600000US00961,25657,12220,13437,29197,42875,2806,00961
8600000US00962,15062,6986,8076,16062,25927,1761,00962
8600000US00965,5926,2806,3120,14821,25662,7250,00965
8600000US00966,12868,5694,7174,47315,84157,11648,00966
8600000US00968,3103,1234,1869,48175,77584,11049,00968
8600000US00969,34745,15643,19102,51910,77646,5078,00969
8600000US00971,21963,11153,10810,20608,36003,4510,00971
8600000US00976,46722,21063,25659,31304,43468,2671,00976
8600000US00979,14160,6810,7350,36270,60134,6313,00979
8600000US00982,11611,5031,6580,24970,31817,2150,00982
8600000US00983,28315,12399,15916,26259,34298,1535,00983
8600000US00985,25423,11111,14312,25338,34030,1736,00985
8600000US00987,44795,20418,24377,33042,43558,2464,00987
8600000US01001,14325,6514,7811,62144,78870,4937,01001
8600000US01002,26349,12778,13571,55858,85653,5028,01002
8600000US01003,11172,5749,5423,,,,01003
8600000US01005,3963,1992,1971,68278,94293,10094,01005
8600000US01007,11620,5492,6128,93300,114222,7773,01007
8600000US01008,1027,539,488,75250,85155,9029,01008
8600000US01009,249,134,115,81250,77654,27532,01009
8600000US01010,2984,1444,1540,84471,98962,12492,01010
8600000US01011,1185,603,582,64904,77938,10003,01011
8600000US01012,473,241,232,64091,79291,15316,01012
8600000US01013,17991,8170,9821,40594,55988,3971,01013
8600000US01020,24688,12030,12658,58226,70381,3837,01020
8600000US01022,2064,995,1069,41863,52661,6688,01022
8600000US01026,753,366,387,55268,68135,8232,01026
8600000US01027,15089,7168,7921,62772,81225,6894,01027
8600000US01028,12755,5844,6911,88442,103313,7591,01028
8600000US01029,548,266,282,72813,82166,19103,01029
8600000US01030,8837,4301,4536,74139,92404,6569,01030
8600000US01031,961,514,447,42188,63356,12122,01031
8600000US01032,424,191,233,80500,79783,9701,01032
8600000US01033,5257,2529,2728,95987,106998,14152,01033
8600000US01034,1782,898,884,84926,96256,6224,01034
8600000US01035,4494,1915,2579,64276,96514,17069,01035
8600000US01036,4265,2077,2188,85943,104410,10253,01036
8600000US01037,606,354,252,96302,101734,17160,01037
8600000US01038,2401,1181,1220,66818,82873,8920,01038
8600000US01039,927,402,525,77679,99023,18196,01039
8600000US01040,30898,14530,16368,40656,58425,2778,01040
8600000US01050,1947,997,950,63427,75890,7491,01050
8600000US01053,1442,772,670,59074,80090,15452,01053
8600000US01054,1614,791,823,91500,124037,11785,01054
8600000US01056,17354,9110,8244,72040,84787,5010,01056
8600000US01057,7049,3432,3617,82444,94287,5241,01057
8600000US01060,13717,5225,8492,60020,85478,5921,01060
8600000US01062,8042,3896,4146,73954,96383,8995,01062
8600000US01063,587,13,574,,,,01063
8600000US01066,9,9,0,,,,01066
8600000US01068,1516,758,758,84375,97402,6846,01068
8600000US01069,7332,3559,3773,63398,76135,5212,01069
8600000US01070,498,249,249,53750,70856,9940,01070
8600000US01071,1054,469,585,75491,82176,9012,01071
8600000US01072,1210,588,622,78696,90739,8218,01072
8600000US01073,4999,2499,2500,93854,118405,16451,01073
8600000US01074,403,131,272,64840,69852,17406,01074
8600000US01075,15309,5814,9495,65898,83301,4732,01075
8600000US01077,7744,3873,3871,77734,95372,7788,01077
8600000US01079,515,275,240,31875,63468,27148,01079
8600000US01080,2114,973,1141,58139,69715,13393,01080
8600000US01081,1472,703,769,54647,69192,7884,01081
8600000US01082,8396,4092,4304,54107,68449,4595,01082
8600000US01083,2346,1198,1148,70288,74678,15112,01083
8600000US01084,145,86,59,83750,111520,40906,01084
8600000US01085,34105,16231,17874,64026,82468,3462,01085
8600000US01086,372,185,187,,,,01086
8600000US01088,377,151,226,47232,54022,15531,01088
8600000US01089,22475,11128,11347,51472,72502,4206,01089
8600000US01092,1178,526,652,79907,89246,21664,01092
8600000US01093,242,125,117,89643,136228,44249,01093
8600000US01094,262,126,136,25104,46300,16732,01094
8600000US01095,11708,5486,6222,107361,128416,11398,01095
8600000US01096,2191,1069,1122,83080,100853,12531,01096
8600000US01097,24,6,18,,37067,22845,01097
8600000US01098,1023,491,532,78393,90288,9087,01098
8600000US01103,2024,887,1137,18338,36617,6436,01103
8600000US01104,17612,8189,9423,31113,50060,4932,01104
8600000US01105,8876,4286,4590,19921,29784,2927,01105
8600000US01106,12334,5720,6614,111545,150501,13195,01106
8600000US01107,7744,3573,4171,27131,42553,4014,01107
8600000US01108,20063,9364,10699,40915,55405,3673,01108
8600000US01109,22795,10483,12312,34329,46688,2337,01109
8600000US01118,11362,5183,6179,61786,78442,5295,01118
8600000US01119,10842,4793,6049,44091,60776,5700,01119
8600000US01128,2232,1156,1076,61875,82404,13930,01128
8600000US01129,5440,2536,2904,61645,71121,5918,01129
8600000US01151,6344,2920,3424,41002,50188,4171,01151
8600000US01199,0,0,0,,,,01199
8600000US01201,36249,17055,19194,49385,67687,2629,01201
8600000US01220,6765,3325,3440,49301,64283,4536,01220
8600000US01222,696,318,378,69432,73801,13850,01222
8600000US01223,2020,1024,996,75852,93111,9024,01223
8600000US01224,202,76,126,37576,34156,14842,01224
8600000US01225,2713,1411,1302,68264,77583,9718,01225
8600000US01226,5619,2515,3104,59875,82283,9388,01226
8600000US01229,70,50,20,,32656,15654,01229
8600000US01230,6883,3364,3519,67674,86181,9083,01230
8600000US01235,2194,1113,1081,66581,82428,6692,01235
8600000US01236,940,492,448,65833,103014,32649,01236
8600000US01237,2005,1013,992,78194,89514,12244,01237
8600000US01238,4767,2347,2420,72744,88539,7915,01238
8600000US01240,3914,1804,2110,72766,103514,15181,01240
8600000US01242,332,170,162,85789,83180,19849,01242
8600000US01243,247,109,138,69167,100414,36592,01243
8600000US01244,64,33,31,55417,64115,30978,01244
8600000US01245,729,360,369,75167,113087,19221,01245
8600000US01247,12752,6183,6569,41807,58425,4611,01247
8600000US01253,611,309,302,77375,94443,10417,01253
8600000US01254,891,462,429,85313,137232,25411,01254
8600000US01255,783,416,367,69135,95760,10730,01255
8600000US01256,595,334,261,60197,74963,7718,01256
8600000US01257,1775,912,863,94625,114738,24123,01257
8600000US01258,439,243,196,67500,86125,17349,01258
8600000US01259,507,240,267,60625,114977,24908,01259
8600000US01260,360,126,234,115208,97512,33794,01260
8600000US01262,1001,334,667,31144,70993,22740,01262
8600000US01264,174,68,106,66875,129121,37888,01264
8600000US01266,1144,578,566,71989,99441,13740,01266
8600000US01267,6767,3010,3757,82863,106997,11657,01267
8600000US01270,648,325,323,83333,112009,19765,01270
8600000US01301,14508,7145,7363,49312,65267,4112,01301
8600000US01330,1185,613,572,71346,97618,13157,01330
8600000US01331,10736,5031,5705,57164,68944,3886,01331
8600000US01337,1998,960,1038,67470,84012,6813,01337
8600000US01338,110,51,59,60625,65634,22495,01338
8600000US01339,1186,555,631,61500,75316,9867,01339
8600000US01340,1479,693,786,55980,72255,8677,01340
8600000US01341,1472,728,744,100417,125683,16213,01341
8600000US01342,1163,499,664,77202,99663,26502,01342
8600000US01343,38,19,19,76250,69458,25386,01343
8600000US01344,1167,541,626,61359,71300,5800,01344
8600000US01346,350,152,198,63036,79080,11210,01346
8600000US01347,160,23,137,54250,60591,20270,01347
8600000US01349,1003,492,511,64219,73824,11066,01349
8600000US01350,68,34,34,26458,41919,14538,01350
8600000US01351,1772,853,919,78849,85970,11928,01351
8600000US01354,1393,744,649,67083,84268,11999,01354
8600000US01355,780,412,368,68250,84343,11043,01355
8600000US01360,2403,1205,1198,72083,89564,11868,01360
8600000US01364,6324,3000,3324,46405,62725,5268,01364
8600000US01366,1095,487,608,68405,86021,9127,01366
8600000US01367,448,216,232,54500,67150,10877,01367
8600000US01368,991,501,490,72083,82135,10263,01368
8600000US01370,3463,1626,1837,57083,84279,20028,01370
8600000US01373,3761,1821,1940,73639,101267,19338,01373
8600000US01375,3124,1540,1584,61102,84851,25703,01375
8600000US01376,4282,1859,2423,41496,59821,9437,01376
8600000US01378,647,313,334,56250,67686,5526,01378
8600000US01379,711,366,345,44531,68530,20311,01379
8600000US01420,31631,15776,15855,55277,69203,3165,01420
8600000US01430,4766,2224,2542,97561,113980,13470,01430
8600000US01431,2595,1345,1250,101357,107607,9355,01431
8600000US01432,6246,3116,3130,91156,103949,8191,01432
8600000US01434,1646,1434,212,66477,103693,32075,01434
8600000US01436,2556,1328,1228,58458,81575,19219,01436
8600000US01438,490,287,203,117917,103009,31160,01438
8600000US01440,16515,8550,7965,50239,66620,4836,01440
8600000US01450,8615,4269,4346,126883,150606,13399,01450
8600000US01451,3405,1694,1711,155515,197465,26974,01451
8600000US01452,3674,1791,1883,95530,105091,8216,01452
8600000US01453,32545,15241,17304,58205,76754,3325,01453
8600000US01460,7625,3598,4027,120638,143603,9607,01460
8600000US01462,8693,4047,4646,101510,113569,9124,01462
8600000US01463,9324,4579,4745,96750,119833,9938,01463
8600000US01464,6572,3976,2596,70542,99016,13112,01464
8600000US01467,316,110,206,96806,135641,90706,01467
8600000US01468,3372,1547,1825,70438,89960,14843,01468
8600000US01469,5765,2869,2896,83602,102455,10336,01469
8600000US01473,5999,2996,3003,98714,113449,11405,01473
8600000US01474,1488,732,756,96750,136120,34226,01474
8600000US01475,8203,4073,4130,71895,84674,9424,01475
8600000US01501,13569,6593,6976,83441,99167,4495,01501
8600000US01503,2505,1247,1258,104063,132350,16722,01503
8600000US01504,7199,3389,3810,86513,99879,7370,01504
8600000US01505,3573,1660,1913,98520,119053,10686,01505
8600000US01506,2732,1401,1331,68125,90221,11636,01506
8600000US01507,10444,4600,5844,97805,110976,8949,01507
8600000US01510,11122,5520,5602,66094,83269,6038,01510
8600000US01515,1705,872,833,84444,89692,6875,01515
8600000US01516,6529,3220,3309,95567,104320,5970,01516
8600000US01518,2758,1242,1516,64732,100478,18422,01518
8600000US01519,5162,2525,2637,106644,130158,12502,01519
8600000US01520,11950,5641,6309,105772,123838,5632,01520
8600000US01521,2015,1046,969,81680,95053,8164,01521
8600000US01522,2355,1085,1270,101089,127360,25134,01522
8600000US01523,6156,3669,2487,103857,116842,17607,01523
8600000US01524,5833,2670,3163,71645,92142,16208,01524
8600000US01525,276,148,128,40888,51491,19150,01525
8600000US01527,10860,5259,5601,81804,104680,9801,01527
8600000US01529,2455,1113,1342,78704,98656,9977,01529
8600000US01531,998,506,492,89167,107679,15661,01531
8600000US01532,11482,5385,6097,113608,154347,12277,01532
8600000US01534,5026,2459,2567,92181,114506,11652,01534
8600000US01535,3819,1821,1998,73599,85607,7124,01535
8600000US01536,5959,2744,3215,108175,124935,10533,01536
8600000US01537,1818,824,994,76389,78072,9850,01537
8600000US01540,8832,4542,4290,68750,83768,6891,01540
8600000US01541,2724,1343,1381,134191,165998,18211,01541
8600000US01542,1818,867,951,107806,111247,16513,01542
8600000US01543,6390,3319,3071,104050,112333,8063,01543
8600000US01545,27917,13399,14518,106108,129554,5196,01545
8600000US01550,13263,6581,6682,50787,62978,3417,01550
8600000US01560,3276,1634,1642,79583,111389,12227,01560
8600000US01561,269,166,103,,85720,38049,01561
8600000US01562,9954,5126,4828,71830,78836,5340,01562
8600000US01564,6248,3122,3126,107348,137440,15039,01564
8600000US01566,4307,1907,2400,100600,125087,15628,01566
8600000US01568,5716,2877,2839,123942,146652,13757,01568
8600000US01569,10803,5410,5393,101266,108745,6355,01569
8600000US01570,13500,6273,7227,57924,73864,5733,01570
8600000US01571,9204,4275,4929,67117,89644,8067,01571
8600000US01581,13956,6893,7063,108767,139391,7240,01581
8600000US01583,6679,4344,2335,79375,107040,10563,01583
8600000US01585,3802,1875,1927,68578,85963,9459,01585
8600000US01588,7370,3454,3916,75495,91039,8925,01588
8600000US01590,7083,3367,3716,102439,124900,8560,01590
8600000US01602,19884,9193,10691,61710,81485,3968,01602
8600000US01603,15119,7425,7694,38701,59029,4800,01603
8600000US01604,29231,14739,14492,53270,69097,3312,01604
8600000US01605,21595,10176,11419,37857,55155,3830,01605
8600000US01606,15865,7294,8571,66130,82004,6526,01606
8600000US01607,6865,3271,3594,46974,57551,5444,01607
8600000US01608,2774,1251,1523,24181,33694,5388,01608
8600000US01609,18898,9666,9232,44943,82154,8956,01609
8600000US01610,19469,9004,10465,34005,45316,3597,01610
8600000US01611,1798,871,927,92898,101899,15547,01611
8600000US01612,3981,1972,2009,99875,131047,11791,01612
8600000US01701,26708,12650,14058,111169,132278,7001,01701
8600000US01702,31066,15222,15844,57186,76098,3863,01702
8600000US01718,614,262,352,164402,157821,35535,01718
8600000US01719,4547,2342,2205,108207,140407,11245,01719
8600000US01720,17085,8225,8860,137147,165998,7630,01720
8600000US01721,13534,6541,6993,121406,136571,8249,01721
8600000US01730,10469,5144,5325,129726,163587,12675,01730
8600000US01731,1165,582,583,97305,104475,12584,01731
8600000US01740,3764,1905,1859,155093,174038,16336,01740
8600000US01741,3971,2002,1969,171625,240930,27761,01741
8600000US01742,14807,7666,7141,141068,195692,13220,01742
8600000US01745,385,147,238,125139,124938,21992,01745
8600000US01746,10884,5230,5654,125625,157110,9885,01746
8600000US01747,4529,2037,2492,107550,109996,9703,01747
8600000US01748,12555,6171,6384,166156,190259,11642,01748
8600000US01749,16121,7750,8371,87806,106042,5145,01749
8600000US01752,31866,15083,16783,79228,100656,4696,01752
8600000US01754,8397,4141,4256,101324,121375,11427,01754
8600000US01756,4624,2326,2298,132063,161517,25734,01756
8600000US01757,22218,10867,11351,82260,94403,5007,01757
8600000US01760,27173,12855,14318,109490,143456,6471,01760
8600000US01770,3106,1477,1629,180769,221374,22374,01770
8600000US01772,7001,3499,3502,147444,191769,14580,01772
8600000US01773,3924,1834,2090,137222,201858,26500,01773
8600000US01775,5269,2493,2776,145967,164845,17284,01775
8600000US01776,13442,6624,6818,176570,223959,12648,01776
8600000US01778,10276,4889,5387,174107,223706,14789,01778
8600000US01801,32499,15825,16674,88671,104168,4712,01801
8600000US01803,21515,10169,11346,105443,130151,7371,01803
8600000US01810,26724,12843,13881,148125,186073,7966,01810
8600000US01821,26463,12730,13733,103728,116743,5381,01821
8600000US01824,20605,9974,10631,119387,136170,6218,01824
8600000US01826,24230,11624,12606,88440,100749,4655,01826
8600000US01827,2564,1295,1269,131250,157170,16769,01827
8600000US01830,20635,9890,10745,62194,81355,4631,01830
8600000US01832,17963,8553,9410,66106,82985,4960,01832
8600000US01833,6645,3201,3444,128885,136912,9843,01833
8600000US01834,5365,2806,2559,97109,112510,13678,01834
8600000US01835,10154,4689,5465,75115,90412,5693,01835
8600000US01840,4092,1901,2191,22092,44020,7076,01840
8600000US01841,35386,17582,17804,40230,52289,2891,01841
8600000US01843,18679,9112,9567,49443,62409,3926,01843
8600000US01844,39338,18578,20760,74912,94101,3437,01844
8600000US01845,23425,11099,12326,109371,146547,7198,01845
8600000US01850,12015,6441,5574,48331,60908,5092,01850
8600000US01851,23727,11760,11967,57029,72914,3836,01851
8600000US01852,27283,13150,14133,54377,71574,4183,01852
8600000US01854,24041,11842,12199,42293,60852,3923,01854
8600000US01860,5403,2599,2804,83508,108311,10246,01860
8600000US01862,8634,4832,3802,97234,104971,8687,01862
8600000US01863,7295,3544,3751,88542,109314,9054,01863
8600000US01864,12212,6096,6116,126818,152083,10934,01864
8600000US01867,19090,9002,10088,112836,138257,7340,01867
8600000US01876,24784,11814,12970,97853,113964,7413,01876
8600000US01879,9842,4778,5064,109485,126782,11541,01879
8600000US01880,21530,10185,11345,95954,118976,7823,01880
8600000US01886,17689,8745,8944,141173,154239,6170,01886
8600000US01887,18573,9118,9455,122813,136610,8073,01887
8600000US01890,16356,7725,8631,159536,220498,9670,01890
8600000US01901,1438,715,723,22788,35010,6935,01901
8600000US01902,37156,18281,18875,43956,61318,2956,01902
8600000US01904,13446,6536,6910,85309,95352,4393,01904
8600000US01905,18902,9562,9340,60417,74779,5251,01905
8600000US01906,23153,10885,12268,80253,98449,4900,01906
8600000US01907,11497,5233,6264,113078,153226,13454,01907
8600000US01908,3041,1404,1637,90741,130144,20339,01908
8600000US01913,13712,6540,7172,80721,97711,5321,01913
8600000US01915,34717,15980,18737,79483,109747,5917,01915
8600000US01921,6233,3076,3157,174340,216543,25419,01921
8600000US01922,2489,1052,1437,90489,130679,25535,01922
8600000US01923,21904,10085,11819,84842,103974,4996,01923
8600000US01929,2826,1449,1377,113469,135147,18219,01929
8600000US01930,24994,11822,13172,65377,91768,5321,01930
8600000US01937,174,127,47,,,,01937
8600000US01938,11042,5102,5940,90557,117818,9934,01938
8600000US01940,10221,4756,5465,119876,162028,12673,01940
8600000US01944,4159,1994,2165,124025,180589,21586,01944
8600000US01945,15683,7110,8573,115511,170933,13464,01945
8600000US01949,7854,4079,3775,102604,143463,16213,01949
8600000US01950,14441,6589,7852,103220,137592,9236,01950
8600000US01951,3147,1215,1932,97083,132780,25916,01951
8600000US01952,7598,3707,3891,78355,94126,12426,01952
8600000US01960,43188,20310,22878,68214,88380,2918,01960
8600000US01966,6062,2527,3535,81681,102211,8560,01966
8600000US01969,4902,2313,2589,114063,165590,45271,01969
8600000US01970,35854,16021,19833,65495,83314,4469,01970
8600000US01982,5915,2874,3041,133333,147832,10677,01982
8600000US01983,4819,2282,2537,136812,149219,14266,01983
8600000US01984,4331,1812,2519,109712,172500,24263,01984
8600000US01985,3503,1703,1800,138403,170053,22123,01985
8600000US02019,13281,6610,6671,99569,122506,10541,02019
8600000US02021,18006,8326,9680,105371,135556,6745,02021
8600000US02025,6101,2933,3168,132204,207255,27479,02025
8600000US02026,20488,9616,10872,96868,128863,8765,02026
8600000US02030,4325,2169,2156,224784,339622,40573,02030
8600000US02032,3233,1623,1610,130109,163322,24896,02032
8600000US02035,13699,6654,7045,98374,125437,8814,02035
8600000US02038,24801,12022,12779,115355,141798,6736,02038
8600000US02043,17128,7877,9251,133596,194652,12973,02043
8600000US02045,9040,4055,4985,85573,109935,8910,02045
8600000US02047,77,52,25,,43009,16962,02047
8600000US02048,18036,9011,9025,114720,134417,9067,02048
8600000US02050,20314,9789,10525,95168,115250,7232,02050
8600000US02052,8873,4333,4540,155039,203700,16964,02052
8600000US02053,9965,4612,5353,119450,148732,11543,02053
8600000US02054,6382,3037,3345,106336,127728,11148,02054
8600000US02056,8777,5349,3428,146607,168104,10616,02056
8600000US02061,7889,3845,4044,151306,179550,12773,02061
8600000US02062,23438,11144,12294,90511,110223,6692,02062
8600000US02066,13877,6530,7347,121231,155639,12870,02066
8600000US02067,13403,6445,6958,138650,193368,16656,02067
8600000US02071,1481,1182,299,109963,135994,38571,02071
8600000US02072,23044,10509,12535,79421,95812,4566,02072
8600000US02081,14484,6880,7604,109893,140409,10267,02081
8600000US02090,11746,5603,6143,155887,205300,18419,02090
8600000US02093,8738,4184,4554,113017,140257,8946,02093
8600000US02108,3592,1711,1881,136667,222479,41893,02108
8600000US02109,3689,2032,1657,143191,208564,29845,02109
8600000US02110,2115,963,1152,116932,272139,64878,02110
8600000US02111,7044,3146,3898,40870,114752,28295,02111
8600000US02113,7172,3683,3489,100063,121887,10202,02113
8600000US02114,12522,6305,6217,95161,143442,12102,02114
8600000US02115,27649,13622,14027,37340,72238,5541,02115
8600000US02116,21589,9993,11596,105559,198886,16014,02116
8600000US02118,23859,11963,11896,65250,137005,9878,02118
8600000US02119,21876,10017,11859,30551,51239,4335,02119
8600000US02120,13281,6725,6556,33727,52171,4390,02120
8600000US02121,21861,9507,12354,30712,50336,4041,02121
8600000US02122,20234,10214,10020,60474,78812,5334,02122
8600000US02124,42532,19084,23448,53174,75366,3762,02124
8600000US02125,27815,13667,14148,56318,80020,5812,02125
8600000US02126,22905,10493,12412,52474,70403,5443,02126
8600000US02127,32029,15380,16649,99340,121844,5121,02127
8600000US02128,37260,20249,17011,55483,75181,2988,02128
8600000US02129,15624,6944,8680,118226,151533,8429,02129
8600000US02130,34173,15872,18301,90813,114098,4791,02130
8600000US02131,26849,12065,14784,73199,95371,5765,02131
8600000US02132,22957,10679,12278,100915,118858,4778,02132
8600000US02134,18115,9442,8673,58068,76198,6198,02134
8600000US02135,40367,19490,20877,72009,89087,4519,02135
8600000US02136,26234,12074,14160,64784,82184,4717,02136
8600000US02138,34570,16612,17958,95368,145375,8239,02138
8600000US02139,33528,16688,16840,96771,124391,4986,02139
8600000US02140,17878,8455,9423,100572,130776,9165,02140
8600000US02141,12364,6428,5936,79222,102235,6811,02141
8600000US02142,3129,1550,1579,116346,174675,24797,02142
8600000US02143,23565,11489,12076,95556,111665,6041,02143
8600000US02144,23078,11632,11446,107232,127149,5514,02144
8600000US02145,22558,11482,11076,75744,92961,5789,02145
8600000US02148,49576,23596,25980,64176,79505,3689,02148
8600000US02149,34447,16624,17823,60264,73710,3574,02149
8600000US02150,29529,14975,14554,53335,68129,3135,02150
8600000US02151,43284,21589,21695,54987,72851,3337,02151
8600000US02152,15125,6843,8282,68322,94159,7101,02152
8600000US02155,51378,24344,27034,92407,114537,6089,02155
8600000US02163,2331,1116,1215,49659,66078,13561,02163
8600000US02169,47433,22461,24972,70248,86202,3396,02169
8600000US02170,16710,8365,8345,76440,96618,7346,02170
8600000US02171,15845,7721,8124,83479,103837,5427,02171
8600000US02176,22299,10631,11668,103743,129158,7541,02176
8600000US02180,18224,8959,9265,94835,113371,6123,02180
8600000US02184,28626,13197,15429,94945,114389,5404,02184
8600000US02186,20732,9564,11168,127448,167091,9367,02186
8600000US02188,12698,6017,6681,83386,96967,5793,02188
8600000US02189,12412,5579,6833,69067,91332,8603,02189
8600000US02190,13704,6580,7124,87143,104703,7158,02190
8600000US02191,6956,3316,3640,74801,91481,5739,02191
8600000US02199,1090,402,688,91125,156516,48307,02199
8600000US02203,25,25,0,,,,02203
8600000US02210,3012,1768,1244,163068,211554,27674,02210
8600000US02215,24920,10517,14403,45337,79421,7621,02215
8600000US02301,46573,21377,25196,49693,67853,2680,02301
8600000US02302,24688,11631,13057,67608,81391,4944,02302
8600000US02322,3707,1825,1882,69868,88267,8605,02322
8600000US02324,22460,11848,10612,92289,107501,5944,02324
8600000US02330,9262,4436,4826,66406,86012,6208,02330
8600000US02332,11622,5567,6055,128333,166347,12041,02332
8600000US02333,10735,5014,5721,86922,98342,5794,02333
8600000US02338,6175,3063,3112,92111,101148,11054,02338
8600000US02339,10594,4974,5620,120000,148543,12796,02339
8600000US02341,8686,4517,4169,98537,110414,5915,02341
8600000US02343,8652,3813,4839,69539,85936,5963,02343
8600000US02346,19748,9809,9939,83227,99760,4959,02346
8600000US02347,8948,4476,4472,106775,124142,8347,02347
8600000US02351,13291,6183,7108,90873,99500,5959,02351
8600000US02356,10012,4791,5221,122710,147051,10646,02356
8600000US02357,1111,614,497,,,,02357
8600000US02359,14350,7205,7145,103920,119193,6657,02359
8600000US02360,48167,22696,25471,87595,109754,4334,02360
8600000US02364,10315,4701,5614,106654,110081,6874,02364
8600000US02366,198,198,0,,,,02366
8600000US02367,2411,1227,1184,98359,115438,13050,02367
8600000US02368,27753,12614,15139,73860,91452,5625,02368
8600000US02370,14211,6964,7247,79807,94876,8532,02370
8600000US02375,7874,3751,4123,94984,120752,9442,02375
8600000US02379,5640,2768,2872,86806,101838,7933,02379
8600000US02382,11496,5642,5854,83066,96121,5658,02382
8600000US02420,10725,5113,5612,180050,227388,14066,02420
8600000US02421,13870,6457,7413,168194,212325,13944,02421
8600000US02445,16710,7635,9075,121763,180091,13910,02445
8600000US02446,25716,11966,13750,98614,139460,8322,02446
8600000US02451,15811,7549,8262,96914,114432,7331,02451
8600000US02452,13396,6774,6622,86197,107720,7161,02452
8600000US02453,24519,12059,12460,76856,97040,5395,02453
8600000US02457,1690,687,1003,,,,02457
8600000US02458,9825,4503,5322,106074,169650,15340,02458
8600000US02459,15208,7078,8130,177005,245496,18807,02459
8600000US02460,7216,3325,3891,122688,169590,12791,02460
8600000US02461,5589,2543,3046,163382,196122,16808,02461
8600000US02462,1169,463,706,113250,168181,30511,02462
8600000US02464,2501,1229,1272,107679,129700,13380,02464
8600000US02465,8828,4101,4727,149104,202754,17435,02465
8600000US02466,7159,3349,3810,114495,144684,13077,02466
8600000US02467,18204,8062,10142,126630,187628,13936,02467
8600000US02468,4213,2106,2107,235714,287274,28921,02468
8600000US02472,29888,13693,16195,97466,119817,5482,02472
8600000US02474,21919,10092,11827,108986,137450,7919,02474
8600000US02476,13339,5944,7395,103425,139668,8903,02476
8600000US02478,19441,9096,10345,120398,164658,7611,02478
8600000US02481,11693,4652,7041,204695,313290,21419,02481
8600000US02482,8241,3581,4660,163750,233605,19479,02482
8600000US02492,15044,7107,7937,159147,223614,14092,02492
8600000US02493,8822,4084,4738,181667,272757,32794,02493
8600000US02494,7460,3219,4241,129918,187225,21986,02494
8600000US02532,11109,5343,5766,71982,90300,8886,02532
8600000US02534,658,356,302,91016,106218,24850,02534
8600000US02535,1139,485,654,93250,164965,31194,02535
8600000US02536,15906,7574,8332,69581,89133,6266,02536
8600000US02537,5078,2464,2614,103894,129891,13327,02537
8600000US02538,2945,1458,1487,68395,72146,11319,02538
8600000US02539,3418,1702,1716,64810,123710,27276,02539
8600000US02540,7225,3189,4036,73164,102735,10956,02540
8600000US02542,588,333,255,50682,64787,8594,02542
8600000US02543,629,233,396,82100,197060,135140,02543
8600000US02553,97,14,83,,74720,40099,02553
8600000US02554,8561,4400,4161,105334,138967,11712,02554
8600000US02556,2323,1019,1304,97222,135692,26203,02556
8600000US02557,3593,1728,1865,82045,91222,14765,02557
8600000US02558,1015,488,527,46622,52200,15035,02558
8600000US02559,3554,1691,1863,72784,85211,8760,02559
8600000US02561,290,230,60,84398,105893,52641,02561
8600000US02562,2582,1250,1332,84353,114355,14370,02562
8600000US02563,8052,3953,4099,89375,111567,10175,02563
8600000US02564,197,110,87,90313,91714,24113,02564
8600000US02568,3438,1887,1551,50301,91641,22195,02568
8600000US02571,8372,3613,4759,59219,71875,7094,02571
8600000US02575,2395,1003,1392,94306,111452,17684,02575
8600000US02576,3677,1790,1887,93125,100830,13651,02576
8600000US02584,12,0,12,,,,02584
8600000US02601,12382,5770,6612,49031,63043,5986,02601
8600000US02630,1763,919,844,107031,163428,44538,02630
8600000US02631,8300,3875,4425,73534,101427,9299,02631
8600000US02632,8337,4162,4175,77253,94948,7907,02632
8600000US02633,3743,1805,1938,72639,140229,40357,02633
8600000US02635,2710,1364,1346,72608,99732,21000,02635
8600000US02637,137,68,69,145673,179329,100019,02637
8600000US02638,2855,1345,1510,80132,100176,12868,02638
8600000US02639,2517,1284,1233,48750,72162,12297,02639
8600000US02641,192,71,121,,145446,83491,02641
8600000US02642,4393,2062,2331,68161,89528,11689,02642
8600000US02643,0,0,0,,,,02643
8600000US02644,3445,1608,1837,99418,107791,15904,02644
8600000US02645,8085,3870,4215,79365,99536,11914,02645
8600000US02646,1613,726,887,64760,83059,16002,02646
8600000US02647,74,29,45,74583,68339,18044,02647
8600000US02648,5485,2739,2746,84563,95098,9967,02648
8600000US02649,11687,5409,6278,71810,88942,4464,02649
8600000US02650,778,377,401,79926,87589,13131,02650
8600000US02651,0,0,0,,,,02651
8600000US02652,629,289,340,56316,72067,13779,02652
8600000US02653,5044,2248,2796,71698,95412,13080,02653
8600000US02655,2977,1442,1535,77563,135028,25239,02655
8600000US02657,2817,1548,1269,50741,79641,10460,02657
8600000US02659,828,394,434,71023,118124,26810,02659
8600000US02660,5472,2451,3021,56341,80711,11399,02660
8600000US02663,94,50,44,64200,82266,36838,02663
8600000US02664,7651,3581,4070,60193,77818,6440,02664
8600000US02666,493,278,215,65840,66907,19120,02666
8600000US02667,2970,1353,1617,69612,83075,14642,02667
8600000US02668,2319,969,1350,100528,121790,17061,02668
8600000US02669,85,68,17,92292,151995,128141,02669
8600000US02670,1121,531,590,63086,99879,22322,02670
8600000US02671,822,422,400,63281,78875,15211,02671
8600000US02672,246,121,125,74050,126458,61801,02672
8600000US02673,7272,3375,3897,62595,75562,5933,02673
8600000US02675,5623,2325,3298,72281,99899,8343,02675
8600000US02702,3538,1708,1830,99615,107360,11828,02702
8600000US02703,34606,16490,18116,74255,92805,3266,02703
8600000US02713,40,25,15,110625,161600,87915,02713
8600000US02715,2722,1278,1444,99444,110325,12095,02715
8600000US02717,3853,1972,1881,82292,101939,12545,02717
8600000US02718,5204,2544,2660,91625,105894,16263,02718
8600000US02719,12924,6039,6885,65763,82903,5396,02719
8600000US02720,24924,11916,13008,50783,61409,2198,02720
8600000US02721,20063,9216,10847,37059,49289,2914,02721
8600000US02723,11346,5349,5997,40374,53489,5111,02723
8600000US02724,14376,6690,7686,37702,52675,4532,02724
8600000US02725,2075,979,1096,74878,78475,11907,02725
8600000US02726,12812,6082,6730,77715,91634,6413,02726
8600000US02738,3906,1754,2152,80188,138386,19783,02738
8600000US02739,5326,2578,2748,91573,135965,17768,02739
8600000US02740,34226,15504,18722,40705,57905,3352,02740
8600000US02743,8692,4303,4389,72125,85180,5778,02743
8600000US02744,8510,4130,4380,38264,52428,5024,02744
8600000US02745,19883,9872,10011,61143,71265,3314,02745
8600000US02746,11195,5207,5988,33840,45021,2884,02746
8600000US02747,19822,9823,9999,82923,100111,7197,02747
8600000US02748,9550,4149,5401,78997,117525,12639,02748
8600000US02760,20681,9945,10736,87561,110400,7025,02760
8600000US02762,7209,3479,3730,98280,109193,8085,02762
8600000US02763,1304,637,667,121167,131786,27102,02763
8600000US02764,3503,1692,1811,84099,100512,14428,02764
8600000US02766,16053,7750,8303,108423,120890,6808,02766
8600000US02767,11166,5091,6075,100125,116077,11504,02767
8600000US02769,9522,4987,4535,104052,126367,8555,02769
8600000US02770,4011,2016,1995,102254,123649,10492,02770
8600000US02771,12114,5816,6298,89155,109476,10358,02771
8600000US02777,13417,6802,6615,83405,93894,6255,02777
8600000US02779,5126,2449,2677,94516,112984,11435,02779
8600000US02780,38788,18281,20507,57591,73310,2936,02780
8600000US02790,12980,6288,6692,80145,99230,7012,02790
8600000US02791,300,134,166,65833,87586,35990,02791
8600000US02802,451,259,192,51125,74004,39898,02802
8600000US02804,1673,768,905,100094,92200,11593,02804
8600000US02806,11817,5694,6123,122729,163629,9715,02806
8600000US02807,684,311,373,65893,75560,10551,02807
8600000US02808,1967,1075,892,74811,82627,12039,02808
8600000US02809,19057,9139,9918,66771,88310,5327,02809
8600000US02812,885,496,389,115000,124596,17714,02812
8600000US02813,6515,3319,3196,79019,102446,11645,02813
8600000US02814,6184,3100,3084,90040,95064,6759,02814
8600000US02815,134,59,75,243311,201649,90814,02815
8600000US02816,26503,12763,13740,70234,87584,4313,02816
8600000US02817,4691,2181,2510,106058,117143,12969,02817
8600000US02818,14058,6645,7413,103873,142929,10756,02818
8600000US02822,5461,2748,2713,87958,113916,12446,02822
8600000US02825,4417,2114,2303,81492,104129,15602,02825
8600000US02826,444,269,175,71699,98456,45075,02826
8600000US02827,1736,879,857,87143,99115,13026,02827
8600000US02828,6511,2954,3557,82150,101899,9974,02828
8600000US02830,4577,2222,2355,77823,92013,10247,02830
8600000US02831,2687,1326,1361,98958,118222,15013,02831
8600000US02832,3458,1664,1794,88796,106163,14856,02832
8600000US02833,951,406,545,85547,74057,13801,02833
8600000US02835,4434,2183,2251,108737,149966,19530,02835
8600000US02836,187,115,72,83531,82631,8690,02836
8600000US02837,2998,1522,1476,81523,109880,14307,02837
8600000US02838,2636,1100,1536,60692,95496,39811,02838
8600000US02839,1651,783,868,57250,68978,10698,02839
8600000US02840,19762,9219,10543,64939,91535,5753,02840
8600000US02841,1632,1405,227,,,,02841
8600000US02842,12835,6015,6820,69796,90704,6838,02842
8600000US02852,17505,8251,9254,83197,102046,5369,02852
8600000US02857,7330,3870,3460,94083,114392,13116,02857
8600000US02858,728,244,484,86625,101746,36783,02858
8600000US02859,5694,2757,2937,84616,86931,9765,02859
8600000US02860,36197,17728,18469,41638,55632,2178,02860
8600000US02861,20302,10000,10302,58795,71932,4279,02861
8600000US02863,13848,6943,6905,31696,42733,2972,02863
8600000US02864,27572,13365,14207,86278,105994,6673,02864
8600000US02865,13732,6321,7411,85865,112833,8374,02865
8600000US02871,13513,6592,6921,101771,126366,13631,02871
8600000US02872,278,112,166,32024,53480,37229,02872
8600000US02873,148,48,100,,108492,36636,02873
8600000US02874,4546,2265,2281,133526,155456,13432,02874
8600000US02875,386,198,188,107546,119209,33554,02875
8600000US02876,194,83,111,28333,39878,20251,02876
8600000US02878,13102,6507,6595,74553,94909,5907,02878
8600000US02879,17027,8240,8787,79975,100797,4966,02879
8600000US02881,7313,3472,3841,79154,111189,20006,02881
8600000US02882,12387,5806,6581,75143,113542,14459,02882
8600000US02885,8659,3999,4660,55462,74245,5671,02885
8600000US02886,23531,10689,12842,67459,85709,5257,02886
8600000US02888,15990,7894,8096,73604,89001,8595,02888
8600000US02889,22427,10772,11655,69744,82289,3773,02889
8600000US02891,17435,8020,9415,64778,90146,5570,02891
8600000US02892,3999,1953,2046,96619,110643,9650,02892
8600000US02893,23593,11268,12325,53765,65789,3506,02893
8600000US02894,590,215,375,72063,80598,16982,02894
8600000US02895,32472,15397,17075,39932,53739,2172,02895
8600000US02896,9754,4497,5257,83915,103699,9899,02896
8600000US02898,1373,681,692,82778,79818,10239,02898
8600000US02903,9929,4781,5148,35425,83975,11016,02903
8600000US02904,24039,10584,13455,41263,62677,4361,02904
8600000US02905,19518,9164,10354,42950,62562,4000,02905
8600000US02906,24421,11901,12520,81724,132263,8878,02906
8600000US02907,22209,11180,11029,38934,53596,6267,02907
8600000US02908,28784,13366,15418,47177,64406,4125,02908
8600000US02909,29765,14583,15182,35486,47322,2784,02909
8600000US02910,17224,8433,8791,65726,73868,3968,02910
8600000US02911,13078,5907,7171,58014,74831,6389,02911
8600000US02912,1344,644,700,,,,02912
8600000US02914,17455,8098,9357,51139,64403,4407,02914
8600000US02915,14055,6678,7377,61984,71804,4221,02915
8600000US02916,7106,3315,3791,72762,92079,6898,02916
8600000US02917,11868,5604,6264,82145,96579,7957,02917
8600000US02919,24096,11354,12742,64014,80552,4223,02919
8600000US02920,30435,15271,15164,57389,74630,3923,02920
8600000US02921,9795,4505,5290,103094,116455,10572,02921
8600000US03031,8583,4102,4481,134782,169186,14523,03031
8600000US03032,4323,2133,2190,115139,125498,10011,03032
8600000US03033,3776,1916,1860,138092,153376,16670,03033
8600000US03034,3289,1722,1567,102083,120689,13615,03034
8600000US03036,3924,2000,1924,134514,153495,15273,03036
8600000US03037,3490,1670,1820,100469,111238,10810,03037
8600000US03038,26402,12945,13457,71151,86745,3485,03038
8600000US03042,5459,2712,2747,77426,94886,10389,03042
8600000US03043,1344,681,663,101357,121083,14916,03043
8600000US03044,3733,1873,1860,97875,110585,7659,03044
8600000US03045,10829,5410,5419,87838,103557,7421,03045
8600000US03046,2109,1097,1012,106800,133283,12682,03046
8600000US03047,1452,720,732,78750,89877,7996,03047
8600000US03048,2827,1425,1402,77546,84743,6374,03048
8600000US03049,6036,3101,2935,132500,163450,18187,03049
8600000US03051,19958,9503,10455,95992,114328,7286,03051
8600000US03052,6469,3334,3135,100464,117052,9847,03052
8600000US03053,19438,9239,10199,103019,121332,5113,03053
8600000US03054,20318,9839,10479,103043,114944,6787,03054
8600000US03055,12004,5635,6369,77405,91964,5750,03055
8600000US03057,1994,1018,976,113125,129287,11706,03057
8600000US03060,23583,11187,12396,50481,68508,4522,03060
8600000US03062,22878,11317,11561,91417,112026,5197,03062
8600000US03063,13655,6564,7091,83108,102685,9056,03063
8600000US03064,11320,5619,5701,68269,88594,6817,03064
8600000US03070,4185,2192,1993,108924,122307,10469,03070
8600000US03071,3978,2107,1871,83250,106816,12290,03071
8600000US03076,10563,4969,5594,103940,122351,6936,03076
8600000US03077,8048,4066,3982,76713,85599,6043,03077
8600000US03079,23882,11610,12272,83343,106759,5049,03079
8600000US03082,1374,742,632,90521,115348,11577,03082
8600000US03084,1133,575,558,90476,98039,8812,03084
8600000US03086,3159,1700,1459,76421,94884,11888,03086
8600000US03087,10772,5662,5110,133222,164520,11526,03087
8600000US03101,2471,1504,967,30483,54366,8218,03101
8600000US03102,26503,13010,13493,56082,67229,2502,03102
8600000US03103,28674,14570,14104,55086,64961,3064,03103
8600000US03104,27001,13830,13171,63569,81103,3359,03104
8600000US03106,11494,5573,5921,84375,102069,6069,03106
8600000US03109,8400,4104,4296,79051,94432,6713,03109
8600000US03110,16735,7825,8910,131986,163492,9297,03110
8600000US03215,154,96,58,106250,135646,29836,03215
8600000US03216,1966,1080,886,73011,82701,8592,03216
8600000US03217,1709,796,913,46534,58357,8514,03217
8600000US03218,660,271,389,56080,92420,34987,03218
8600000US03220,5921,2826,3095,69792,82777,9530,03220
8600000US03221,1690,821,869,62831,79370,6979,03221
8600000US03222,4807,2489,2318,58141,70580,4876,03222
8600000US03223,2841,1467,1374,67500,85006,16259,03223
8600000US03224,1981,1005,976,85729,97872,9641,03224
8600000US03225,2889,1363,1526,82630,88226,10528,03225
8600000US03226,864,447,417,66750,88353,11859,03226
8600000US03227,836,393,443,81711,103374,15133,03227
8600000US03229,4528,2204,2324,97014,119986,14498,03229
8600000US03230,1027,528,499,64648,75618,8351,03230
8600000US03231,190,83,107,86125,82274,25700,03231
8600000US03233,86,41,45,128750,168114,97076,03233
8600000US03234,3760,1816,1944,68910,95805,12864,03234
8600000US03235,7051,3189,3862,50740,62436,5385,03235
8600000US03237,1939,940,999,76447,87837,12350,03237
8600000US03238,92,49,43,30556,35500,14171,03238
8600000US03240,1008,550,458,54792,71662,11891,03240
8600000US03241,670,347,323,66875,91507,18001,03241
8600000US03242,4125,2013,2112,86696,94374,10163,03242
8600000US03243,798,399,399,78030,88554,11563,03243
8600000US03244,6055,3003,3052,70983,82181,6565,03244
8600000US03245,1699,819,880,71458,89983,13001,03245
8600000US03246,13642,6697,6945,56865,75720,4975,03246
8600000US03249,5693,2486,3207,80844,108542,10575,03249
8600000US03251,1014,494,520,57656,67216,9682,03251
8600000US03253,5071,2498,2573,68714,92638,11518,03253
8600000US03254,3360,1635,1725,72429,110659,16982,03254
8600000US03255,1666,865,801,93466,120551,15464,03255
8600000US03256,1925,961,964,68646,76139,7989,03256
8600000US03257,4108,1710,2398,86500,124138,15217,03257
8600000US03258,2078,970,1108,88409,104495,12396,03258
8600000US03259,327,165,162,55375,94586,28393,03259
8600000US03260,588,287,301,96750,116383,25652,03260
8600000US03261,3517,1722,1795,88654,101547,8938,03261
8600000US03262,753,371,382,57083,64574,10513,03262
8600000US03263,3076,1467,1609,51941,67904,9179,03263
8600000US03264,6185,3176,3009,47130,73906,13263,03264
8600000US03266,1865,943,922,56071,67080,8288,03266
8600000US03268,952,501,451,80114,107997,37968,03268
8600000US03269,2445,1297,1148,84022,97950,12984,03269
8600000US03273,308,174,134,98611,100845,17375,03273
8600000US03275,9286,4776,4510,75213,89204,9870,03275
8600000US03276,6405,3406,2999,54203,66500,4302,03276
8600000US03278,2349,1119,1230,75809,91841,8523,03278
8600000US03279,709,366,343,51979,68539,10593,03279
8600000US03280,1000,547,453,77083,96767,19587,03280
8600000US03281,6823,3363,3460,86944,104596,9764,03281
8600000US03282,738,380,358,65938,88442,16911,03282
8600000US03284,711,366,345,77788,77058,9022,03284
8600000US03285,2088,1092,996,64069,70754,6499,03285
8600000US03287,1329,620,709,75500,102900,14469,03287
8600000US03290,3855,1884,1971,96167,116285,12927,03290
8600000US03291,46,5,41,25795,26510,12631,03291
8600000US03293,99,49,50,85481,99087,50057,03293
8600000US03301,26861,13420,13441,62439,83204,4217,03301
8600000US03303,12589,6003,6586,70709,81036,4369,03303
8600000US03304,5909,2938,2971,117796,131850,9070,03304
8600000US03307,4685,2144,2541,69784,84013,9028,03307
8600000US03431,21490,9999,11491,56262,76667,5613,03431
8600000US03440,2261,1136,1125,74000,87618,15375,03440
8600000US03441,175,70,105,32361,37575,7559,03441
8600000US03442,1105,581,524,61818,75548,7589,03442
8600000US03443,363,179,184,69036,85532,18715,03443
8600000US03444,1206,566,640,79722,100225,9533,03444
8600000US03445,598,287,311,63958,82037,13120,03445
8600000US03446,4902,2434,2468,70938,89095,17293,03446
8600000US03447,1973,1055,918,64500,82001,9829,03447
8600000US03448,609,319,290,70815,77529,9624,03448
8600000US03449,1464,731,733,71250,109303,18730,03449
8600000US03450,826,410,416,72833,104234,18103,03450
8600000US03451,3209,1648,1561,61217,65506,7149,03451
8600000US03452,4185,1932,2253,61333,76064,16468,03452
8600000US03455,1908,976,932,60541,99374,29417,03455
8600000US03456,615,306,309,59211,73323,7868,03456
8600000US03457,627,324,303,75833,100135,14751,03457
8600000US03458,5881,2774,3107,82056,118256,17908,03458
8600000US03461,4852,2429,2423,77625,90786,8477,03461
8600000US03462,1042,504,538,90441,160906,52912,03462
8600000US03464,877,413,464,82500,90408,10194,03464
8600000US03465,1630,821,809,61518,79112,16533,03465
8600000US03466,1319,676,643,77853,102947,25735,03466
8600000US03467,1429,685,744,92500,106961,11591,03467
8600000US03470,3993,1898,2095,51164,59278,5132,03470
8600000US03561,4949,2278,2671,40144,61593,10213,03561
8600000US03570,8785,5085,3700,38315,53726,5135,03570
8600000US03574,2132,951,1181,53190,71068,11494,03574
8600000US03575,60,47,13,105938,100829,26018,03575
8600000US03576,2364,1156,1208,43726,62802,5748,03576
8600000US03579,308,165,143,47083,69029,16751,03579
8600000US03580,1199,595,604,74886,102113,15461,03580
8600000US03581,2600,1350,1250,61809,78319,8152,03581
8600000US03582,1971,1001,970,43707,55195,4397,03582
8600000US03583,794,370,424,59107,68083,5529,03583
8600000US03584,2874,1433,1441,54926,67153,7354,03584
8600000US03585,2235,1148,1087,57500,74678,6011,03585
8600000US03586,528,251,277,80313,106695,19921,03586
8600000US03588,1303,672,631,51806,62229,3987,03588
8600000US03590,750,377,373,40000,52615,12317,03590
8600000US03592,965,498,467,44844,58093,7657,03592
8600000US03593,396,195,201,84063,96052,10979,03593
8600000US03595,553,310,243,59236,70565,9570,03595
8600000US03597,389,214,175,28750,42061,9589,03597
8600000US03598,2653,1290,1363,47788,59003,5322,03598
8600000US03601,328,181,147,59107,69407,10939,03601
8600000US03602,2033,934,1099,61900,71780,6197,03602
8600000US03603,4145,2097,2048,50461,58656,8749,03603
8600000US03604,205,82,123,109000,118023,26167,03604
8600000US03605,726,385,341,64394,73217,8002,03605
8600000US03607,401,204,197,63500,82232,17215,03607
8600000US03608,2437,1273,1164,74875,113102,22936,03608
8600000US03609,530,285,245,91438,92862,17715,03609
8600000US03740,534,291,243,63036,81835,14447,03740
8600000US03741,3365,1567,1798,71635,86657,15600,03741
8600000US03743,11020,5280,5740,48667,61939,4428,03743
8600000US03745,1197,613,584,80057,93706,11243,03745
8600000US03746,209,91,118,116667,123784,35475,03746
8600000US03748,4226,1994,2232,83194,102655,13586,03748
8600000US03750,626,302,324,172540,171092,37803,03750
8600000US03751,502,293,209,41845,64752,18640,03751
8600000US03752,596,316,280,65000,72381,9776,03752
8600000US03753,2311,1091,1220,84773,99207,12380,03753
8600000US03754,202,152,50,85997,68642,35824,03754
8600000US03755,9397,4486,4911,113304,179638,25654,03755
8600000US03765,380,159,221,60982,58532,11467,03765
8600000US03766,7776,3763,4013,71726,88789,6911,03766
8600000US03768,1318,633,685,106786,163514,16496,03768
8600000US03770,408,202,206,98750,94788,17597,03770
8600000US03771,698,378,320,69063,83332,10462,03771
8600000US03773,6383,3094,3289,56806,70918,5825,03773
8600000US03774,1852,878,974,48856,67181,15097,03774
8600000US03777,1274,575,699,83594,119538,15705,03777
8600000US03779,678,335,343,77222,94535,17400,03779
8600000US03780,440,199,241,57500,79446,30091,03780
8600000US03781,1565,788,777,83208,111620,22878,03781
8600000US03782,2351,1151,1200,71690,89585,9941,03782
8600000US03784,3175,1564,1611,55061,79171,10383,03784
8600000US03785,1819,836,983,45750,61084,9614,03785
8600000US03801,19077,9564,9513,78903,107653,5590,03801
8600000US03809,2733,1330,1403,77681,85470,10786,03809
8600000US03810,1473,688,785,90294,99944,21215,03810
8600000US03811,5554,2679,2875,113322,130614,14365,03811
8600000US03812,577,314,263,33895,68036,34912,03812
8600000US03813,2305,1201,1104,62708,79375,18604,03813
8600000US03814,2005,942,1063,43869,55294,8447,03814
8600000US03816,1240,572,668,59924,84787,17250,03816
8600000US03817,648,387,261,20577,47480,23422,03817
8600000US03818,2996,1439,1557,47206,63409,8153,03818
8600000US03819,3486,1758,1728,87986,98897,8542,03819
8600000US03820,25402,12013,13389,70691,89880,6066,03820
8600000US03823,1278,684,594,119375,145941,13237,03823
8600000US03824,15009,7231,7778,75066,103756,10032,03824
8600000US03825,7134,3456,3678,87595,112752,16550,03825
8600000US03826,1859,933,926,73625,95589,12767,03826
8600000US03827,2490,1208,1282,100243,126658,11546,03827
8600000US03830,1767,880,887,57712,70457,16906,03830
8600000US03832,289,138,151,71250,99908,34672,03832
8600000US03833,17490,8261,9229,88961,119412,6488,03833
8600000US03835,5455,2901,2554,62596,75466,8116,03835
8600000US03836,1171,602,569,63304,77734,8857,03836
8600000US03837,1024,534,490,67743,68976,12860,03837
8600000US03838,969,581,388,55667,65327,15478,03838
8600000US03839,2889,1362,1527,69113,71924,6694,03839
8600000US03840,3061,1517,1544,115592,136495,12232,03840
8600000US03841,5075,2445,2630,89125,115428,12125,03841
8600000US03842,13164,6230,6934,82384,110426,7076,03842
8600000US03844,1866,970,896,131053,179798,25341,03844
8600000US03845,992,536,456,54857,97052,40105,03845
8600000US03846,837,376,461,70417,98512,19386,03846
8600000US03847,337,143,194,93750,136077,78858,03847
8600000US03848,5069,2683,2386,97843,111751,14578,03848
8600000US03849,1156,531,625,60588,92215,22895,03849
8600000US03850,254,110,144,65417,66481,26199,03850
8600000US03851,3197,1630,1567,68445,79874,7198,03851
8600000US03852,469,182,287,101364,99834,19911,03852
8600000US03853,483,233,250,55313,69748,16045,03853
8600000US03854,662,317,345,107083,211065,78054,03854
8600000US03855,2113,1069,1044,80787,94199,8209,03855
8600000US03856,1236,629,607,146389,171613,17170,03856
8600000US03857,7492,3776,3716,75193,87991,6985,03857
8600000US03858,3912,2045,1867,110787,115439,9026,03858
8600000US03860,3450,1689,1761,58527,72055,8827,03860
8600000US03861,3610,1620,1990,91600,112108,12891,03861
8600000US03862,3647,1767,1880,103851,153450,19487,03862
8600000US03864,1547,791,756,51875,66459,12504,03864
8600000US03865,6210,2945,3265,82904,96750,9991,03865
8600000US03867,17350,8357,8993,57017,74699,4916,03867
8600000US03868,4059,2042,2017,57266,71455,12369,03868
8600000US03869,2003,964,1039,77098,93806,9115,03869
8600000US03870,4416,2195,2221,106071,175328,34247,03870
8600000US03871,115,39,76,,175548,158583,03871
8600000US03872,2768,1363,1405,72263,86013,9357,03872
8600000US03873,4801,2288,2513,106627,111451,9917,03873
8600000US03874,7624,3726,3898,67261,81094,7419,03874
8600000US03875,923,451,472,90032,114828,24779,03875
8600000US03878,9418,4557,4861,64829,72109,5759,03878
8600000US03882,1200,588,612,58466,75540,11926,03882
8600000US03883,106,45,61,,64967,32291,03883
8600000US03884,3122,1552,1570,90900,119023,18507,03884
8600000US03885,5702,2800,2902,115078,148769,15828,03885
8600000US03886,1683,762,921,53357,64941,13505,03886
8600000US03887,1711,891,820,74135,86725,9883,03887
8600000US03890,146,56,90,58871,58859,3172,03890
8600000US03894,5376,2634,2742,61563,85127,12188,03894
8600000US03901,5909,2893,3016,85242,89390,8605,03901
8600000US03902,2098,1091,1007,84048,139902,46380,03902
8600000US03903,5072,2423,2649,77435,87772,7155,03903
8600000US03904,6469,3226,3243,69702,93936,9723,03904
8600000US03905,1792,830,962,90978,102856,18379,03905
8600000US03906,3829,1918,1911,72837,82302,7093,03906
8600000US03907,1072,483,589,70417,87491,12682,03907
8600000US03908,5599,2640,2959,86623,98845,10916,03908
8600000US03909,8114,3888,4226,93882,111627,10704,03909
8600000US03910,294,134,160,57820,81147,50244,03910
8600000US03911,52,27,25,,,,03911
8600000US04001,2191,1182,1009,56797,70585,8074,04001
8600000US04002,6089,3122,2967,65291,74162,7898,04002
8600000US04003,297,150,147,86902,82537,22236,04003
8600000US04005,19434,9282,10152,51953,69197,4813,04005
8600000US04006,154,66,88,32708,47066,20953,04006
8600000US04008,2300,1254,1046,72533,78906,11982,04008
8600000US04009,4401,1846,2555,50379,56516,9171,04009
8600000US04010,1096,477,619,46458,54824,6868,04010
8600000US04011,17241,8228,9013,60326,85274,6021,04011
8600000US04015,3221,1684,1537,68125,71815,9240,04015
8600000US04017,363,175,188,63542,105133,28118,04017
8600000US04019,23,5,18,,,,04019
8600000US04020,1040,492,548,47083,80822,20777,04020
8600000US04021,4725,2169,2556,105573,134057,18040,04021
8600000US04022,1020,541,479,55417,67680,9745,04022
8600000US04024,474,212,262,57500,59996,8965,04024
8600000US04027,4736,2419,2317,64771,72718,8290,04027
8600000US04029,1345,726,619,55962,73506,8566,04029
8600000US04030,2010,889,1121,68312,82068,14951,04030
8600000US04032,6683,3112,3571,80723,116104,18990,04032
8600000US04037,2940,1362,1578,48065,58184,5546,04037
8600000US04038,13473,6535,6938,78251,92405,5776,04038
8600000US04039,6043,2778,3265,71855,80111,7140,04039
8600000US04040,2686,1333,1353,44551,60181,6920,04040
8600000US04041,1382,656,726,44006,55857,7024,04041
8600000US04042,3814,1873,1941,64183,72499,6752,04042
8600000US04043,9370,4282,5088,76136,108459,11214,04043
8600000US04046,6271,2935,3336,71000,88400,7473,04046
8600000US04047,1581,761,820,56467,69147,9767,04047
8600000US04048,2333,1198,1135,54340,62716,8178,04048
8600000US04049,2838,1376,1462,70512,79835,7817,04049
8600000US04050,212,96,116,76250,95116,18983,04050
8600000US04051,849,449,400,49931,74673,14591,04051
8600000US04055,3033,1524,1509,67528,76274,7127,04055
8600000US04056,259,128,131,61250,59118,14874,04056
8600000US04057,63,32,31,,,,04057
8600000US04061,2413,1336,1077,70984,75125,14488,04061
8600000US04062,14481,7265,7216,76692,88653,6704,04062
8600000US04063,482,167,315,,57071,16649,04063
8600000US04064,7565,3450,4115,50971,84381,17152,04064
8600000US04066,667,327,340,66719,87691,19716,04066
8600000US04068,1342,662,680,42740,54058,6084,04068
8600000US04069,1346,643,703,85313,97631,9808,04069
8600000US04071,4356,2051,2305,75478,100421,9816,04071
8600000US04072,15286,7121,8165,68271,85490,5042,04072
8600000US04073,12595,5698,6897,47220,58703,3349,04073
8600000US04074,15342,7228,8114,97589,116159,6235,04074
8600000US04076,2077,1023,1054,67819,67830,4110,04076
8600000US04079,3199,1473,1726,77188,112565,13921,04079
8600000US04083,3662,1875,1787,60158,71197,10056,04083
8600000US04084,6392,3024,3368,73632,82441,7554,04084
8600000US04085,1719,875,844,89609,98816,16100,04085
8600000US04086,7262,3352,3910,74653,83780,6743,04086
8600000US04087,1456,752,704,55978,60127,10123,04087
8600000US04088,1177,560,617,52303,67742,9568,04088
8600000US04090,8577,4195,4382,67269,88821,8336,04090
8600000US04091,728,401,327,51818,62395,7911,04091
8600000US04092,15060,7358,7702,55563,69340,3930,04092
8600000US04093,6456,3108,3348,72439,91917,13190,04093
8600000US04095,1014,511,503,52308,65563,7365,04095
8600000US04096,6714,3079,3635,81731,124266,12957,04096
8600000US04097,2838,1402,1436,110500,122064,13482,04097
8600000US04101,15213,7525,7688,42076,57466,3308,04101
8600000US04102,14626,7278,7348,57982,76768,4460,04102
8600000US04103,25104,11962,13142,66799,82206,4042,04103
8600000US04105,8886,4298,4588,119022,168731,23795,04105
8600000US04106,21165,9606,11559,66009,83626,4535,04106
8600000US04107,7019,3293,3726,111739,135919,13001,04107
8600000US04108,798,325,473,86563,112646,14684,04108
8600000US04109,90,46,44,65288,81955,38585,04109
8600000US04110,1106,548,558,165720,234135,84761,04110
8600000US04210,18004,8548,9456,48924,63941,2888,04210
8600000US04216,345,178,167,43750,53178,6243,04216
8600000US04217,2644,1346,1298,43953,58081,6864,04217
8600000US04219,1327,672,655,51369,66597,7170,04219
8600000US04220,2555,1242,1313,54444,65189,6240,04220
8600000US04221,763,347,416,45938,57414,8167,04221
8600000US04222,2940,1393,1547,73030,88918,8802,04222
8600000US04224,2003,1001,1002,37656,52497,7074,04224
8600000US04226,172,99,73,49583,59646,10925,04226
8600000US04227,108,57,51,30682,27559,6859,04227
8600000US04228,0,0,0,,,,04228
8600000US04231,225,112,113,37188,48025,8109,04231
8600000US04234,63,12,51,32097,39352,13272,04234
8600000US04236,3247,1717,1530,69571,83378,7888,04236
8600000US04237,166,69,97,73000,74137,17631,04237
8600000US04238,1340,701,639,54333,66502,5727,04238
8600000US04239,3664,1755,1909,58823,64892,7321,04239
8600000US04240,29230,13825,15405,41371,56320,3615,04240
8600000US04250,3110,1557,1553,48875,56159,5676,04250
8600000US04252,3613,1721,1892,66056,77844,10178,04252
8600000US04253,1615,805,810,59511,72696,10517,04253
8600000US04254,2387,1153,1234,36094,41499,5726,04254
8600000US04255,535,265,270,64375,63882,7036,04255
8600000US04256,2279,1165,1114,61786,68394,8469,04256
8600000US04257,2286,1154,1132,45000,53352,7621,04257
8600000US04258,1840,896,944,73036,86175,8420,04258
8600000US04259,2552,1252,1300,54821,66702,9914,04259
8600000US04260,4447,2263,2184,70081,81335,6327,04260
8600000US04261,314,143,171,54583,71856,10944,04261
8600000US04263,1624,814,810,54250,67626,9593,04263
8600000US04265,879,399,480,65221,78372,21143,04265
8600000US04267,54,24,30,59688,65297,17121,04267
8600000US04268,3659,1705,1954,47798,59136,8375,04268
8600000US04270,4746,2254,2492,54250,60282,5564,04270
8600000US04271,0,0,0,,,,04271
8600000US04274,4495,2278,2217,61857,69271,6955,04274
8600000US04275,335,152,183,42500,51126,9536,04275
8600000US04276,5322,2711,2611,35440,49768,4427,04276
8600000US04280,5107,2571,2536,67275,75734,6306,04280
8600000US04281,4117,1961,2156,46597,57288,8836,04281
8600000US04282,4424,2129,2295,63047,78782,9866,04282
8600000US04284,801,382,419,68000,80515,8285,04284
8600000US04285,339,174,165,43750,59988,10912,04285
8600000US04286,24,9,15,,,,04286
8600000US04287,2540,1205,1335,53243,68322,11195,04287
8600000US04289,1726,792,934,45313,54683,7357,04289
8600000US04290,1251,629,622,56181,66837,6742,04290
8600000US04292,758,387,371,62875,63296,6581,04292
8600000US04294,3213,1562,1651,48056,61812,7438,04294
8600000US04330,20956,10126,10830,45278,58352,2797,04330
8600000US04342,1439,703,736,68674,74388,5461,04342
8600000US04343,16,16,0,,,,04343
8600000US04344,2302,952,1350,39486,67447,14345,04344
8600000US04345,8899,4080,4819,56055,70249,5048,04345
8600000US04346,1596,790,806,50729,64473,8239,04346
8600000US04347,1976,942,1034,59548,81787,11130,04347
8600000US04348,2273,1151,1122,56445,62666,4788,04348
8600000US04349,905,438,467,66429,80194,8979,04349
8600000US04350,2894,1486,1408,69464,86319,11863,04350
8600000US04351,2093,997,1096,69083,94336,12459,04351
8600000US04352,1212,520,692,53203,66070,5221,04352
8600000US04353,1864,917,947,48656,64253,9835,04353
8600000US04354,1178,615,563,65121,90242,24416,04354
8600000US04355,2059,1085,974,82292,92960,10902,04355
8600000US04357,2743,1353,1390,53750,57213,5364,04357
8600000US04358,3206,1622,1584,61534,69482,6583,04358
8600000US04359,247,125,122,,56160,22121,04359
8600000US04360,417,215,202,58646,68458,9469,04360
8600000US04363,2095,1050,1045,54948,61091,5889,04363
8600000US04364,4746,2349,2397,65990,73217,7917,04364
8600000US04401,36110,17210,18900,47789,66161,3565,04401
8600000US04406,556,291,265,45417,57867,10620,04406
8600000US04408,115,66,49,54375,66163,13713,04408
8600000US04410,953,503,450,47197,52355,4740,04410
8600000US04411,1271,619,652,57708,67409,6749,04411
8600000US04412,7261,3703,3558,58403,70298,6684,04412
8600000US04413,184,108,76,46250,46037,12021,04413
8600000US04414,1057,565,492,37692,46600,5375,04414
8600000US04415,215,102,113,37679,44375,13882,04415
8600000US04416,4192,1834,2358,46250,55494,8605,04416
8600000US04417,288,154,134,29583,36778,6562,04417
8600000US04418,1394,717,677,43594,55679,9317,04418
8600000US04419,2195,1139,1056,67143,71810,5812,04419
8600000US04421,1122,776,346,52500,78581,14228,04421
8600000US04422,1114,633,481,53000,72242,20371,04422
8600000US04424,660,284,376,32232,36420,3369,04424
8600000US04426,3754,1817,1937,39928,57075,7239,04426
8600000US04427,2214,1061,1153,55050,62064,6119,04427
8600000US04428,2266,1125,1141,58325,67550,5579,04428
8600000US04429,3711,1764,1947,59190,79308,8958,04429
8600000US04430,1450,697,753,39464,48666,3796,04430
8600000US04431,42,22,20,55139,52759,14534,04431
8600000US04434,907,439,468,55938,63120,6882,04434
8600000US04435,851,400,451,42788,55493,7044,04435
8600000US04438,864,458,406,44375,54122,6393,04438
8600000US04441,1495,728,767,55179,60858,8108,04441
8600000US04442,22,14,8,30938,32962,15705,04442
8600000US04443,1954,996,958,38717,50327,6383,04443
8600000US04444,7093,3624,3469,79716,98473,10578,04444
8600000US04448,1151,597,554,32500,47299,7487,04448
8600000US04449,1196,603,593,52102,60143,6232,04449
8600000US04450,934,419,515,63750,62836,7081,04450
8600000US04451,175,89,86,33542,41393,7756,04451
8600000US04453,602,293,309,33500,46560,7167,04453
8600000US04454,26,13,13,18958,21677,7857,04454
8600000US04455,625,307,318,38516,57342,9317,04455
8600000US04456,2273,1127,1146,63004,74474,8577,04456
8600000US04457,4760,2495,2265,39797,57939,9036,04457
8600000US04459,712,358,354,39583,47729,5599,04459
8600000US04460,1012,558,454,36458,50148,5905,04460
8600000US04461,2337,1164,1173,63036,63408,6659,04461
8600000US04462,4062,1781,2281,37295,56880,14990,04462
8600000US04463,2515,1248,1267,33402,40042,2671,04463
8600000US04464,445,236,209,41042,62528,16446,04464
8600000US04468,7467,3863,3604,42475,57841,5813,04468
8600000US04469,2548,1406,1142,,,,04469
8600000US04471,536,266,270,36923,48520,12274,04471
8600000US04472,1821,899,922,53682,66495,9048,04472
8600000US04473,7302,3481,3821,45742,67186,5437,04473
8600000US04474,2924,1336,1588,64857,73811,9840,04474
8600000US04475,507,276,231,43036,53844,10368,04475
8600000US04476,999,486,513,48667,68489,8068,04476
8600000US04478,295,121,174,36964,50132,10358,04478
8600000US04479,1087,547,540,39000,52549,6273,04479
8600000US04481,404,208,196,43750,57254,11558,04481
8600000US04485,191,88,103,45694,60685,15241,04485
8600000US04487,766,426,340,33523,43259,6960,04487
8600000US04488,1222,564,658,57500,70318,10855,04488
8600000US04489,173,65,108,48095,37838,16356,04489
8600000US04490,242,122,120,54688,57578,7628,04490
8600000US04491,127,63,64,37500,44529,8289,04491
8600000US04492,98,44,54,46607,45393,6299,04492
8600000US04493,1553,751,802,51786,63705,7798,04493
8600000US04495,364,172,192,38500,45455,6277,04495
8600000US04496,3124,1515,1609,58373,69123,8218,04496
8600000US04497,245,127,118,23750,40038,8293,04497
8600000US04530,8617,4231,4386,52545,73776,7368,04530
8600000US04535,635,309,326,68068,83762,12325,04535
8600000US04537,1809,851,958,60887,75458,13238,04537
8600000US04538,1752,762,990,48000,63880,8520,04538
8600000US04539,913,450,463,54615,82529,26796,04539
8600000US04541,41,27,14,45893,41352,10871,04541
8600000US04543,1709,799,910,52941,68481,9418,04543
8600000US04544,571,301,270,79100,108745,37406,04544
8600000US04547,797,382,415,58304,71313,9671,04547
8600000US04548,793,400,393,62778,85784,15537,04548
8600000US04551,672,325,347,64583,75939,10188,04551
8600000US04553,1396,700,696,71250,96880,16677,04553
8600000US04554,737,359,378,58281,73426,14578,04554
8600000US04555,1313,626,687,61442,71311,7281,04555
8600000US04556,952,448,504,57237,74249,8178,04556
8600000US04558,121,53,68,93056,94467,44624,04558
8600000US04562,1822,837,985,72419,99881,28096,04562
8600000US04563,1188,615,573,56029,66184,6575,04563
8600000US04564,536,299,237,66607,102798,37695,04564
8600000US04568,396,204,192,50714,91544,22681,04568
8600000US04570,0,0,0,,,,04570
8600000US04571,340,155,185,46188,88380,69182,04571
8600000US04572,4211,1840,2371,42917,56920,5564,04572
8600000US04573,415,202,213,67031,93667,18710,04573
8600000US04574,1146,599,547,50652,87785,36208,04574
8600000US04575,70,44,26,140625,277650,204549,04575
8600000US04576,518,227,291,52197,82724,12453,04576
8600000US04578,3647,1852,1795,44835,61317,7333,04578
8600000US04579,2434,1157,1277,76442,80880,5822,04579
8600000US04605,11533,5415,6118,56787,71358,4293,04605
8600000US04606,954,465,489,40208,49335,4554,04606
8600000US04607,954,468,486,47000,97194,26898,04607
8600000US04609,4511,2351,2160,51544,68863,8120,04609
8600000US04611,346,178,168,46806,63699,14779,04611
8600000US04612,400,195,205,67750,83326,24548,04612
8600000US04613,68,31,37,78125,88630,47104,04613
8600000US04614,2190,978,1212,59324,77647,15749,04614
8600000US04616,637,324,313,48438,72945,14669,04616
8600000US04617,661,301,360,65833,97712,16119,04617
8600000US04619,2487,1231,1256,31078,61233,27731,04619
8600000US04622,980,463,517,39688,49437,7062,04622
8600000US04623,708,364,344,46827,50786,5492,04623
8600000US04624,149,65,84,60250,56035,16994,04624
8600000US04625,75,37,38,44792,91577,35104,04625
8600000US04626,369,203,166,51000,66518,17509,04626
8600000US04627,1340,580,760,45526,62148,10822,04627
8600000US04628,580,286,294,47679,54275,7231,04628
8600000US04629,0,0,0,,,,04629
8600000US04630,1097,523,574,45132,57576,6960,04630
8600000US04631,1142,512,630,35147,58033,13831,04631
8600000US04634,1547,768,779,41643,48155,3645,04634
8600000US04635,9,4,5,18750,17417,5057,04635
8600000US04637,138,56,82,46250,58881,16089,04637
8600000US04640,1778,821,957,55341,77945,17638,04640
8600000US04642,77,33,44,87250,100162,39421,04642
8600000US04643,826,420,406,44722,52790,5549,04643
8600000US04644,0,0,0,,,,04644
8600000US04645,20,14,6,31563,38187,20344,04645
8600000US04646,55,24,31,58750,81026,41678,04646
8600000US04648,541,247,294,41736,53971,6212,04648
8600000US04649,1057,513,544,42639,56365,9457,04649
8600000US04650,242,114,128,,243894,176431,04650
8600000US04652,1402,679,723,35476,51539,7575,04652
8600000US04653,498,200,298,47857,50315,7078,04653
8600000US04654,2622,1237,1385,36615,50958,4715,04654
8600000US04655,887,521,366,57760,69811,12170,04655
8600000US04657,271,147,124,51875,65969,14308,04657
8600000US04658,1262,602,660,50156,58879,8429,04658
8600000US04660,940,446,494,88224,122772,24860,04660
8600000US04662,328,164,164,52821,55536,12019,04662
8600000US04664,1029,540,489,50192,68164,8317,04664
8600000US04666,1006,491,515,40313,50713,4802,04666
8600000US04667,1059,497,562,39934,50934,4363,04667
8600000US04668,1209,584,625,32434,47238,4532,04668
8600000US04669,178,97,81,,94550,31882,04669
8600000US04671,475,241,234,60375,89275,21044,04671
8600000US04673,148,72,76,37917,55040,17707,04673
8600000US04674,370,186,184,58281,69074,17263,04674
8600000US04675,169,96,73,72083,186636,119454,04675
8600000US04676,899,445,454,54750,69924,14956,04676
8600000US04677,241,108,133,58250,65131,14839,04677
8600000US04679,1480,693,787,54450,72026,8692,04679
8600000US04680,921,482,439,41250,55689,5710,04680
8600000US04681,890,426,464,47125,58181,7739,04681
8600000US04683,90,42,48,96667,109921,33181,04683
8600000US04684,1348,634,714,68333,97007,15087,04684
8600000US04685,357,178,179,73958,83369,10795,04685
8600000US04686,113,60,53,46250,51576,11543,04686
8600000US04691,265,123,142,53906,66302,9700,04691
8600000US04693,335,160,175,39688,54077,11632,04693
8600000US04694,1783,873,910,47228,59629,4741,04694
8600000US04730,7863,3665,4198,38750,53855,3597,04730
8600000US04732,1374,752,622,39324,44850,4515,04732
8600000US04733,205,94,111,49688,58662,13596,04733
8600000US04734,579,295,284,46094,55507,9411,04734
8600000US04735,480,249,231,46833,57286,8566,04735
8600000US04736,7430,3685,3745,38450,54925,4691,04736
8600000US04739,763,375,388,38207,53113,10372,04739
8600000US04740,886,427,459,48269,63475,8448,04740
8600000US04741,4,4,0,,,,04741
8600000US04742,2558,1126,1432,39272,62204,11655,04742
8600000US04743,3811,1892,1919,42940,57022,4929,04743
8600000US04745,744,375,369,44167,53830,6723,04745
8600000US04746,374,205,169,27292,38766,7563,04746
8600000US04747,1076,541,535,37463,51209,6256,04747
8600000US04750,1651,811,840,38015,43635,4249,04750
8600000US04756,2786,1325,1461,39706,51923,7359,04756
8600000US04757,2378,1193,1185,57455,69970,5154,04757
8600000US04758,1093,495,598,41711,59710,10985,04758
8600000US04760,603,313,290,37500,58775,12427,04760
8600000US04761,414,178,236,48542,61233,18339,04761
8600000US04762,432,213,219,36375,52692,8252,04762
8600000US04763,588,276,312,34464,43396,5623,04763
8600000US04764,27,15,12,50625,47747,8102,04764
8600000US04765,918,447,471,32344,45936,6824,04765
8600000US04766,327,164,163,43000,50762,5156,04766
8600000US04768,298,153,145,52708,58755,6072,04768
8600000US04769,7348,3575,3773,37401,57703,6437,04769
8600000US04772,694,337,357,46042,62793,11335,04772
8600000US04773,539,265,274,59205,52005,17529,04773
8600000US04774,476,240,236,35865,43552,5178,04774
8600000US04776,835,426,409,42578,51953,5926,04776
8600000US04777,334,170,164,35208,40810,6330,04777
8600000US04779,288,152,136,40313,52096,9866,04779
8600000US04780,552,281,271,55625,64554,10674,04780
8600000US04781,450,248,202,40417,50738,6130,04781
8600000US04783,460,219,241,40625,61578,10073,04783
8600000US04785,2005,956,1049,31184,43985,4583,04785
8600000US04786,1595,820,775,42426,49392,4292,04786
8600000US04787,577,305,272,32019,43484,7301,04787
8600000US04841,5821,2614,3207,41308,54503,5248,04841
8600000US04843,4225,1733,2492,57132,76909,9793,04843
8600000US04847,1178,600,578,63462,75287,8610,04847
8600000US04848,594,280,314,65000,112236,23800,04848
8600000US04849,3071,1451,1620,59904,86762,8198,04849
8600000US04851,76,42,34,31250,51978,21078,04851
8600000US04852,36,18,18,42500,72464,31797,04852
8600000US04853,405,186,219,67500,85959,9159,04853
8600000US04854,1295,657,638,58281,83437,10448,04854
8600000US04855,186,100,86,129342,139401,50798,04855
8600000US04856,2744,1277,1467,63011,95411,21453,04856
8600000US04858,1112,558,554,61875,79893,13785,04858
8600000US04859,673,357,316,50100,78844,21066,04859
8600000US04860,1285,605,680,51875,77653,23096,04860
8600000US04861,2163,1074,1089,52907,55651,7031,04861
8600000US04862,3225,1599,1626,57209,67021,4491,04862
8600000US04863,910,426,484,66563,79275,11068,04863
8600000US04864,4155,2513,1642,67422,75190,11601,04864
8600000US04901,21689,10009,11680,43168,62953,5686,04901
8600000US04910,1687,860,827,49293,60171,5931,04910
8600000US04911,1719,935,784,32177,45685,5892,04911
8600000US04912,719,360,359,34531,37704,4866,04912
8600000US04915,7299,3340,3959,55737,70511,8634,04915
8600000US04917,2217,1108,1109,80303,90405,6992,04917
8600000US04918,298,163,135,67313,74251,24113,04918
8600000US04920,1348,721,627,34324,45060,7524,04920
8600000US04921,1179,582,597,37578,46126,3748,04921
8600000US04922,863,461,402,36719,56656,12509,04922
8600000US04923,423,208,215,30417,43531,9301,04923
8600000US04924,1742,862,880,50731,58310,6112,04924
8600000US04925,84,41,43,58333,54442,9779,04925
8600000US04926,79,37,42,,,,04926
8600000US04927,2807,1404,1403,47990,54513,5667,04927
8600000US04928,1708,780,928,40762,57612,6978,04928
8600000US04929,615,281,334,35673,62439,15266,04929
8600000US04930,3357,1548,1809,37050,44851,4928,04930
8600000US04932,1009,464,545,51953,60940,7509,04932
8600000US04933,24,19,5,,,,04933
8600000US04936,135,70,65,,68353,19665,04936
8600000US04937,5246,2517,2729,41084,51537,5475,04937
8600000US04938,8259,3830,4429,42301,57848,5958,04938
8600000US04939,826,415,411,41250,54365,9235,04939
8600000US04940,0,0,0,,,,04940
8600000US04941,1410,739,671,53266,59526,7476,04941
8600000US04942,1106,550,556,31514,42039,3774,04942
8600000US04943,1389,696,693,31129,45073,5752,04943
8600000US04944,37,18,19,,,,04944
8600000US04945,848,417,431,40357,55332,6272,04945
8600000US04947,1185,631,554,55000,69363,9070,04947
8600000US04949,650,318,332,47857,55739,8042,04949
8600000US04950,3942,1922,2020,42229,56837,10920,04950
8600000US04951,839,451,388,37417,53498,6796,04951
8600000US04952,1558,783,775,51563,63657,5880,04952
8600000US04953,2561,1206,1355,50192,58780,7076,04953
8600000US04955,1249,632,617,51417,61555,5771,04955
8600000US04956,722,365,357,42708,61895,11226,04956
8600000US04957,3392,1655,1737,47622,64810,8956,04957
8600000US04958,1537,839,698,49904,59756,7704,04958
8600000US04961,723,377,346,42333,59033,9585,04961
8600000US04962,97,55,42,68261,67424,28135,04962
8600000US04963,5806,2973,2833,55253,73461,9081,04963
8600000US04964,122,65,57,,61181,22210,04964
8600000US04965,1697,859,838,48679,56035,5248,04965
8600000US04966,1356,653,703,39167,50878,5036,04966
8600000US04967,3184,1575,1609,50893,55208,5214,04967
8600000US04969,954,511,443,46900,62665,11338,04969
8600000US04970,1213,638,575,53500,72844,12234,04970
8600000US04971,1601,752,849,53412,77874,23511,04971
8600000US04973,1154,528,626,59583,67577,6022,04973
8600000US04974,2047,922,1125,36563,48729,8053,04974
8600000US04975,0,0,0,,,,04975
8600000US04976,7669,3688,3981,42000,51824,4377,04976
8600000US04978,603,283,320,64250,71126,10558,04978
8600000US04979,746,361,385,55048,59824,6824,04979
8600000US04981,2157,1063,1094,55591,69048,9176,04981
8600000US04982,441,265,176,47941,47549,7739,04982
8600000US04983,1376,643,733,37500,64961,11917,04983
8600000US04984,523,256,267,39239,62515,11488,04984
8600000US04985,45,19,26,22917,34733,11334,04985
8600000US04986,1302,702,600,46346,58749,5751,04986
8600000US04987,780,386,394,43625,55017,5290,04987
8600000US04988,1890,893,997,36875,55247,7795,04988
8600000US04989,3180,1636,1544,57802,74487,7762,04989
8600000US04992,142,0,142,,,,04992
8600000US05001,7763,3578,4185,62574,77761,6304,05001
8600000US05031,120,40,80,84196,217153,144559,05031
8600000US05032,1826,879,947,52917,59153,5298,05032
8600000US05033,1985,1037,948,51400,62849,6497,05033
8600000US05034,278,122,156,77981,100328,53692,05034
8600000US05035,587,294,293,51875,69089,14084,05035
8600000US05036,876,406,470,55234,71940,9133,05036
8600000US05037,418,214,204,85197,92975,17209,05037
8600000US05038,1046,509,537,51625,56957,5251,05038
8600000US05039,938,464,474,50114,65457,8161,05039
8600000US05040,479,220,259,72841,75287,10319,05040
8600000US05041,339,218,121,67837,70226,13920,05041
8600000US05042,398,207,191,57321,75288,16670,05042
8600000US05043,804,377,427,71118,94143,15654,05043
8600000US05045,1521,711,810,59112,71896,7816,05045
8600000US05046,911,478,433,51667,59685,6803,05046
8600000US05048,2333,1230,1103,58295,80925,12504,05048
8600000US05050,129,70,59,46875,62297,23754,05050
8600000US05051,1211,536,675,54952,62453,9351,05051
8600000US05052,145,84,61,68214,82991,34201,05052
8600000US05053,381,196,185,109250,124733,28354,05053
8600000US05055,2474,1162,1312,114405,148237,18425,05055
8600000US05056,375,190,185,58750,80040,20434,05056
8600000US05058,218,103,115,74531,89825,24963,05058
8600000US05059,272,117,155,,108192,63236,05059
8600000US05060,3830,1862,1968,61713,73892,6264,05060
8600000US05061,1261,688,573,69271,78890,13116,05061
8600000US05062,521,273,248,51719,66655,9073,05062
8600000US05065,767,384,383,59625,82566,15745,05065
8600000US05067,181,93,88,141667,128998,26848,05067
8600000US05068,2571,1205,1366,56731,63439,6766,05068
8600000US05069,420,193,227,57273,72262,12245,05069
8600000US05070,456,195,261,91354,113410,24187,05070
8600000US05071,89,33,56,53606,56509,7523,05071
8600000US05072,380,167,213,73194,100682,33067,05072
8600000US05075,819,369,450,74500,93234,18273,05075
8600000US05076,317,166,151,49688,62125,7544,05076
8600000US05077,1015,539,476,62788,86405,10936,05077
8600000US05079,561,267,294,58333,57923,5020,05079
8600000US05081,399,170,229,28516,38984,7831,05081
8600000US05083,206,102,104,46167,68729,39415,05083
8600000US05084,248,139,109,61700,78827,19467,05084
8600000US05086,554,291,263,57500,65688,9425,05086
8600000US05089,3750,1732,2018,53061,66036,10587,05089
8600000US05091,2713,1243,1470,68799,112092,27497,05091
8600000US05101,3453,1580,1873,43427,55921,5292,05101
8600000US05141,127,46,81,27500,37188,13114,05141
8600000US05142,561,302,259,49792,59292,8433,05142
8600000US05143,3513,1801,1712,53138,72145,6685,05143
8600000US05146,551,271,280,57054,73036,9199,05146
8600000US05148,813,420,393,64904,109822,23297,05148
8600000US05149,1724,846,878,55701,72133,9674,05149
8600000US05150,583,223,360,27946,45559,22965,05150
8600000US05151,1269,631,638,58933,73292,12979,05151
8600000US05152,306,133,173,63750,82955,15846,05152
8600000US05153,519,242,277,49306,66394,14826,05153
8600000US05154,389,176,213,41563,64403,17037,05154
8600000US05155,696,347,349,50368,62453,13738,05155
8600000US05156,7386,3702,3684,51054,59232,4120,05156
8600000US05158,810,404,406,52903,63719,10763,05158
8600000US05161,489,258,231,72500,112077,37395,05161
8600000US05201,11700,5524,6176,49272,65382,4922,05201
8600000US05250,2888,1386,1502,58079,82734,12329,05250
8600000US05251,1141,528,613,53158,78673,12441,05251
8600000US05252,216,94,122,60625,79748,18677,05252
8600000US05253,347,144,203,67813,85697,40562,05253
8600000US05254,179,82,97,90368,131356,63430,05254
8600000US05255,3191,1440,1751,49844,89754,23268,05255
8600000US05257,2445,1151,1294,52222,72936,8710,05257
8600000US05260,438,247,191,88221,96351,29373,05260
8600000US05261,1972,977,995,54623,64041,11144,05261
8600000US05262,1591,836,755,68098,88560,16201,05262
8600000US05301,13390,6294,7096,49304,69408,4019,05301
8600000US05340,514,249,265,49348,67200,7733,05340
8600000US05341,299,148,151,53750,66596,13222,05341
8600000US05342,536,256,280,47656,57278,11156,05342
8600000US05343,651,333,318,51458,72943,12706,05343
8600000US05345,1908,882,1026,52218,69626,5520,05345
8600000US05346,4320,2248,2072,58768,82088,13659,05346
8600000US05350,550,259,291,55893,60535,6070,05350
8600000US05352,754,374,380,63250,91167,15801,05352
8600000US05353,756,376,380,67500,82960,19670,05353
8600000US05354,1816,830,986,75938,89372,8002,05354
8600000US05355,561,303,258,57132,82738,11501,05355
8600000US05356,741,342,399,45250,56655,8382,05356
8600000US05358,144,78,66,67188,81773,19054,05358
8600000US05359,425,216,209,61389,77514,14111,05359
8600000US05360,143,66,77,69583,104895,45292,05360
8600000US05361,912,444,468,62019,72253,8461,05361
8600000US05362,51,23,28,77083,89052,38256,05362
8600000US05363,1410,704,706,47759,63860,11545,05363
8600000US05401,25459,12860,12599,44097,64414,3070,05401
8600000US05403,15761,7372,8389,71087,94605,4758,05403
8600000US05404,6102,3252,2850,49663,59975,5746,05404
8600000US05405,4309,1837,2472,,,,05405
8600000US05408,7512,3253,4259,67618,84015,9318,05408
8600000US05439,1475,692,783,,,,05439
8600000US05440,1461,715,746,54048,68224,13128,05440
8600000US05441,699,356,343,65705,78329,15876,05441
8600000US05442,299,154,145,55000,62552,9525,05442
8600000US05443,5506,2673,2833,61832,74153,6055,05443
8600000US05444,1323,634,689,66964,83666,10310,05444
8600000US05445,2967,1559,1408,109886,166775,29799,05445
8600000US05446,12858,6106,6752,65333,89225,6157,05446
8600000US05447,48,35,13,38333,45419,11049,05447
8600000US05448,788,381,407,73750,88937,15278,05448
8600000US05450,3982,1979,2003,56863,70264,5288,05450
8600000US05452,16744,7953,8791,80807,97483,5672,05452
8600000US05454,3635,1852,1783,76117,89289,8869,05454
8600000US05455,814,442,372,85000,101353,10619,05455
8600000US05456,987,527,460,73500,95977,20339,05456
8600000US05457,1230,607,623,75833,79238,8044,05457
8600000US05458,1775,923,852,68250,89242,9144,05458
8600000US05459,1447,656,791,53068,59599,9119,05459
8600000US05461,3405,1833,1572,65917,102024,15758,05461
8600000US05462,1490,777,713,83558,97997,7632,05462
8600000US05463,384,179,205,62500,76837,9375,05463
8600000US05464,2606,1368,1238,72784,75630,6821,05464
8600000US05465,4118,2018,2100,96250,114998,11107,05465
8600000US05468,10766,5137,5629,80419,89194,6963,05468
8600000US05471,532,239,293,44706,51997,9133,05471
8600000US05472,1349,709,640,71607,88854,9159,05472
8600000US05473,1180,583,597,78214,108532,17108,05473
8600000US05474,748,405,343,75263,91075,9866,05474
8600000US05476,2465,1207,1258,49141,55958,4491,05476
8600000US05477,3494,1845,1649,92500,102467,8919,05477
8600000US05478,11511,5643,5868,61576,76147,5323,05478
8600000US05481,0,0,0,,,,05481
8600000US05482,6060,2758,3302,95017,133509,17928,05482
8600000US05483,1187,599,588,80000,91560,19440,05483
8600000US05485,75,32,43,62596,55626,13362,05485
8600000US05486,1362,637,725,85089,127455,20731,05486
8600000US05487,1244,652,592,69375,84288,8550,05487
8600000US05488,6402,3144,3258,66192,82067,8494,05488
8600000US05489,2675,1389,1286,98220,110377,7696,05489
8600000US05491,4794,2283,2511,70768,76826,3584,05491
8600000US05492,563,294,269,68750,76738,10136,05492
8600000US05494,1427,739,688,98482,117222,12753,05494
8600000US05495,7797,3706,4091,85480,104596,10184,05495
8600000US05602,9557,4315,5242,65779,83473,3998,05602
8600000US05640,111,58,53,53750,79425,19827,05640
8600000US05641,13024,6151,6873,53434,64356,3988,05641
8600000US05647,785,362,423,41953,58940,8912,05647
8600000US05648,366,169,197,77083,94505,23891,05648
8600000US05649,323,148,175,80515,76238,14614,05649
8600000US05650,977,450,527,63167,81379,11545,05650
8600000US05651,1154,549,605,69018,73650,10561,05651
8600000US05652,584,315,269,55714,60996,5974,05652
8600000US05653,379,199,180,49500,75160,27707,05653
8600000US05654,883,460,423,46875,69386,32220,05654
8600000US05655,2263,1134,1129,58036,67015,8610,05655
8600000US05656,2921,1463,1458,44964,60023,7451,05656
8600000US05657,81,42,39,97500,100611,41944,05657
8600000US05658,1217,580,637,56528,81268,13791,05658
8600000US05660,1406,708,698,78533,98211,11338,05660
8600000US05661,4612,2244,2368,57632,77900,9171,05661
8600000US05663,5718,3375,2343,72500,77035,5448,05663
8600000US05664,93,66,27,,,,05664
8600000US05667,1777,865,912,51071,70619,6475,05667
8600000US05669,565,289,276,62604,71961,11971,05669
8600000US05672,3593,1674,1919,57917,105362,38762,05672
8600000US05673,2059,1034,1025,77978,104156,10851,05673
8600000US05674,1188,578,610,62550,119999,33129,05674
8600000US05675,987,522,465,57216,67438,6882,05675
8600000US05676,3877,1918,1959,71442,86902,7101,05676
8600000US05677,1817,875,942,58563,91789,15175,05677
8600000US05678,172,73,99,46250,55496,21961,05678
8600000US05679,2753,1357,1396,65048,70934,6763,05679
8600000US05680,1735,863,872,63533,74990,6366,05680
8600000US05681,324,147,177,71250,65515,11762,05681
8600000US05682,978,531,447,60179,78963,11540,05682
8600000US05701,16641,8141,8500,50108,66994,3728,05701
8600000US05730,240,131,109,63417,84884,30453,05730
8600000US05732,599,250,349,59167,66628,14829,05732
8600000US05733,4791,2246,2545,55941,67467,6253,05733
8600000US05734,1151,609,542,65074,81492,10811,05734
8600000US05735,3765,1844,1921,45776,59883,6979,05735
8600000US05736,406,179,227,43333,78978,50745,05736
8600000US05737,706,375,331,68438,90199,9610,05737
8600000US05738,966,513,453,70476,93156,9461,05738
8600000US05739,1068,486,582,58542,72120,9322,05739
8600000US05740,22,0,22,,,,05740
8600000US05742,573,268,305,84688,95818,15839,05742
8600000US05743,2977,1435,1542,48263,58252,3669,05743
8600000US05744,516,206,310,61818,60383,11938,05744
8600000US05747,254,141,113,66250,75127,17598,05747
8600000US05748,270,142,128,51071,56932,6500,05748
8600000US05751,608,280,328,60288,94900,20415,05751
8600000US05753,9022,4207,4815,64360,82748,5576,05753
8600000US05757,657,318,339,58409,73241,7433,05757
8600000US05758,546,283,263,63875,80097,17577,05758
8600000US05759,1462,746,716,53466,66992,8864,05759
8600000US05760,976,509,467,60417,72202,8118,05760
8600000US05761,679,374,305,55568,83853,14875,05761
8600000US05762,299,143,156,54464,68790,12709,05762
8600000US05763,2182,1025,1157,55797,65505,6363,05763
8600000US05764,2842,1408,1434,51957,61534,5688,05764
8600000US05765,1377,686,691,64423,76774,6798,05765
8600000US05766,428,209,219,49152,69573,12862,05766
8600000US05767,965,476,489,48304,69443,10433,05767
8600000US05769,899,456,443,67019,82236,14757,05769
8600000US05770,765,377,388,61979,94263,18424,05770
8600000US05772,586,307,279,73173,84651,12436,05772
8600000US05773,1816,845,971,55833,71320,9456,05773
8600000US05774,882,455,427,64265,79575,13416,05774
8600000US05775,404,206,198,44792,67105,20711,05775
8600000US05776,615,304,311,57054,73472,13230,05776
8600000US05777,2719,1350,1369,61417,68915,4742,05777
8600000US05778,470,244,226,62604,73208,8779,05778
8600000US05819,7355,3626,3729,45134,60553,3980,05819
8600000US05820,464,255,209,40865,51372,8776,05820
8600000US05821,954,464,490,59167,98819,22039,05821
8600000US05822,1353,639,714,45114,54952,6212,05822
8600000US05824,957,469,488,56579,60993,4915,05824
8600000US05825,71,37,34,33750,42535,8929,05825
8600000US05826,725,362,363,60000,71044,8074,05826
8600000US05827,302,174,128,58125,63193,12536,05827
8600000US05828,1656,750,906,56250,72253,7372,05828
8600000US05829,1308,642,666,40846,55159,8555,05829
8600000US05830,1136,531,605,44135,62077,8337,05830
8600000US05832,690,376,314,49750,71297,14641,05832
8600000US05833,247,134,113,60625,56029,10202,05833
8600000US05836,854,384,470,49417,66348,13310,05836
8600000US05837,289,140,149,39375,44953,8220,05837
8600000US05839,622,296,326,44408,54723,7442,05839
8600000US05841,347,144,203,57083,72613,20649,05841
8600000US05842,384,185,199,61750,76592,12645,05842
8600000US05843,1968,957,1011,46071,57580,7305,05843
8600000US05845,932,494,438,40694,51689,7864,05845
8600000US05846,957,446,511,36450,48568,5574,05846
8600000US05847,608,287,321,50192,53968,6732,05847
8600000US05850,248,74,174,,,,05850
8600000US05851,5296,2785,2511,46795,73585,15805,05851
8600000US05853,455,222,233,39191,69401,21179,05853
8600000US05855,5801,3118,2683,50068,62973,4892,05855
8600000US05857,1980,928,1052,61667,73760,7059,05857
8600000US05858,369,204,165,35000,52952,11829,05858
8600000US05859,1286,599,687,43558,58616,6778,05859
8600000US05860,1968,1006,962,47974,54655,4460,05860
8600000US05862,197,85,112,70000,70246,9587,05862
8600000US05866,544,278,266,63558,66336,8752,05866
8600000US05867,660,304,356,63125,68955,10276,05867
8600000US05868,279,139,140,60536,65254,12674,05868
8600000US05871,1174,576,598,52269,57620,4117,05871
8600000US05872,701,330,371,40000,50722,8008,05872
8600000US05873,533,267,266,55921,69161,12213,05873
8600000US05874,440,196,244,40000,74567,23637,05874
8600000US05875,391,165,226,60938,94673,22274,05875
8600000US05901,14,9,5,33438,36233,24112,05901
8600000US05902,183,97,86,28846,39664,13855,05902
8600000US05903,691,368,323,39038,58521,8100,05903
8600000US05904,171,67,104,24167,30628,7110,05904
8600000US05905,632,317,315,43958,73446,13987,05905
8600000US05906,1018,523,495,42674,47583,4665,05906
8600000US05907,120,57,63,43750,47474,6071,05907
8600000US06001,13959,6445,7514,129888,186248,11723,06001
8600000US06002,17928,8059,9869,76952,100350,6072,06002
8600000US06010,47666,23277,24389,66829,82765,3867,06010
8600000US06013,7332,3568,3764,126341,149246,11034,06013
8600000US06016,5290,2464,2826,85024,98011,9151,06016
8600000US06018,2412,1244,1168,65718,83356,12767,06018
8600000US06019,7978,3911,4067,88165,125006,12845,06019
8600000US06020,0,0,0,,,,06020
8600000US06021,256,127,129,82625,105435,22556,06021
8600000US06022,77,36,41,,,,06022
8600000US06023,961,414,547,86842,95671,24998,06023
8600000US06024,395,178,217,94375,90843,18351,06024
8600000US06026,3953,1806,2147,100689,106247,11675,06026
8600000US06027,1122,554,568,93462,108826,11095,06027
8600000US06029,12495,6410,6085,85427,111243,9961,06029
8600000US06031,1241,613,628,86667,142783,33686,06031
8600000US06032,14180,6612,7568,97031,140650,10688,06032
8600000US06033,22479,10821,11658,112004,145449,8192,06033
8600000US06035,6045,3069,2976,107227,138552,15003,06035
8600000US06037,15585,7375,8210,99158,120064,8899,06037
8600000US06039,1540,819,721,80921,116489,28298,06039
8600000US06040,27013,12901,14112,63891,82642,3618,06040
8600000US06042,18815,8728,10087,79392,87929,3495,06042
8600000US06043,3868,1863,2005,105417,123472,10032,06043
8600000US06051,22112,10208,11904,34341,45601,2914,06051
8600000US06052,6381,3208,3173,71317,89396,8931,06052
8600000US06053,27441,13473,13968,50698,64273,3340,06053
8600000US06057,4851,2337,2514,107566,120624,13093,06057
8600000US06058,1264,661,603,76875,106894,11092,06058
8600000US06059,0,0,0,,,,06059
8600000US06060,2008,1020,988,147574,160623,23925,06060
8600000US06061,104,72,32,52031,57442,19687,06061
8600000US06062,14723,7429,7294,65553,82809,5705,06062
8600000US06063,2545,1285,1260,113462,122185,11672,06063
8600000US06065,601,293,308,93750,108168,23405,06065
8600000US06066,23874,11401,12473,62645,78106,3611,06066
8600000US06067,16672,7714,8958,83100,104127,6555,06067
8600000US06068,1271,560,711,77066,128442,37164,06068
8600000US06069,2077,939,1138,72679,145916,47723,06069
8600000US06070,12128,5932,6196,120335,162208,11244,06070
8600000US06071,9427,5474,3953,105164,133148,11489,06071
8600000US06073,4154,2104,2050,150184,188868,17609,06073
8600000US06074,20025,9368,10657,107088,121739,4955,06074
8600000US06076,10238,4748,5490,75368,91565,5548,06076
8600000US06078,10267,6011,4256,111586,148604,13297,06078
8600000US06081,1143,488,655,68792,81911,14601,06081
8600000US06082,35970,19163,16807,76423,89670,3823,06082
8600000US06084,11239,5667,5572,115718,145811,11564,06084
8600000US06085,5791,2693,3098,88786,125238,14343,06085
8600000US06088,3953,1883,2070,62126,74024,7475,06088
8600000US06089,2400,1161,1239,107476,155689,18650,06089
8600000US06090,687,344,343,155691,171403,34827,06090
8600000US06091,107,58,49,60000,78408,23764,06091
8600000US06092,3044,1495,1549,157733,186247,20073,06092
8600000US06093,2441,1170,1271,111534,133516,14796,06093
8600000US06095,23127,10627,12500,88897,103006,4748,06095
8600000US06096,10288,4937,5351,66846,86410,9464,06096
8600000US06098,10473,5333,5140,71657,80053,5202,06098
8600000US06103,1775,988,787,80426,95488,15069,06103
8600000US06105,15918,7690,8228,31512,60094,4750,06105
8600000US06106,29149,13795,15354,33076,46554,2017,06106
8600000US06107,14265,6884,7381,132171,164528,9138,06107
8600000US06108,19244,9914,9330,52857,67352,6350,06108
8600000US06109,21225,9368,11857,83391,104651,6479,06109
8600000US06110,9969,4580,5389,69888,90105,7913,06110
8600000US06111,24744,11561,13183,80310,92811,3576,06111
8600000US06112,16593,6980,9613,38750,52148,3454,06112
8600000US06114,20939,10363,10576,38153,51277,4146,06114
8600000US06117,12722,5938,6784,125488,175398,11867,06117
8600000US06118,20360,9377,10983,57346,74478,3559,06118
8600000US06119,12292,5690,6602,82146,112674,6565,06119
8600000US06120,9511,4349,5162,26456,35048,2748,06120
8600000US06160,0,0,0,,,,06160
8600000US06226,15629,7135,8494,35971,46827,3537,06226
8600000US06231,3015,1508,1507,119247,133054,14542,06231
8600000US06232,2596,1225,1371,101098,105847,7531,06232
8600000US06234,6685,3692,2993,71967,87484,10011,06234
8600000US06235,1976,1088,888,71458,85681,7932,06235
8600000US06237,4404,2250,2154,106333,123113,10342,06237
8600000US06238,9772,4757,5015,91479,109821,6934,06238
8600000US06239,8796,4009,4787,53718,69635,7109,06239
8600000US06241,4787,2400,2387,75833,81324,6114,06241
8600000US06242,1113,605,508,84118,95938,8133,06242
8600000US06243,115,67,48,,,,06243
8600000US06247,2243,1152,1091,75291,88436,6647,06247
8600000US06248,4348,2184,2164,104038,130723,10049,06248
8600000US06249,5814,2890,2924,95757,105322,8632,06249
8600000US06250,3754,1788,1966,86580,126824,32779,06250
8600000US06254,1492,776,716,94000,108333,9231,06254
8600000US06255,3540,1844,1696,76688,83020,9529,06255
8600000US06256,1868,824,1044,53594,69560,10707,06256
8600000US06259,3525,1831,1694,86786,102710,8352,06259
8600000US06260,7720,3669,4051,59844,72790,6625,06260
8600000US06262,595,244,351,72857,82254,25433,06262
8600000US06263,169,82,87,46116,60449,21815,06263
8600000US06264,88,46,42,95500,122338,27706,06264
8600000US06266,412,197,215,59896,66483,12257,06266
8600000US06268,9669,4701,4968,48140,82851,10032,06268
8600000US06269,10047,4941,5106,,,,06269
8600000US06277,3266,1521,1745,85805,97182,10024,06277
8600000US06278,3577,1835,1742,67949,84451,7842,06278
8600000US06279,5160,2823,2337,74940,93981,10764,06279
8600000US06280,2381,1085,1296,67328,83122,9367,06280
8600000US06281,5278,2746,2532,89055,101216,12151,06281
8600000US06282,954,437,517,95174,108443,20814,06282
8600000US06320,22054,10801,11253,39721,56937,4049,06320
8600000US06330,2626,1299,1327,68125,84386,6703,06330
8600000US06331,4000,1964,2036,92835,103610,10226,06331
8600000US06332,473,244,229,76094,104420,47315,06332
8600000US06333,5487,2793,2694,119679,137729,9254,06333
8600000US06334,2115,1031,1084,84167,96832,6868,06334
8600000US06335,5010,2408,2602,95350,105839,10274,06335
8600000US06336,51,26,25,152250,152032,46407,06336
8600000US06339,6482,3226,3256,89801,114157,13707,06339
8600000US06340,24591,13371,11220,61980,78655,4892,06340
8600000US06350,31,9,22,62000,57865,21100,06350
8600000US06351,12427,6379,6048,70557,90091,8256,06351
8600000US06353,64,30,34,,,,06353
8600000US06354,5070,2627,2443,64223,74957,8651,06354
8600000US06355,10344,4835,5509,92308,114742,7715,06355
8600000US06357,10109,4412,5697,79821,100407,6874,06357
8600000US06359,4187,2189,1998,74321,94649,11085,06359
8600000US06360,28771,13661,15110,56177,72824,4157,06360
8600000US06365,3710,1750,1960,75568,93485,10888,06365
8600000US06370,5685,2900,2785,79745,95380,8423,06370
8600000US06371,7872,3834,4038,93818,137680,11231,06371
8600000US06373,267,81,186,,73739,43730,06373
8600000US06374,5930,2724,3206,66707,75951,6461,06374
8600000US06375,2993,1558,1435,96552,114710,11486,06375
8600000US06376,183,95,88,,97478,55968,06376
8600000US06377,2235,1150,1085,82524,84531,8797,06377
8600000US06378,4702,2303,2399,95260,141106,16817,06378
8600000US06379,6952,3289,3663,66167,85867,4979,06379
8600000US06380,2299,1171,1128,40612,56905,12674,06380
8600000US06382,9909,5702,4207,68598,82830,6257,06382
8600000US06384,2139,1047,1092,73031,82339,6436,06384
8600000US06385,12578,6047,6531,79293,100006,5864,06385
8600000US06387,270,111,159,,72965,32338,06387
8600000US06389,15,8,7,,,,06389
8600000US06390,171,104,67,,135366,61990,06390
8600000US06401,14792,7012,7780,53704,68491,5203,06401
8600000US06403,4735,2201,2534,86842,105317,9722,06403
8600000US06405,23387,10648,12739,80073,107900,5644,06405
8600000US06409,398,184,214,31151,52502,21104,06409
8600000US06410,23587,12443,11144,112814,135752,6309,06410
8600000US06412,3458,1500,1958,92417,104926,9546,06412
8600000US06413,10480,4965,5515,76526,97427,6347,06413
8600000US06414,91,37,54,,133954,65540,06414
8600000US06415,12758,6489,6269,103062,116905,8250,06415
8600000US06416,11063,5718,5345,91841,114484,7614,06416
8600000US06417,3457,1668,1789,71641,106000,17261,06417
8600000US06418,9988,4556,5432,56073,71987,6932,06418
8600000US06419,5037,2446,2591,113068,136825,13324,06419
8600000US06420,3245,1653,1592,114750,133703,14664,06420
8600000US06422,5792,2864,2928,117631,149382,23457,06422
8600000US06423,4419,2254,2165,91599,112489,10522,06423
8600000US06424,10241,5126,5115,101629,115424,9173,06424
8600000US06426,3081,1556,1525,106991,147458,22878,06426
8600000US06437,17443,8693,8750,110000,158508,10652,06437
8600000US06438,2388,1185,1203,108384,124880,19950,06438
8600000US06441,3949,1915,2034,108479,123877,13858,06441
8600000US06442,2116,1077,1039,77023,96231,17396,06442
8600000US06443,13754,6283,7471,104754,142192,9734,06443
8600000US06444,99,29,70,,75451,84999,06444
8600000US06447,5036,2488,2548,109750,137300,18977,06447
8600000US06450,28882,13644,15238,61031,74280,3012,06450
8600000US06451,20279,9084,11195,54245,72047,4378,06451
8600000US06455,2668,1289,1379,106042,120738,16622,06455
8600000US06456,276,109,167,,91302,48344,06456
8600000US06457,38328,18213,20115,67651,88996,3803,06457
8600000US06460,32559,15455,17104,86305,110096,5291,06460
8600000US06461,11995,5657,6338,98581,118221,8925,06461
8600000US06467,283,117,166,110526,108830,3335,06467
8600000US06468,14672,6927,7745,115049,140631,9875,06468
8600000US06469,2449,1201,1248,95208,108173,22646,06469
8600000US06470,12768,6336,6432,123008,151373,9189,06470
8600000US06471,6382,3137,3245,81188,115189,18452,06471
8600000US06472,5396,2668,2728,94423,126804,23534,06472
8600000US06473,19747,9586,10161,99966,125117,9949,06473
8600000US06475,8374,3756,4618,81411,112007,10889,06475
8600000US06477,10970,5154,5816,117215,146486,11469,06477
8600000US06478,10058,5102,4956,106047,123455,9034,06478
8600000US06479,7929,3875,4054,92295,104802,7566,06479
8600000US06480,7364,3444,3920,91295,115083,12697,06480
8600000US06481,985,448,537,72380,88172,14209,06481
8600000US06482,8423,4063,4360,126974,162921,14699,06482
8600000US06483,12912,6185,6727,70941,93167,5634,06483
8600000US06484,33795,16165,17630,94446,115632,4910,06484
8600000US06488,15688,7455,8233,94176,119631,8395,06488
8600000US06489,26375,12549,13826,90883,107199,3588,06489
8600000US06492,37679,17110,20569,79489,97183,2921,06492
8600000US06498,6251,3051,3200,88977,139413,21618,06498
8600000US06510,2503,1255,1248,54931,86456,18121,06510
8600000US06511,42575,19851,22724,40803,65747,3169,06511
8600000US06512,23188,10905,12283,62736,81437,3508,06512
8600000US06513,29608,13809,15799,41507,54264,2644,06513
8600000US06514,21680,10233,11447,70754,88727,4702,06514
8600000US06515,15010,6768,8242,53928,80946,6111,06515
8600000US06516,43755,21880,21875,58112,74932,3198,06516
8600000US06517,11707,5357,6350,84118,111626,6888,06517
8600000US06518,17091,7817,9274,76938,95564,5479,06518
8600000US06519,11107,5187,5920,28955,48879,5344,06519
8600000US06524,4382,2129,2253,119653,151728,19500,06524
8600000US06525,6785,3190,3595,142188,161377,14147,06525
8600000US06604,22830,11430,11400,36009,55314,4711,06604
8600000US06605,18872,8786,10086,42928,64028,4995,06605
8600000US06606,36210,17237,18973,56607,75121,4165,06606
8600000US06607,6000,2641,3359,41594,49941,4242,06607
8600000US06608,9873,4806,5067,33762,46928,4231,06608
8600000US06610,18169,8406,9763,46210,60083,4106,06610
8600000US06611,27378,13056,14322,118707,146377,6749,06611
8600000US06612,5750,2906,2844,142841,185186,17796,06612
8600000US06614,27323,12680,14643,83793,103385,4334,06614
8600000US06615,14999,6506,8493,62690,79911,4423,06615
8600000US06702,2682,1339,1343,12157,18010,3134,06702
8600000US06704,18538,8442,10096,40135,51414,2796,06704
8600000US06705,19174,9092,10082,46154,55998,3420,06705
8600000US06706,10539,4933,5606,41902,56470,5688,06706
8600000US06708,22586,10402,12184,51021,72341,5924,06708
8600000US06710,7643,3546,4097,32227,47573,4845,06710
8600000US06712,7738,3818,3920,100524,113503,8236,06712
8600000US06716,13223,6622,6601,86786,100586,6194,06716
8600000US06750,959,442,517,81125,100684,17971,06750
8600000US06751,2702,1377,1325,92250,122507,16821,06751
8600000US06752,1472,711,761,107321,165639,18071,06752
8600000US06754,1366,701,665,96442,130147,11673,06754
8600000US06755,854,393,461,95143,96811,15818,06755
8600000US06756,2297,1127,1170,100167,118163,14420,06756
8600000US06757,1669,761,908,64279,94051,14253,06757
8600000US06758,280,138,142,115179,147924,37877,06758
8600000US06759,4772,2031,2741,86349,118766,11372,06759
8600000US06762,6117,2868,3249,109091,134861,9805,06762
8600000US06763,1519,754,765,85380,127174,25285,06763
8600000US06770,24721,12404,12317,70638,94907,9968,06770
8600000US06776,21074,10176,10898,85977,109166,5504,06776
8600000US06777,1145,594,551,96087,123720,19876,06777
8600000US06778,1132,617,515,63505,80925,18390,06778
8600000US06779,6621,3283,3338,68165,78556,6455,06779
8600000US06782,2023,897,1126,86324,100576,14239,06782
8600000US06783,1687,869,818,133125,207284,30925,06783
8600000US06784,3011,1484,1527,112400,179146,33320,06784
8600000US06785,584,295,289,74773,141340,62950,06785
8600000US06786,7729,3722,4007,77528,92150,7430,06786
8600000US06787,6245,3159,3086,67500,81239,5683,06787
8600000US06790,27960,13584,14376,63514,74313,2420,06790
8600000US06791,4273,2196,2077,108355,122694,8643,06791
8600000US06793,1205,654,551,99861,261732,115445,06793
8600000US06794,845,424,421,94813,148326,45208,06794
8600000US06795,10982,5415,5567,89132,114739,10001,06795
8600000US06796,801,390,411,91071,150540,29015,06796
8600000US06798,7664,3618,4046,78025,115481,12968,06798
8600000US06801,15129,7186,7943,101306,121076,7976,06801
8600000US06804,13199,6426,6773,107955,134769,10265,06804
8600000US06807,5408,2555,2853,148095,238584,41779,06807
8600000US06810,40761,20633,20128,61220,78361,3680,06810
8600000US06811,25898,13021,12877,93819,119668,7321,06811
8600000US06812,10989,5457,5532,107089,140346,13362,06812
8600000US06820,14630,6996,7634,210511,352839,23031,06820
8600000US06824,26592,12490,14102,144360,211143,11854,06824
8600000US06825,17324,8014,9310,111970,144566,7708,06825
8600000US06830,19312,8937,10375,109250,244086,17970,06830
8600000US06831,11560,5439,6121,155417,305181,29841,06831
8600000US06840,14304,6558,7746,192428,338765,22160,06840
8600000US06850,15052,7376,7676,91331,120707,6829,06850
8600000US06851,21591,10040,11551,93261,125011,7199,06851
8600000US06853,2834,1308,1526,169219,287531,45062,06853
8600000US06854,23604,11916,11688,66071,96966,7092,06854
8600000US06855,7067,3216,3851,71968,107266,9337,06855
8600000US06856,5,5,0,,,,06856
8600000US06870,5098,2392,2706,220642,313926,36704,06870
8600000US06877,18004,8682,9322,158441,223279,13341,06877
8600000US06878,5517,2573,2944,182386,318515,29396,06878
8600000US06880,20490,9763,10727,186290,307338,17320,06880
8600000US06883,7173,3501,3672,219083,292611,26136,06883
8600000US06890,3294,1632,1662,191513,256378,39597,06890
8600000US06896,7123,3355,3768,128164,173001,16770,06896
8600000US06897,13252,6525,6727,187903,258760,15779,06897
8600000US06901,6259,3067,3192,73441,112326,14230,06901
8600000US06902,54543,26824,27719,72961,114544,5364,06902
8600000US06903,11246,5489,5757,208866,285306,20499,06903
8600000US06905,16359,7842,8517,122723,158303,11898,06905
8600000US06906,6775,3252,3523,95458,121360,12413,06906
8600000US06907,7038,3362,3676,88409,127526,14149,06907
8600000US07001,14750,9327,5423,71943,86659,6112,07001
8600000US07002,49947,24277,25670,59924,80094,2959,07002
8600000US07003,38667,18326,20341,76487,93410,3523,07003
8600000US07004,5789,2815,2974,117750,141713,17757,07004
8600000US07005,11778,5920,5858,111380,140197,8125,07005
8600000US07006,20232,9369,10863,117828,162381,10587,07006
8600000US07008,18140,8299,9841,74676,82317,5510,07008
8600000US07009,10311,4462,5849,119946,147239,10134,07009
8600000US07010,21155,9757,11398,66952,98741,8197,07010
8600000US07011,31300,14848,16452,57517,75118,3084,07011
8600000US07012,9684,4608,5076,80881,100323,7666,07012
8600000US07013,22206,10292,11914,91963,106995,5555,07013
8600000US07014,3810,1998,1812,93023,103799,12356,07014
8600000US07016,18250,8708,9542,126655,147335,6351,07016
8600000US07017,27227,12137,15090,44805,59429,3346,07017
8600000US07018,22073,9932,12141,44869,59239,3876,07018
8600000US07020,9869,4678,5191,107143,131624,9444,07020
8600000US07021,1592,744,848,198750,285033,28939,07021
8600000US07022,11781,5666,6115,57706,70766,7867,07022
8600000US07023,5473,2526,2947,133452,159749,16389,07023
8600000US07024,30872,14041,16831,78151,104419,4978,07024
8600000US07026,24442,11663,12779,57181,74633,4446,07026
8600000US07027,3481,1734,1747,84896,111418,15478,07027
8600000US07028,5187,2543,2644,213138,270235,26360,07028
8600000US07029,14784,7363,7421,65377,84933,5003,07029
8600000US07030,46021,23041,22980,136402,179824,6027,07030
8600000US07031,12791,6338,6453,75291,98573,7923,07031
8600000US07032,32676,16760,15916,67284,81469,3467,07032
8600000US07033,6398,2978,3420,98624,135465,37040,07033
8600000US07034,7304,3676,3628,85293,97881,8973,07034
8600000US07035,8478,4159,4319,93377,101102,5879,07035
8600000US07036,34348,16294,18054,68531,80200,3134,07036
8600000US07039,22089,10654,11435,163403,215158,11860,07039
8600000US07040,17377,8404,8973,131607,176675,9259,07040
8600000US07041,5009,2357,2652,109167,189098,18030,07041
8600000US07042,19957,9431,10526,103345,151807,9315,07042
8600000US07043,9147,4343,4804,191706,261349,18658,07043
8600000US07044,10612,4958,5654,120408,145172,10233,07044
8600000US07045,8326,3804,4522,166429,210456,21975,07045
8600000US07046,2983,1382,1601,212426,302282,31085,07046
8600000US07047,48904,23915,24989,61734,81262,5027,07047
8600000US07050,23133,9606,13527,38526,51969,3660,07050
8600000US07052,37457,17407,20050,99845,135965,7013,07052
8600000US07054,24084,11557,12527,94665,119165,4293,07054
8600000US07055,47785,24183,23602,36288,56565,2376,07055
8600000US07057,9547,4466,5081,65212,88557,9612,07057
8600000US07058,3746,1755,1991,136122,156490,21844,07058
8600000US07059,12171,5767,6404,165030,240018,14912,07059
8600000US07060,35076,17758,17318,58796,75889,4623,07060
8600000US07062,9369,4328,5041,71004,88093,8492,07062
8600000US07063,10134,4909,5225,71144,86799,8518,07063
8600000US07064,3094,1479,1615,82361,92248,7619,07064
8600000US07065,23402,11365,12037,74164,94727,6314,07065
8600000US07066,12737,5859,6878,100464,125173,8898,07066
8600000US07067,14581,6964,7617,105330,121770,5894,07067
8600000US07068,4683,2199,2484,126250,169976,23869,07068
8600000US07069,4661,2063,2598,153707,194644,28119,07069
8600000US07070,14530,6804,7726,96384,124650,8087,07070
8600000US07071,18062,9100,8962,78036,94388,6052,07071
8600000US07072,5022,2411,2611,100792,109025,14107,07072
8600000US07073,7751,3816,3935,78429,89626,8355,07073
8600000US07074,2097,992,1105,65688,81418,7820,07074
8600000US07075,6858,3167,3691,92989,112328,9897,07075
8600000US07076,18659,8883,9776,128750,164965,10549,07076
8600000US07077,1907,871,1036,77396,95952,12749,07077
8600000US07078,8691,4236,4455,,388136,26155,07078
8600000US07079,13272,6294,6978,133281,187103,10014,07079
8600000US07080,18758,9252,9506,100573,109790,3849,07080
8600000US07081,13866,6214,7652,114296,137939,7362,07081
8600000US07082,3911,1925,1986,116791,156308,20432,07082
8600000US07083,45198,21714,23484,87952,103988,4661,07083
8600000US07086,11937,6156,5781,94544,136506,8466,07086
8600000US07087,52937,25925,27012,45620,62028,2528,07087
8600000US07088,2696,1039,1657,52299,67941,12265,07088
8600000US07090,21314,10002,11312,168983,230014,14611,07090
8600000US07092,5305,2423,2882,130345,170135,19824,07092
8600000US07093,50984,24514,26470,54824,75388,3567,07093
8600000US07094,15685,7440,8245,101184,122610,7233,07094
8600000US07095,15242,7620,7622,82917,94662,4434,07095
8600000US07102,10978,5720,5258,25351,43875,5231,07102
8600000US07103,23841,10359,13482,29304,43242,2529,07103
8600000US07104,37967,18646,19321,36799,53009,3032,07104
8600000US07105,40835,22367,18468,44721,59588,3187,07105
8600000US07106,24970,11217,13753,39562,55554,4670,07106
8600000US07107,27076,12620,14456,31366,46432,2396,07107
8600000US07108,15462,6507,8955,26317,40531,2971,07108
8600000US07109,28490,13842,14648,70054,84975,3405,07109
8600000US07110,22575,10383,12192,95259,115143,4567,07110
8600000US07111,40945,18719,22226,41868,54663,2769,07111
8600000US07112,19291,8524,10767,35680,54460,5048,07112
8600000US07114,10332,6543,3789,26970,42783,5583,07114
8600000US07201,20609,10914,9695,46160,58990,3637,07201
8600000US07202,31360,15219,16141,48527,60907,2996,07202
8600000US07203,16922,7837,9085,61804,76158,4431,07203
8600000US07204,10542,5200,5342,71846,91148,6910,07204
8600000US07205,17214,7949,9265,71102,84074,5136,07205
8600000US07206,18679,9274,9405,44048,54131,2478,07206
8600000US07208,23359,11710,11649,47728,65100,3859,07208
8600000US07302,37363,18797,18566,123617,157785,5864,07302
8600000US07304,33231,15834,17397,48238,66152,3227,07304
8600000US07305,48597,22118,26479,51755,73497,3063,07305
8600000US07306,42628,22613,20015,53327,73849,3082,07306
8600000US07307,33557,16963,16594,62562,79900,3980,07307
8600000US07310,11337,6099,5238,153657,183258,15743,07310
8600000US07311,385,222,163,186780,245834,77815,07311
8600000US07401,4809,2133,2676,158977,213772,26873,07401
8600000US07403,6365,2777,3588,90372,108124,10296,07403
8600000US07405,13768,6819,6949,116692,148302,7869,07405
8600000US07407,15704,7593,8111,77887,89503,4060,07407
8600000US07410,25728,12131,13597,115512,135295,6338,07410
8600000US07416,4218,2079,2139,69085,83118,10628,07416
8600000US07417,8453,4146,4307,159883,229048,20012,07417
8600000US07418,1810,996,814,130563,133978,19199,07418
8600000US07419,6946,3413,3533,88339,103052,8024,07419
8600000US07420,4032,2035,1997,81737,89486,7881,07420
8600000US07421,5846,2979,2867,92274,111407,10741,07421
8600000US07422,5222,2539,2683,93217,108611,11037,07422
8600000US07423,2900,1317,1583,191645,242914,30708,07423
8600000US07424,21787,9937,11850,85254,109717,6248,07424
8600000US07430,21263,9684,11579,104800,145450,10532,07430
8600000US07432,5550,2705,2845,119231,134365,13392,07432
8600000US07435,2039,1033,1006,121599,158746,27715,07435
8600000US07436,9804,4770,5034,117996,147683,8804,07436
8600000US07438,8975,4420,4555,109539,124644,8222,07438
8600000US07439,1900,1039,861,90402,109381,14652,07439
8600000US07440,3245,1536,1709,117159,138633,20827,07440
8600000US07442,8856,4588,4268,97782,109142,7523,07442
8600000US07444,9146,4118,5028,94121,120636,11782,07444
8600000US07446,11335,5611,5724,144491,184213,15006,07446
8600000US07450,17588,8260,9328,168807,233226,11084,07450
8600000US07452,8329,4058,4271,166450,206279,16804,07452
8600000US07456,9194,4510,4684,128272,141361,7037,07456
8600000US07457,3430,1609,1821,109851,123449,10146,07457
8600000US07458,8509,4404,4105,168125,272175,27759,07458
8600000US07460,2842,1450,1392,109688,126974,14170,07460
8600000US07461,14737,6930,7807,86178,100556,5926,07461
8600000US07462,5015,2639,2376,84574,100487,8060,07462
8600000US07463,7507,3553,3954,119434,135458,10539,07463
8600000US07465,5600,2744,2856,95915,129627,15690,07465
8600000US07470,43262,20648,22614,118044,143720,5553,07470
8600000US07480,12950,6257,6693,99178,112707,8280,07480
8600000US07481,12751,6033,6718,150329,202124,13581,07481
8600000US07495,0,0,0,,,,07495
8600000US07501,23372,11442,11930,28159,42423,2804,07501
8600000US07502,12189,5683,6506,55726,76987,9687,07502
8600000US07503,13425,6924,6501,43921,57472,4710,07503
8600000US07504,9174,4310,4864,58818,70680,6612,07504
8600000US07505,2046,1092,954,19625,33768,5697,07505
8600000US07506,14830,7327,7503,96250,110506,7281,07506
8600000US07508,17536,8264,9272,77468,100399,7496,07508
8600000US07512,8903,4041,4862,101321,123368,10150,07512
8600000US07513,9172,4433,4739,43305,55098,5097,07513
8600000US07514,13817,6446,7371,42483,53755,5917,07514
8600000US07522,13739,5665,8074,33543,43749,3256,07522
8600000US07524,9447,4461,4986,37333,57594,12338,07524
8600000US07601,36457,17535,18922,67188,79556,3558,07601
8600000US07603,6776,3058,3718,83517,95378,8326,07603
8600000US07604,9634,4440,5194,91911,116237,12228,07604
8600000US07605,7090,3427,3663,96131,130943,13735,07605
8600000US07606,2085,1024,1061,70735,92049,14771,07606
8600000US07607,7735,3479,4256,88143,120771,13522,07607
8600000US07608,79,48,31,28750,44329,19678,07608
8600000US07620,1171,545,626,124844,240688,45731,07620
8600000US07621,21311,10029,11282,96713,113788,5381,07621
8600000US07624,6516,3231,3285,132719,174233,18971,07624
8600000US07626,6330,2944,3386,138256,189558,32323,07626
8600000US07627,3678,1721,1957,158906,244060,37414,07627
8600000US07628,14155,6761,7394,96017,122868,15305,07628
8600000US07630,5822,2686,3136,123808,134490,15656,07630
8600000US07631,22220,10684,11536,84054,127665,8249,07631
8600000US07632,4170,2062,2108,146944,212904,35854,07632
8600000US07640,3445,1691,1754,128380,169376,16880,07640
8600000US07641,2520,1245,1275,173750,204745,20399,07641
8600000US07642,7873,3645,4228,140694,155656,9982,07642
8600000US07643,9180,4422,4758,61144,79616,8723,07643
8600000US07644,19752,9548,10204,60651,79956,6679,07644
8600000US07645,6341,2880,3461,128641,174231,27143,07645
8600000US07646,13188,6266,6922,91900,120117,7680,07646
8600000US07647,4248,2091,2157,109567,132723,13191,07647
8600000US07648,4657,2119,2538,127386,174052,24280,07648
8600000US07649,6081,2935,3146,146103,178889,12456,07649
8600000US07650,17328,8810,8518,64626,86300,6141,07650
8600000US07652,21471,10420,11051,117087,142803,9199,07652
8600000US07656,6838,3419,3419,118560,147933,9858,07656
8600000US07657,9094,4588,4506,67500,90987,9028,07657
8600000US07660,10230,4993,5237,80450,100608,7219,07660
8600000US07661,8683,4235,4448,123409,144868,11275,07661
8600000US07662,4631,2105,2526,81394,100098,13152,07662
8600000US07663,11385,5735,5650,99094,107173,8431,07663
8600000US07666,30993,14668,16325,109677,145879,6861,07666
8600000US07670,10058,4805,5253,159722,230838,20787,07670
8600000US07675,20665,9858,10807,124346,167020,9583,07675
8600000US07676,7215,3508,3707,131875,147199,10333,07676
8600000US07677,4479,2035,2444,167344,229367,26619,07677
8600000US07701,18888,9030,9858,82474,121893,7716,07701
8600000US07702,3092,1381,1711,124500,164128,22803,07702
8600000US07703,57,17,40,,,,07703
8600000US07704,3912,1883,2029,170625,222880,23907,07704
8600000US07711,1264,660,604,126667,200269,38880,07711
8600000US07712,30608,14415,16193,64852,94137,4055,07712
8600000US07716,6899,3612,3287,96693,136874,17131,07716
8600000US07717,1488,655,833,88594,147099,22084,07717
8600000US07718,5431,2645,2786,112944,125033,12023,07718
8600000US07719,17527,8707,8820,95206,117390,6301,07719
8600000US07720,3630,1733,1897,60362,109098,22255,07720
8600000US07721,2311,1168,1143,73211,91826,8638,07721
8600000US07722,7443,3587,3856,160048,219262,20696,07722
8600000US07723,571,272,299,65982,145801,34867,07723
8600000US07724,16961,8464,8497,79060,109519,9249,07724
8600000US07726,33757,15468,18289,111484,145181,5651,07726
8600000US07727,5607,2609,2998,80438,109574,10429,07727
8600000US07728,42934,20459,22475,89484,117825,4859,07728
8600000US07730,13385,6134,7251,101118,114449,6187,07730
8600000US07731,29354,14408,14946,106371,123296,4794,07731
8600000US07732,4438,2435,2003,59234,91322,19612,07732
8600000US07733,12779,5966,6813,154187,203451,17173,07733
8600000US07734,10237,4950,5287,56398,76225,10650,07734
8600000US07735,14924,7007,7917,72015,85812,5357,07735
8600000US07737,3142,1449,1693,97232,107899,11832,07737
8600000US07738,4712,2342,2370,142896,157083,15158,07738
8600000US07739,4277,1930,2347,162232,228699,31197,07739
8600000US07740,23891,11750,12141,58652,83986,4737,07740
8600000US07746,13916,6609,7307,149401,183071,11196,07746
8600000US07747,24826,11773,13053,103580,122749,4129,07747
8600000US07748,21200,10561,10639,116076,144213,7330,07748
8600000US07750,2628,1216,1412,133295,171312,21282,07750
8600000US07751,14369,6941,7428,148265,190763,16265,07751
8600000US07753,30631,14337,16294,70994,87861,3794,07753
8600000US07755,4539,2230,2309,94886,116578,9977,07755
8600000US07756,3022,1169,1853,61199,91782,20509,07756
8600000US07757,4502,2191,2311,110329,119113,12216,07757
8600000US07758,3165,1493,1672,95186,120112,14011,07758
8600000US07760,6306,3078,3228,153942,287632,21849,07760
8600000US07762,6981,3419,3562,84368,120586,12168,07762
8600000US07764,6276,2812,3464,104566,124351,11884,07764
8600000US07801,19309,9708,9601,71485,86716,7856,07801
8600000US07803,2787,1402,1385,95268,99257,7931,07803
8600000US07820,36,36,0,,,,07820
8600000US07821,7229,3611,3618,107982,122431,7938,07821
8600000US07822,475,245,230,67813,84163,16649,07822
8600000US07823,6546,3011,3535,57917,76119,6548,07823
8600000US07825,7642,3925,3717,99896,118732,8667,07825
8600000US07826,4708,2388,2320,82469,103012,7663,07826
8600000US07827,3304,1731,1573,69792,81728,9083,07827
8600000US07828,11709,5906,5803,74616,101883,12442,07828
8600000US07830,5148,2406,2742,128504,161954,18179,07830
8600000US07832,2966,1461,1505,97872,118496,12515,07832
8600000US07833,132,78,54,48819,88024,46515,07833
8600000US07834,14104,6620,7484,119829,151201,9881,07834
8600000US07836,8983,4272,4711,113198,160126,25973,07836
8600000US07838,2559,1331,1228,107237,123007,13099,07838
8600000US07840,23610,11693,11917,80740,103492,4853,07840
8600000US07842,77,38,39,,132277,51291,07842
8600000US07843,9327,4636,4691,81317,98751,7044,07843
8600000US07846,19,10,9,,,,07846
8600000US07847,1380,710,670,111994,119951,14570,07847
8600000US07848,4157,1980,2177,83063,127672,17547,07848
8600000US07849,7146,3632,3514,93180,115037,11677,07849
8600000US07850,4567,2230,2337,89397,100546,8500,07850
8600000US07851,61,34,27,127000,128480,23284,07851
8600000US07852,3089,1351,1738,82000,114649,14435,07852
8600000US07853,9516,4634,4882,162693,177638,10161,07853
8600000US07856,4044,1906,2138,91917,127447,28260,07856
8600000US07857,2741,1350,1391,61761,82193,9782,07857
8600000US07860,20587,10413,10174,84000,102762,5240,07860
8600000US07863,3104,1518,1586,82768,93124,8397,07863
8600000US07865,1614,780,834,125186,130675,25148,07865
8600000US07866,18001,8792,9209,105733,126793,6976,07866
8600000US07869,19616,9534,10082,128596,166733,9100,07869
8600000US07870,28,13,15,,,,07870
8600000US07871,15184,7116,8068,130273,162241,11090,07871
8600000US07874,6492,3149,3343,93058,101780,5812,07874
8600000US07876,8387,4084,4303,125634,146248,11063,07876
8600000US07878,610,227,383,98938,115960,24305,07878
8600000US07880,263,171,92,192682,162643,37776,07880
8600000US07881,6,2,4,,51300,37012,07881
8600000US07882,11425,5514,5911,92942,104428,6299,07882
8600000US07885,7681,3736,3945,73763,93247,7208,07885
8600000US07901,16836,8081,8755,139919,234258,14007,07901
8600000US07920,19942,9527,10415,145942,204518,11402,07920
8600000US07921,6444,2854,3590,118042,146423,12746,07921
8600000US07922,9313,4353,4960,167639,209901,15077,07922
8600000US07924,5622,2952,2670,159970,244458,33250,07924
8600000US07926,11,0,11,,,,07926
8600000US07927,3002,1565,1437,119569,141635,15893,07927
8600000US07928,13254,6354,6900,177564,269741,14934,07928
8600000US07930,6294,3037,3257,144649,203265,19371,07930
8600000US07931,2360,1229,1131,190577,341348,56250,07931
8600000US07932,8053,3887,4166,126492,168828,15987,07932
8600000US07933,2672,1329,1343,145361,186421,32230,07933
8600000US07934,1141,489,652,150833,207511,46058,07934
8600000US07935,296,87,209,138611,235005,148449,07935
8600000US07936,8990,4056,4934,129659,155644,14569,07936
8600000US07939,202,202,0,,,,07939
8600000US07940,13251,6120,7131,133333,194180,13866,07940
8600000US07945,6713,3185,3528,178984,260956,27479,07945
8600000US07946,2376,1210,1166,166063,209918,26842,07946
8600000US07950,15151,7438,7713,125000,150132,7993,07950
8600000US07960,36922,17993,18929,118578,169422,7858,07960
8600000US07961,0,0,0,,,,07961
8600000US07970,178,57,121,238108,204300,61936,07970
8600000US07974,8969,4306,4663,146615,188987,14674,07974
8600000US07976,569,291,278,93750,150770,49389,07976
8600000US07977,431,190,241,85833,115655,31831,07977
8600000US07979,391,158,233,133197,192723,91004,07979
8600000US07980,1701,895,806,127587,168147,39149,07980
8600000US07981,7180,3373,3807,110025,139450,10593,07981
8600000US08001,639,378,261,70404,77003,16753,08001
8600000US08002,17886,8468,9418,80153,104931,7048,08002
8600000US08003,23112,11360,11752,125958,158657,8170,08003
8600000US08004,9757,4729,5028,91035,103695,11144,08004
8600000US08005,18863,8895,9968,73053,88257,5645,08005
8600000US08006,342,147,195,64306,95627,24887,08006
8600000US08007,3977,1951,2026,72000,83401,10022,08007
8600000US08008,6499,2967,3532,85343,132583,11000,08008
8600000US08009,10304,4928,5376,83024,94339,7016,08009
8600000US08010,8914,3964,4950,65172,81333,8259,08010
8600000US08011,20,11,9,,,,08011
8600000US08012,30679,15089,15590,72597,85215,3298,08012
8600000US08014,421,244,177,103295,104902,16709,08014
8600000US08015,15080,7458,7622,65349,74773,4206,08015
8600000US08016,25656,12102,13554,78898,94799,4759,08016
8600000US08019,798,422,376,99063,105967,13402,08019
8600000US08020,2281,1116,1165,88110,100926,15160,08020
8600000US08021,34296,15612,18684,51183,65216,2440,08021
8600000US08022,7507,3571,3936,94864,118461,11933,08022
8600000US08023,271,123,148,28708,43096,14177,08023
8600000US08026,1727,796,931,82069,101525,8356,08026
8600000US08027,3785,1725,2060,72601,78185,6983,08027
8600000US08028,17059,8520,8539,70460,81931,5009,08028
8600000US08029,3682,1786,1896,53486,69309,8101,08029
8600000US08030,9856,4681,5175,57093,67102,3959,08030
8600000US08031,9004,4590,4414,54447,67709,4291,08031
8600000US08033,11959,5769,6190,120188,168045,9779,08033
8600000US08034,14396,6798,7598,92841,110178,5346,08034
8600000US08035,6099,2705,3394,94479,115701,7677,08035
8600000US08036,4633,2254,2379,109133,142102,20584,08036
8600000US08037,18793,9502,9291,73388,93731,5988,08037
8600000US08038,66,31,35,51607,94891,46169,08038
8600000US08039,72,35,37,71136,77375,20788,08039
8600000US08041,723,359,364,126023,123642,18461,08041
8600000US08042,149,73,76,155417,149703,45435,08042
8600000US08043,23305,10956,12349,92361,131587,9457,08043
8600000US08045,2318,1010,1308,64517,71002,8187,08045
8600000US08046,25162,11418,13744,74083,85505,3557,08046
8600000US08048,9363,4364,4999,86800,117328,7174,08048
8600000US08049,4378,2189,2189,61250,71409,5378,08049
8600000US08050,19769,9401,10368,76512,100852,8036,08050
8600000US08051,8216,3561,4655,80525,96540,7990,08051
8600000US08052,15223,7346,7877,56944,72263,4523,08052
8600000US08053,35556,16793,18763,97036,119427,4183,08053
8600000US08054,32999,15284,17715,94719,124503,5641,08054
8600000US08055,21051,10346,10705,118365,148451,8124,08055
8600000US08056,3257,1576,1681,163125,173468,16612,08056
8600000US08057,15673,7273,8400,140802,198969,18020,08057
8600000US08059,4527,2120,2407,69040,78181,11132,08059
8600000US08060,18998,9312,9686,86706,103721,8188,08060
8600000US08061,1981,870,1111,141429,142668,13814,08061
8600000US08062,11592,5639,5953,130417,148758,7717,08062
8600000US08063,2399,1121,1278,64609,72052,7081,08063
8600000US08064,192,61,131,,,,08064
8600000US08065,5891,2900,2991,70714,82053,4553,08065
8600000US08066,7044,3237,3807,49762,62545,6796,08066
8600000US08067,1217,623,594,90417,107290,12828,08067
8600000US08068,5826,2903,2923,60351,83121,8520,08068
8600000US08069,9892,4729,5163,49347,62474,4388,08069
8600000US08070,9775,4599,5176,64508,87982,17529,08070
8600000US08071,7515,3439,4076,78077,88857,5409,08071
8600000US08072,263,105,158,71094,82535,21352,08072
8600000US08073,147,61,86,242629,183305,72698,08073
8600000US08074,15,7,8,,,,08074
8600000US08075,22780,10848,11932,76777,93821,4885,08075
8600000US08077,15417,7529,7888,101807,124714,5626,08077
8600000US08078,6498,2963,3535,61506,70536,4595,08078
8600000US08079,7471,3413,4058,42736,67167,5014,08079
8600000US08080,28961,13868,15093,99432,125099,6094,08080
8600000US08081,37623,17783,19840,86806,100177,5605,08081
8600000US08083,8066,3937,4129,76504,91881,5055,08083
8600000US08084,5566,2589,2977,79950,90326,5793,08084
8600000US08085,14834,7055,7779,121032,138869,9090,08085
8600000US08086,6353,3036,3317,79885,99028,7129,08086
8600000US08087,20195,9792,10403,65620,79544,5070,08087
8600000US08088,19044,9388,9656,78910,99699,5140,08088
8600000US08089,3447,1688,1759,63789,76726,7281,08089
8600000US08090,6269,3260,3009,89450,100627,5573,08090
8600000US08091,4430,1980,2450,65050,74629,10829,08091
8600000US08092,2823,1452,1371,74469,93954,8622,08092
8600000US08093,7187,3441,3746,54747,76454,8376,08093
8600000US08094,30855,14835,16020,80712,90802,2993,08094
8600000US08095,36,0,36,,,,08095
8600000US08096,28312,13386,14926,70151,88257,3729,08096
8600000US08097,2533,1287,1246,81619,94663,8332,08097
8600000US08098,7490,3708,3782,88390,101966,7815,08098
8600000US08102,5752,2564,3188,21016,35733,5886,08102
8600000US08103,10246,5268,4978,28065,43343,6073,08103
8600000US08104,15081,6146,8935,23744,33659,2940,08104
8600000US08105,19378,9132,10246,31918,45157,3698,08105
8600000US08106,8009,3790,4219,77238,90357,4290,08106
8600000US08107,10074,4905,5169,54957,72144,5021,08107
8600000US08108,14619,6870,7749,91957,108486,5939,08108
8600000US08109,17408,8248,9160,67673,78213,4002,08109
8600000US08110,13957,6637,7320,66875,74342,3997,08110
8600000US08201,8004,3741,4263,68274,85016,9700,08201
8600000US08202,1401,673,728,85625,160707,20587,08202
8600000US08203,7848,3738,4110,71483,90156,5436,08203
8600000US08204,15487,7694,7793,67305,86110,4809,08204
8600000US08205,22453,10066,12387,64894,81331,3722,08205
8600000US08210,13132,6480,6652,69371,93187,10716,08210
8600000US08212,185,78,107,47917,69268,12264,08212
8600000US08215,10678,5458,5220,67049,89055,9594,08215
8600000US08217,25,15,10,,,,08217
8600000US08221,5336,2527,2809,95034,123446,8684,08221
8600000US08223,3388,1560,1828,80224,106391,10474,08223
8600000US08224,419,211,208,75795,89298,18329,08224
8600000US08225,6370,2917,3453,78191,105423,10456,08225
8600000US08226,9187,4188,4999,70871,103073,8019,08226
8600000US08230,4113,1919,2194,91950,108736,11793,08230
8600000US08232,14428,6816,7612,40387,55803,4925,08232
8600000US08234,31422,14604,16818,78534,94144,4981,08234
8600000US08240,2274,923,1351,,,,08240
8600000US08241,978,516,462,111607,127917,20812,08241
8600000US08242,2343,1118,1225,52732,64298,15765,08242
8600000US08243,1786,865,921,77500,108129,11961,08243
8600000US08244,8391,3777,4614,59863,78201,6547,08244
8600000US08246,87,52,35,,,,08246
8600000US08247,905,425,480,108281,170309,22646,08247
8600000US08248,221,125,96,226719,207303,76270,08248
8600000US08251,7778,3688,4090,53468,65060,6483,08251
8600000US08260,11069,5175,5894,47408,77837,11373,08260
8600000US08270,6560,3534,3026,61513,78090,6355,08270
8600000US08302,32920,17506,15414,46639,66529,3658,08302
8600000US08310,1087,609,478,59000,63145,10341,08310
8600000US08311,1655,861,794,61845,73463,9054,08311
8600000US08312,6514,3153,3361,65163,98143,20354,08312
8600000US08314,2892,2696,196,74357,77308,15000,08314
8600000US08316,245,111,134,66016,72936,26758,08316
8600000US08317,1115,512,603,81759,96195,14248,08317
8600000US08318,9691,4767,4924,81797,95624,5501,08318
8600000US08319,968,516,452,99125,104666,9366,08319
8600000US08320,1091,1091,0,,,,08320
8600000US08321,143,78,65,23250,31588,8422,08321
8600000US08322,8512,4247,4265,84298,96707,7107,08322
8600000US08323,487,216,271,73750,90662,11823,08323
8600000US08324,259,144,115,86250,110784,45504,08324
8600000US08326,1147,616,531,66513,103633,40961,08326
8600000US08327,3042,2908,134,66154,63051,16559,08327
8600000US08328,1015,510,505,67250,75301,15201,08328
8600000US08329,233,102,131,66058,63615,21624,08329
8600000US08330,21841,10546,11295,66397,85627,5886,08330
8600000US08332,27185,12945,14240,53110,64848,3101,08332
8600000US08340,889,412,477,89196,101004,30196,08340
8600000US08341,1743,943,800,35802,55321,10710,08341
8600000US08343,4091,2016,2075,105345,116080,8454,08343
8600000US08344,3807,1765,2042,69069,83617,7035,08344
8600000US08345,453,250,203,59125,63771,8141,08345
8600000US08346,482,269,213,37038,52942,23365,08346
8600000US08348,161,68,93,80450,69127,8964,08348
8600000US08349,1368,601,767,36361,52365,7880,08349
8600000US08350,480,209,271,92614,118360,58128,08350
8600000US08352,459,265,194,68594,70514,14054,08352
8600000US08353,291,129,162,56429,70846,13584,08353
8600000US08360,31939,14818,17121,49697,62275,2305,08360
8600000US08361,14805,6793,8012,78330,98036,7397,08361
8600000US08401,28883,14578,14305,27786,47439,3726,08401
8600000US08402,5495,2565,2930,79375,113165,10317,08402
8600000US08403,882,420,462,121208,175393,29483,08403
8600000US08406,8580,4095,4485,55484,81305,6692,08406
8600000US08501,4900,2500,2400,119427,140985,11314,08501
8600000US08502,8122,4014,4108,199750,224372,14573,08502
8600000US08505,14342,6689,7653,88604,108341,6878,08505
8600000US08510,4462,2280,2182,148045,184787,32250,08510
8600000US08511,724,372,352,75962,99635,14108,08511
8600000US08512,8523,4057,4466,89885,141799,12434,08512
8600000US08514,4014,1868,2146,102143,140241,19541,08514
8600000US08515,4722,2690,2032,151406,163396,13599,08515
8600000US08518,4309,1955,2354,56223,90078,9017,08518
8600000US08520,20688,9830,10858,88092,116432,6700,08520
8600000US08525,3834,1920,1914,129688,156516,14714,08525
8600000US08527,43317,20616,22701,90582,104499,3658,08527
8600000US08528,71,29,42,25750,35928,19922,08528
8600000US08530,6466,3675,2791,95888,126336,12278,08530
8600000US08533,5094,2591,2503,105648,117970,13540,08533
8600000US08534,10121,4759,5362,129700,185248,14380,08534
8600000US08535,3661,1958,1703,181065,209893,23285,08535
8600000US08536,14605,7288,7317,105238,131463,8782,08536
8600000US08540,38255,18288,19967,142339,203928,11381,08540
8600000US08542,5209,2856,2353,84958,125352,23026,08542
8600000US08550,14625,7187,7438,195146,230506,13238,08550
8600000US08551,4144,1925,2219,138173,173672,23820,08551
8600000US08553,460,233,227,115156,160777,24059,08553
8600000US08554,3049,1410,1639,84515,96508,10140,08554
8600000US08555,606,309,297,100833,116449,13842,08555
8600000US08558,5503,2576,2927,208148,249583,28115,08558
8600000US08559,4194,2180,2014,111080,139394,20117,08559
8600000US08560,2960,1456,1504,111182,173193,39805,08560
8600000US08561,211,78,133,,105390,36340,08561
8600000US08562,3374,1783,1591,66267,81361,8268,08562
8600000US08608,797,357,440,16442,31291,10811,08608
8600000US08609,10036,5271,4765,34857,43522,4151,08609
8600000US08610,24097,12078,12019,62268,71999,3002,08610
8600000US08611,19083,9945,9138,35720,52516,5576,08611
8600000US08618,30782,14438,16344,44181,63195,3084,08618
8600000US08619,17432,8159,9273,77413,95249,7882,08619
8600000US08620,9901,5285,4616,92225,110044,6924,08620
8600000US08628,7784,3691,4093,89007,99061,8696,08628
8600000US08629,10660,5512,5148,63171,70653,5630,08629
8600000US08638,17540,8423,9117,55510,71898,4310,08638
8600000US08640,6635,5812,823,59327,68122,8096,08640
8600000US08641,2812,1609,1203,65737,74406,5062,08641
8600000US08648,25966,11948,14018,102633,119719,6380,08648
8600000US08690,15460,7042,8418,99809,115939,6540,08690
8600000US08691,12501,5825,6676,127813,147968,7002,08691
8600000US08701,52643,25545,27098,48341,72051,3746,08701
8600000US08720,572,253,319,111000,125059,34102,08720
8600000US08721,15952,7779,8173,81599,97115,5074,08721
8600000US08722,8481,4231,4250,74967,87896,7685,08722
8600000US08723,26178,12403,13775,74269,91526,5140,08723
8600000US08724,33198,16216,16982,78019,103248,5944,08724
8600000US08730,3656,1775,1881,138750,166961,16276,08730
8600000US08731,15548,7791,7757,80979,95606,5845,08731
8600000US08732,1131,508,623,98333,107665,9084,08732
8600000US08733,1992,962,1030,61182,80186,14394,08733
8600000US08734,7204,3341,3863,84580,110668,12634,08734
8600000US08735,3588,1748,1840,74135,109332,12061,08735
8600000US08736,10337,5267,5070,119176,149953,9123,08736
8600000US08738,1088,532,556,84659,167641,31348,08738
8600000US08740,1428,649,779,60345,72289,10878,08740
8600000US08741,2080,960,1120,96250,113731,16012,08741
8600000US08742,19628,9476,10152,91869,119750,5997,08742
8600000US08750,2586,1209,1377,123464,202786,25588,08750
8600000US08751,3675,1696,1979,56985,84985,14855,08751
8600000US08752,1968,947,1021,68750,110532,20156,08752
8600000US08753,49153,23752,25401,79997,97525,3376,08753
8600000US08755,20787,9510,11277,69331,100519,9137,08755
8600000US08757,30065,13189,16876,43932,59569,2980,08757
8600000US08758,6688,3198,3490,66543,81158,7530,08758
8600000US08759,30845,12497,18348,37286,58922,4373,08759
8600000US08801,7271,4642,2629,123608,160750,14855,08801
8600000US08802,3045,1466,1579,128914,158349,18318,08802
8600000US08804,1999,1060,939,83750,110381,13467,08804
8600000US08805,9361,4587,4774,72884,93450,8104,08805
8600000US08807,29823,13835,15988,125700,153753,6225,08807
8600000US08808,142,89,53,73648,63126,18553,08808
8600000US08809,4520,2073,2447,98281,124239,9627,08809
8600000US08810,6657,3155,3502,138203,151693,12136,08810
8600000US08812,10876,5242,5634,96585,129345,13946,08812
8600000US08816,36895,17425,19470,109041,134089,4458,08816
8600000US08817,34732,17541,17191,89538,103501,3305,08817
8600000US08820,29708,14241,15467,126650,150712,5795,08820
8600000US08821,332,157,175,55573,78737,27306,08821
8600000US08822,24494,11472,13022,110671,137192,6651,08822
8600000US08823,7371,3625,3746,112045,124688,15132,08823
8600000US08824,9160,4508,4652,134507,146355,10846,08824
8600000US08825,3556,1743,1813,105368,134658,21932,08825
8600000US08826,4326,2160,2166,103987,118996,10099,08826
8600000US08827,3287,1622,1665,108380,138072,10260,08827
8600000US08828,1861,836,1025,83068,91840,6557,08828
8600000US08829,2791,1367,1424,97016,112320,12375,08829
8600000US08830,14464,7342,7122,95595,111200,5894,08830
8600000US08831,40576,18895,21681,82451,115649,5172,08831
8600000US08832,2200,1243,957,63000,65864,9959,08832
8600000US08833,6858,3316,3542,140027,177244,14904,08833
8600000US08835,7985,3882,4103,69654,77417,4935,08835
8600000US08836,2729,1318,1411,155754,229944,43281,08836
8600000US08837,13570,6495,7075,83870,104048,6875,08837
8600000US08840,12582,6018,6564,122161,154525,9873,08840
8600000US08844,30270,14270,16000,125774,151434,6527,08844
8600000US08846,10531,5068,5463,71061,98420,8825,08846
8600000US08848,6732,3350,3382,102821,126235,8526,08848
8600000US08850,6576,3100,3476,107837,116410,10939,08850
8600000US08852,13378,6465,6913,105649,134938,9545,08852
8600000US08853,3993,1925,2068,140263,165688,18519,08853
8600000US08854,47529,24194,23335,93534,112533,4633,08854
8600000US08857,32153,15150,17003,93730,112353,4146,08857
8600000US08858,95,47,48,,,,08858
8600000US08859,17365,8426,8939,80693,96469,4482,08859
8600000US08861,39397,19010,20387,54072,66478,3280,08861
8600000US08863,9758,4796,4962,90336,100912,6979,08863
8600000US08865,22711,10398,12313,63975,79274,3200,08865
8600000US08867,3991,1974,2017,138300,177360,22752,08867
8600000US08869,6278,2954,3324,78404,102167,7715,08869
8600000US08872,15770,7649,8121,75395,90519,5431,08872
8600000US08873,43351,21045,22306,92357,113298,4377,08873
8600000US08876,17344,8661,8683,95438,120683,6391,08876
8600000US08879,18329,9093,9236,68512,89674,5727,08879
8600000US08880,3468,1749,1719,83155,99764,13150,08880
8600000US08882,12249,6111,6138,68729,85839,6056,08882
8600000US08884,6625,3163,3462,76055,87097,5283,08884
8600000US08886,5420,2606,2814,106837,119088,11346,08886
8600000US08887,865,382,483,89674,101413,12289,08887
8600000US08889,7651,3648,4003,135601,173334,17101,08889
8600000US08890,15,7,8,,,,08890
8600000US08901,44624,21566,23058,42185,55290,2074,08901
8600000US08902,31420,14860,16560,94490,113780,6007,08902
8600000US08904,10912,5179,5733,80846,111121,7918,08904
8600000US10001,20941,10763,10178,88526,151628,15107,10001
8600000US10002,65028,31025,34003,35859,68315,3369,10002
8600000US10003,50805,25163,25642,112131,189885,12283,10003
8600000US10004,2683,1112,1571,157645,218650,32298,10004
8600000US10005,7724,3509,4215,173333,208186,23833,10005
8600000US10006,3005,1416,1589,176250,214543,29839,10006
8600000US10007,5611,3254,2357,246813,367343,34800,10007
8600000US10009,51477,23167,28310,61548,95947,5060,10009
8600000US10010,29820,15469,14351,117923,188064,12471,10010
8600000US10011,45789,23617,22172,128613,207287,15112,10011
8600000US10012,21433,10557,10876,109037,169859,12648,10012
8600000US10013,23895,11621,12274,105442,259828,26885,10013
8600000US10014,28004,14437,13567,126601,203853,10358,10014
8600000US10016,47312,22631,24681,117004,166745,8568,10016
8600000US10017,14639,6662,7977,127506,174635,14441,10017
8600000US10018,9072,4940,4132,108914,154895,15525,10018
8600000US10019,40579,21189,19390,98833,162689,11983,10019
8600000US10020,0,0,0,,,,10020
8600000US10021,38768,17136,21632,118289,222872,18386,10021
8600000US10022,28366,12656,15710,135363,248983,23563,10022
8600000US10023,53922,23138,30784,130452,217812,12487,10023
8600000US10024,48895,21483,27412,131668,249579,12068,10024
8600000US10025,79694,35977,43717,85930,155781,9404,10025
8600000US10026,31784,14457,17327,58884,99903,7158,10026
8600000US10027,53317,24181,29136,46113,81961,4739,10027
8600000US10028,41407,16915,24492,125140,222550,14736,10028
8600000US10029,63605,27932,35673,34016,68078,2854,10029
8600000US10030,24615,10756,13859,37232,72377,6509,10030
8600000US10031,50103,25029,25074,49891,71698,4008,10031
8600000US10032,54903,27544,27359,50391,66845,4177,10032
8600000US10033,48816,24400,24416,58614,75872,3325,10033
8600000US10034,34472,16166,18306,54716,70567,3564,10034
8600000US10035,29241,14441,14800,30081,52121,3739,10035
8600000US10036,25265,13833,11432,91936,130731,7396,10036
8600000US10037,16046,6512,9534,45041,63900,6184,10037
8600000US10038,20170,9235,10935,86058,138542,11666,10038
8600000US10039,20821,8950,11871,39653,61621,8003,10039
8600000US10040,36809,16652,20157,47137,64100,3374,10040
8600000US10044,10237,4753,5484,100441,126465,14747,10044
8600000US10065,24305,9884,14421,127375,242978,18942,10065
8600000US10069,3943,1713,2230,110625,225183,64863,10069
8600000US10075,18066,8177,9889,137146,233358,28469,10075
8600000US10103,0,0,0,,,,10103
8600000US10110,0,0,0,,,,10110
8600000US10111,0,0,0,,,,10111
8600000US10112,0,0,0,,,,10112
8600000US10115,0,0,0,,,,10115
8600000US10119,0,0,0,,,,10119
8600000US10128,50715,21548,29167,114010,196844,9772,10128
8600000US10152,0,0,0,,,,10152
8600000US10153,0,0,0,,,,10153
8600000US10154,0,0,0,,,,10154
8600000US10162,1098,512,586,188880,244032,62011,10162
8600000US10165,0,0,0,,,,10165
8600000US10167,0,0,0,,,,10167
8600000US10168,0,0,0,,,,10168
8600000US10169,0,0,0,,,,10169
8600000US10170,0,0,0,,,,10170
8600000US10171,0,0,0,,,,10171
8600000US10172,0,0,0,,,,10172
8600000US10173,0,0,0,,,,10173
8600000US10174,0,0,0,,,,10174
8600000US10177,0,0,0,,,,10177
8600000US10199,124,23,101,,,,10199
8600000US10271,0,0,0,,,,10271
8600000US10278,0,0,0,,,,10278
8600000US10279,43,18,25,,,,10279
8600000US10280,7442,3400,4042,169844,224631,32209,10280
8600000US10282,3854,1785,2069,,330244,46314,10282
8600000US10301,30230,13875,16355,55802,82103,4361,10301
8600000US10302,13974,7052,6922,64103,80141,5070,10302
8600000US10303,18874,9135,9739,62558,75828,5439,10303
8600000US10304,31293,15150,16143,52199,90003,8244,10304
8600000US10305,33416,15851,17565,76489,91033,3723,10305
8600000US10306,43141,20366,22775,79569,96939,4421,10306
8600000US10307,11584,5673,5911,80893,113474,10270,10307
8600000US10308,24150,11395,12755,93963,108491,5525,10308
8600000US10309,26013,12670,13343,103175,121733,8395,10309
8600000US10310,17509,8239,9270,72093,90754,4128,10310
8600000US10311,0,0,0,,,,10311
8600000US10312,48105,22922,25183,95064,112310,3870,10312
8600000US10314,71309,33519,37790,86742,103927,3890,10314
8600000US10451,35499,15679,19820,28921,49434,5402,10451
8600000US10452,54152,24585,29567,28277,39896,1732,10452
8600000US10453,57229,25275,31954,25275,37719,1530,10453
8600000US10454,26813,12947,13866,21149,35479,2863,10454
8600000US10455,30117,13301,16816,26801,40090,2767,10455
8600000US10456,67251,30465,36786,27106,43257,3399,10456
8600000US10457,51670,23534,28136,27420,41485,2585,10457
8600000US10458,61211,28851,32360,33932,48427,3402,10458
8600000US10459,35194,16168,19026,27687,43297,3075,10459
8600000US10460,43594,19673,23921,26866,41120,2724,10460
8600000US10461,40014,19159,20855,56612,73335,3418,10461
8600000US10462,59940,27529,32411,52409,63952,2434,10462
8600000US10463,56355,25374,30981,58551,83674,3803,10463
8600000US10464,3664,1775,1889,93365,114025,12775,10464
8600000US10465,35489,16676,18813,74796,90281,3276,10465
8600000US10466,56135,24040,32095,51477,68430,2784,10466
8600000US10467,77195,36295,40900,37015,51062,2204,10467
8600000US10468,57419,26445,30974,36046,48780,2327,10468
8600000US10469,58347,26684,31663,63652,78921,2895,10469
8600000US10470,12526,5549,6977,57160,76959,4916,10470
8600000US10471,18423,8491,9932,85707,121901,9184,10471
8600000US10472,50160,23633,26527,30977,46699,2102,10472
8600000US10473,45195,19437,25758,41638,60660,3994,10473
8600000US10474,8599,4441,4158,25493,42633,7384,10474
8600000US10475,35736,14509,21227,50832,63502,4672,10475
8600000US10501,1048,533,515,197321,187580,23035,10501
8600000US10502,4236,2056,2180,163902,201371,19243,10502
8600000US10503,173,71,102,,169221,98621,10503
8600000US10504,5946,2880,3066,208275,315393,38580,10504
8600000US10505,656,267,389,,147444,36789,10505
8600000US10506,4113,1875,2238,222500,362379,51508,10506
8600000US10507,5546,2239,3307,64500,139604,27763,10507
8600000US10509,15090,7611,7479,102372,123525,6200,10509
8600000US10510,7977,3796,4181,167847,247245,19112,10510
8600000US10511,1735,930,805,109375,129267,16623,10511
8600000US10512,19931,9323,10608,97363,121945,8464,10512
8600000US10514,8693,4157,4536,,371511,34949,10514
8600000US10516,4342,2126,2216,102841,144639,16930,10516
8600000US10517,341,154,187,72067,98804,30051,10517
8600000US10518,1041,490,551,198255,218113,50196,10518
8600000US10519,166,66,100,148375,204906,144795,10519
8600000US10520,9952,4720,5232,105670,149069,10715,10520
8600000US10522,8602,4127,4475,138477,203781,25382,10522
8600000US10523,7046,3662,3384,98700,130255,12540,10523
8600000US10524,3500,1713,1787,122419,159306,21512,10524
8600000US10526,1298,596,702,125801,210158,52897,10526
8600000US10527,582,297,285,161583,167671,18328,10527
8600000US10528,9981,4720,5261,120846,194643,16633,10528
8600000US10530,10623,4662,5961,108817,142468,8805,10530
8600000US10532,3842,1895,1947,99167,130121,13637,10532
8600000US10533,5433,2403,3030,144121,235371,43144,10533
8600000US10535,321,69,252,,87418,42193,10535
8600000US10536,8100,3756,4344,175833,255373,26024,10536
8600000US10537,1725,824,901,103021,110617,19793,10537
8600000US10538,11631,5754,5877,177553,278959,24959,10538
8600000US10541,20714,10396,10318,107258,132192,12357,10541
8600000US10543,15951,7680,8271,99124,170835,15074,10543
8600000US10545,119,119,0,,,,10545
8600000US10546,1112,500,612,199250,254481,50434,10546
8600000US10547,6058,2975,3083,117721,120666,13495,10547
8600000US10548,3107,1613,1494,84444,113382,12615,10548
8600000US10549,12607,6519,6088,109450,168201,16486,10549
8600000US10550,28756,12916,15840,47955,63073,3069,10550
8600000US10552,16446,6849,9597,74427,95743,6989,10552
8600000US10553,7981,3427,4554,71477,85326,8044,10553
8600000US10560,3837,1823,2014,134076,184541,28867,10560
8600000US10562,25172,12769,12403,76793,108662,6244,10562
8600000US10566,18322,8646,9676,54332,75511,5259,10566
8600000US10567,15960,7842,8118,126907,155722,9921,10567
8600000US10570,9562,4500,5062,134545,175369,15889,10570
8600000US10573,29675,14974,14701,82150,124825,8304,10573
8600000US10576,3889,1783,2106,205905,333307,41385,10576
8600000US10577,5610,2521,3089,202583,360640,101454,10577
8600000US10578,653,322,331,110972,144402,38615,10578
8600000US10579,6851,3551,3300,103750,136629,15846,10579
8600000US10580,12242,5810,6432,183871,306094,22110,10580
8600000US10583,29169,13947,15222,201232,310965,13970,10583
8600000US10588,2334,1108,1226,103516,119751,28066,10588
8600000US10589,7336,3117,4219,103239,156140,17398,10589
8600000US10590,5350,2695,2655,144722,190877,20209,10590
8600000US10591,18195,8523,9672,95339,140960,10493,10591
8600000US10594,4059,1904,2155,147115,164687,14261,10594
8600000US10595,6872,3764,3108,110448,143393,18645,10595
8600000US10596,1076,574,502,93533,104651,18998,10596
8600000US10597,645,321,324,,291583,70569,10597
8600000US10598,22442,10384,12058,124555,145873,9318,10598
8600000US10601,9970,4805,5165,65435,117984,14646,10601
8600000US10603,14357,6485,7872,99005,119165,7419,10603
8600000US10604,8818,4412,4406,93692,150328,15317,10604
8600000US10605,14719,6909,7810,111399,154321,10384,10605
8600000US10606,13111,6472,6639,79882,115886,9055,10606
8600000US10607,5880,2969,2911,132141,155198,12895,10607
8600000US10701,45443,21130,24313,44559,68117,3481,10701
8600000US10703,17074,7993,9081,64456,83358,5876,10703
8600000US10704,26231,12741,13490,73165,91186,3573,10704
8600000US10705,31193,15134,16059,48540,70072,4035,10705
8600000US10706,6578,2989,3589,144414,208601,18096,10706
8600000US10707,8151,4018,4133,101419,157220,16215,10707
8600000US10708,17610,7754,9856,106875,183246,9719,10708
8600000US10709,7505,3485,4020,117833,154792,11620,10709
8600000US10710,21423,9971,11452,87760,111793,5663,10710
8600000US10801,33180,16141,17039,64769,93268,5371,10801
8600000US10803,8813,4096,4717,152932,227383,19496,10803
8600000US10804,11201,5409,5792,191773,260301,16639,10804
8600000US10805,15938,7477,8461,71439,91793,7177,10805
8600000US10901,18452,8751,9701,95744,123202,7727,10901
8600000US10910,0,0,0,,,,10910
8600000US10911,0,0,0,,,,10911
8600000US10913,4282,2129,2153,140375,174069,17004,10913
8600000US10914,355,168,187,133047,123187,31872,10914
8600000US10915,83,40,43,,,,10915
8600000US10916,3300,1616,1684,101793,117625,11958,10916
8600000US10917,1414,728,686,109750,148328,28679,10917
8600000US10918,9458,4503,4955,103597,108684,6577,10918
8600000US10919,1180,656,524,102738,97919,16337,10919
8600000US10920,7199,3591,3608,115745,134484,11482,10920
8600000US10921,2906,1424,1482,89239,107977,9634,10921
8600000US10922,1239,631,608,86607,109904,17383,10922
8600000US10923,6428,3159,3269,80149,101994,7849,10923
8600000US10924,10565,5153,5412,101801,126371,10091,10924
8600000US10925,3222,1817,1405,90709,91512,14361,10925
8600000US10926,2647,1282,1365,80625,100255,11692,10926
8600000US10927,8692,4237,4455,61336,82170,8298,10927
8600000US10928,3270,1643,1627,82500,94556,9801,10928
8600000US10930,6617,3333,3284,131111,140994,10591,10930
8600000US10931,750,368,382,70833,84205,10044,10931
8600000US10932,104,31,73,,,,10932
8600000US10933,359,143,216,94808,98639,17890,10933
8600000US10940,37667,17746,19921,61367,78756,3653,10940
8600000US10941,10316,5291,5025,73056,90729,6313,10941
8600000US10950,29240,15136,14104,76637,98042,5441,10950
8600000US10952,22242,10573,11669,56594,86027,5694,10952
8600000US10953,72,22,50,,,,10953
8600000US10954,18494,8596,9898,105698,124810,6030,10954
8600000US10956,24933,11937,12996,133297,164257,8740,10956
8600000US10958,2770,1547,1223,100714,106793,10815,10958
8600000US10960,12643,5996,6647,84983,123517,9544,10960
8600000US10962,4403,2296,2107,110833,150178,21763,10962
8600000US10963,3526,2446,1080,74306,99420,18308,10963
8600000US10964,1107,516,591,124844,198207,54480,10964
8600000US10965,12050,5757,6293,110650,138679,10006,10965
8600000US10968,2054,1095,959,115208,157719,27178,10968
8600000US10969,1109,562,547,102688,117670,29527,10969
8600000US10970,7569,3819,3750,91174,107063,9731,10970
8600000US10973,1632,846,786,95156,108704,17428,10973
8600000US10974,2486,1182,1304,95446,106955,10437,10974
8600000US10975,190,99,91,,194838,132625,10975
8600000US10976,2087,856,1231,63875,99374,18387,10976
8600000US10977,40597,20364,20233,55145,86603,4847,10977
8600000US10979,171,132,39,,,,10979
8600000US10980,11193,5431,5762,105437,117591,6053,10980
8600000US10983,4773,2308,2465,110250,141504,24874,10983
8600000US10984,2293,1029,1264,129315,134317,16486,10984
8600000US10985,189,54,135,176143,163074,40894,10985
8600000US10986,1414,686,728,150625,165059,22321,10986
8600000US10987,2714,1301,1413,105069,154622,14815,10987
8600000US10988,692,295,397,80972,103270,22405,10988
8600000US10989,7459,3268,4191,117368,134716,12167,10989
8600000US10990,15817,7709,8108,101357,122892,9094,10990
8600000US10992,6770,3337,3433,97000,108284,7971,10992
8600000US10993,4031,1980,2051,50559,73926,14378,10993
8600000US10994,5990,2825,3165,148342,159952,14750,10994
8600000US10996,4974,3463,1511,103417,122784,9499,10996
8600000US10998,2334,1213,1121,90567,99800,13877,10998
8600000US11001,22069,10575,11494,108438,130947,5245,11001
8600000US11003,36175,17733,18442,97338,112436,6001,11003
8600000US11004,12638,6150,6488,92657,108778,7689,11004
8600000US11005,1749,604,1145,62993,87343,27609,11005
8600000US11010,19842,9792,10050,108952,119711,5020,11010
8600000US11020,4462,2265,2197,135938,201775,24106,11020
8600000US11021,14368,6310,8058,99170,150359,9530,11021
8600000US11023,6370,3039,3331,116250,175908,14333,11023
8600000US11024,5748,3084,2664,106250,206264,31209,11024
8600000US11030,13802,6391,7411,187159,276534,19079,11030
8600000US11040,33329,15404,17925,124378,151193,6849,11040
8600000US11042,522,232,290,,,,11042
8600000US11050,22832,10724,12108,122845,194169,11778,11050
8600000US11096,6171,2956,3215,56917,73073,7781,11096
8600000US11101,24592,12431,12161,65392,103022,6063,11101
8600000US11102,26130,12712,13418,64067,87613,4287,11102
8600000US11103,31739,15705,16034,71437,87030,3253,11103
8600000US11104,22007,10928,11079,61269,80842,4516,11104
8600000US11105,32130,16099,16031,73959,94627,4399,11105
8600000US11106,32735,15848,16887,63703,80566,3556,11106
8600000US11109,5110,2548,2562,148590,176615,19736,11109
8600000US11201,52356,24684,27672,124996,184989,7909,11201
8600000US11203,59582,25245,34337,51277,67925,2546,11203
8600000US11204,55235,27003,28232,49785,72448,2530,11204
8600000US11205,33669,14902,18767,56708,86795,5508,11205
8600000US11206,63455,29225,34230,36404,61423,2581,11206
8600000US11207,70093,30478,39615,37243,53854,2065,11207
8600000US11208,71812,32382,39430,40733,57398,2066,11208
8600000US11209,55286,26544,28742,72314,98949,3412,11209
8600000US11210,49073,21576,27497,65900,89162,2879,11210
8600000US11211,76731,38045,38686,71225,110045,4499,11211
8600000US11212,59673,23764,35909,26239,43099,3092,11212
8600000US11213,50544,22310,28234,41710,60525,2768,11213
8600000US11214,73333,35434,37899,54041,74409,2570,11214
8600000US11215,55278,26025,29253,123583,171776,5851,11215
8600000US11216,47820,21847,25973,61121,88367,5351,11216
8600000US11217,33833,15679,18154,107362,158932,8435,11217
8600000US11218,53551,26937,26614,69415,93120,3720,11218
8600000US11219,57417,28459,28958,39295,59532,2612,11219
8600000US11220,72844,35960,36884,47079,67304,2364,11220
8600000US11221,66810,31652,35158,50153,72291,3357,11221
8600000US11222,32428,15913,16515,85111,106860,4326,11222
8600000US11223,61594,29364,32230,50108,76767,3338,11223
8600000US11224,37377,16331,21046,33131,54541,3454,11224
8600000US11225,47970,21655,26315,55862,82001,5060,11225
8600000US11226,77635,33906,43729,52052,69166,1781,11226
8600000US11228,35732,17148,18584,67911,95616,3497,11228
8600000US11229,65806,31016,34790,60873,83189,2573,11229
8600000US11230,64125,30183,33942,49541,78385,2953,11230
8600000US11231,29219,13274,15945,100213,156754,9679,11231
8600000US11232,21700,11538,10162,56661,78443,5228,11232
8600000US11233,57633,25485,32148,40449,62884,2585,11233
8600000US11234,73974,34097,39877,81399,102731,4080,11234
8600000US11235,63893,29698,34195,52538,76248,2768,11235
8600000US11236,77889,32788,45101,67669,83059,2321,11236
8600000US11237,38986,20021,18965,51413,69731,3598,11237
8600000US11238,46032,21110,24922,85407,117496,4988,11238
8600000US11239,10600,3926,6674,27104,38283,3195,11239
8600000US11351,0,0,0,,,,11351
8600000US11354,46667,20467,26200,42500,62603,3598,11354
8600000US11355,67322,31530,35792,39207,58478,2481,11355
8600000US11356,18037,8722,9315,60493,77889,5304,11356
8600000US11357,32081,15168,16913,83951,102577,5684,11357
8600000US11358,30683,14935,15748,66129,89248,3387,11358
8600000US11359,0,0,0,,,,11359
8600000US11360,16272,7395,8877,86174,106836,6353,11360
8600000US11361,22522,10758,11764,85887,101199,3863,11361
8600000US11362,15667,7193,8474,89185,105491,5811,11362
8600000US11363,5636,2608,3028,104792,131100,12327,11363
8600000US11364,29559,14124,15435,76988,98555,3562,11364
8600000US11365,35797,16992,18805,66483,85608,5088,11365
8600000US11366,11633,5483,6150,78990,102383,6329,11366
8600000US11367,31817,15022,16795,57933,77653,4069,11367
8600000US11368,81979,43182,38797,50797,63829,2192,11368
8600000US11369,26821,13116,13705,54121,70551,2816,11369
8600000US11370,27390,16471,10919,65098,91997,10767,11370
8600000US11371,0,0,0,,,,11371
8600000US11372,50652,24763,25889,56383,75127,4055,11372
8600000US11373,75399,37647,37752,51183,66968,2534,11373
8600000US11374,36278,16464,19814,63161,81747,3752,11374
8600000US11375,59822,26864,32958,80542,109167,3881,11375
8600000US11377,71633,36759,34874,57010,71990,2016,11377
8600000US11378,28568,13662,14906,73333,92128,4399,11378
8600000US11379,30381,14189,16192,82819,98870,4246,11379
8600000US11385,82984,41069,41915,72261,84423,2208,11385
8600000US11411,17021,7636,9385,93882,108615,4747,11411
8600000US11412,29745,13430,16315,78517,94871,3531,11412
8600000US11413,33234,15006,18228,86324,100730,4108,11413
8600000US11414,23363,10651,12712,71648,100462,9401,11414
8600000US11415,15508,7140,8368,68294,88979,7723,11415
8600000US11416,20650,10106,10544,67461,81027,3198,11416
8600000US11417,24850,12006,12844,73424,88365,4091,11417
8600000US11418,29459,14594,14865,66570,84897,3961,11418
8600000US11419,39597,19517,20080,70882,87311,3734,11419
8600000US11420,38885,18802,20083,67932,91191,4385,11420
8600000US11421,32115,15771,16344,72066,87680,4188,11421
8600000US11422,25667,11511,14156,89235,99628,5100,11422
8600000US11423,25493,12374,13119,70266,90438,4882,11423
8600000US11424,0,0,0,,,,11424
8600000US11425,0,0,0,,,,11425
8600000US11426,16374,8019,8355,88803,107612,6790,11426
8600000US11427,19074,9296,9778,74581,100414,6984,11427
8600000US11428,15145,7329,7816,73699,85921,3903,11428
8600000US11429,22047,10211,11836,83240,96463,4467,11429
8600000US11430,194,184,10,,,,11430
8600000US11432,49144,22768,26376,55906,79095,3308,11432
8600000US11433,27696,12495,15201,51521,69657,4664,11433
8600000US11434,50528,21080,29448,62207,76313,2752,11434
8600000US11435,46827,22751,24076,64086,79861,3914,11435
8600000US11436,15578,7543,8035,75242,93965,6502,11436
8600000US11451,0,0,0,,,,11451
8600000US11501,15974,7374,8600,96079,116776,9962,11501
8600000US11507,5840,2850,2990,129613,175051,13767,11507
8600000US11509,1822,908,914,141250,201727,25415,11509
8600000US11510,26091,12294,13797,108761,123333,5594,11510
8600000US11514,3752,1793,1959,89074,117528,14465,11514
8600000US11516,5324,2561,2763,107440,132643,15131,11516
8600000US11518,8004,4059,3945,100082,120090,11818,11518
8600000US11520,33930,15344,18586,76388,96037,5567,11520
8600000US11530,21660,10271,11389,160598,210189,12225,11530
8600000US11542,22001,10529,11472,78339,109400,6313,11542
8600000US11545,9536,4678,4858,160464,252135,16957,11545
8600000US11547,598,275,323,81500,142133,67663,11547
8600000US11548,2510,1112,1398,133699,206174,61282,11548
8600000US11549,2861,1152,1709,,,,11549
8600000US11550,42740,19825,22915,64097,83240,3431,11550
8600000US11552,19058,9480,9578,117069,137828,6485,11552
8600000US11553,19842,9421,10421,73424,90538,5283,11553
8600000US11554,30306,15214,15092,105192,125239,7165,11554
8600000US11556,0,0,0,,,,11556
8600000US11557,5807,2684,3123,126287,182475,13390,11557
8600000US11558,6870,3728,3142,90753,112374,10007,11558
8600000US11559,6003,2724,3279,108750,222848,34776,11559
8600000US11560,4948,2324,2624,129250,218383,16336,11560
8600000US11561,31772,15028,16744,96163,127426,6441,11561
8600000US11563,17572,8568,9004,97169,123104,8267,11563
8600000US11565,7049,3417,3632,120890,141823,12904,11565
8600000US11566,25626,12481,13145,149367,172400,6772,11566
8600000US11568,3802,1787,2015,192266,362362,50863,11568
8600000US11569,887,470,417,153398,187625,45150,11569
8600000US11570,21015,9829,11186,118309,156793,7287,11570
8600000US11572,23589,11319,12270,115096,136868,6390,11572
8600000US11575,12706,5976,6730,80574,97495,8162,11575
8600000US11576,9461,4414,5047,162715,234445,17332,11576
8600000US11577,9533,4542,4991,139896,200878,14209,11577
8600000US11579,4181,1986,2195,121354,168761,24473,11579
8600000US11580,34194,16019,18175,109470,119825,5273,11580
8600000US11581,16304,7677,8627,108800,132378,6537,11581
8600000US11590,36796,17411,19385,102789,125300,5313,11590
8600000US11596,7991,3820,4171,126017,178899,17202,11596
8600000US11598,9310,4469,4841,141088,188365,18400,11598
8600000US11691,46516,20548,25968,46147,65467,4030,11691
8600000US11692,15067,6506,8561,44024,63908,5265,11692
8600000US11693,10088,4834,5254,59431,77799,8459,11693
8600000US11694,17162,8765,8397,80976,111206,7193,11694
8600000US11697,2769,1404,1365,103580,131013,13741,11697
8600000US11701,22087,10128,11959,82983,99766,6510,11701
8600000US11702,11148,5486,5662,123929,147534,10866,11702
8600000US11703,12569,5695,6874,99189,120036,8609,11703
8600000US11704,31959,15467,16492,90089,104641,5377,11704
8600000US11705,5859,2998,2861,108664,138302,12611,11705
8600000US11706,51059,25454,25605,86808,109537,6031,11706
8600000US11709,5486,2716,2770,105469,133535,14909,11709
8600000US11710,27201,12990,14211,132281,147124,7668,11710
8600000US11713,7298,3440,3858,73380,96518,9625,11713
8600000US11714,18126,8733,9393,106693,124568,7437,11714
8600000US11715,3762,1790,1972,119344,124593,11846,11715
8600000US11716,7885,3956,3929,90830,109456,9725,11716
8600000US11717,46208,22810,23398,76767,96853,6174,11717
8600000US11718,2381,1160,1221,122857,155504,20728,11718
8600000US11719,2851,1296,1555,87813,115218,19454,11719
8600000US11720,22307,10742,11565,106013,121440,5665,11720
8600000US11721,4796,2256,2540,139226,173470,15893,11721
8600000US11722,24703,12128,12575,69360,84220,4963,11722
8600000US11724,2336,1054,1282,,311387,49512,11724
8600000US11725,23455,11350,12105,128369,151635,7191,11725
8600000US11726,16192,7767,8425,73720,91746,6369,11726
8600000US11727,23264,10933,12331,82468,94320,4299,11727
8600000US11729,21408,10077,11331,89858,106385,5210,11729
8600000US11730,10659,5380,5279,122646,142986,10280,11730
8600000US11731,23608,11783,11825,117068,135188,6177,11731
8600000US11732,2959,1350,1609,116786,162510,20936,11732
8600000US11733,13001,6598,6403,146802,190313,10238,11733
8600000US11735,26520,13275,13245,105454,123973,5698,11735
8600000US11738,13489,6875,6614,105182,116760,7490,11738
8600000US11739,726,382,344,142917,209706,50130,11739
8600000US11740,7027,3258,3769,112500,132568,10112,11740
8600000US11741,21618,10868,10750,105410,118131,5155,11741
8600000US11742,9863,4765,5098,101012,123874,10140,11742
8600000US11743,33215,16122,17093,123071,177584,8048,11743
8600000US11746,51445,25504,25941,111002,149939,6601,11746
8600000US11747,15318,7025,8293,122964,166162,15299,11747
8600000US11749,2650,1266,1384,95379,108539,9411,11749
8600000US11751,11688,5714,5974,104381,124595,9430,11751
8600000US11752,7492,3585,3907,107470,123472,9142,11752
8600000US11753,9719,4726,4993,168627,222063,19977,11753
8600000US11754,14312,6558,7754,105500,133578,12366,11754
8600000US11755,9908,4937,4971,109490,133843,8997,11755
8600000US11756,34638,16736,17902,120805,128283,4505,11756
8600000US11757,35690,17688,18002,87225,101830,3908,11757
8600000US11758,42559,20117,22442,114681,139390,4332,11758
8600000US11762,17537,8648,8889,126693,142529,6820,11762
8600000US11763,23151,10732,12419,87500,102252,5456,11763
8600000US11764,9308,4694,4614,123149,137733,13689,11764
8600000US11765,562,281,281,237813,373186,71467,11765
8600000US11766,9596,4664,4932,117283,139360,9607,11766
8600000US11767,11773,5556,6217,121968,138160,11027,11767
8600000US11768,16727,8277,8450,126841,169674,11953,11768
8600000US11769,7262,3350,3912,95987,117113,9049,11769
8600000US11770,48,28,20,120625,123629,54073,11770
8600000US11771,7512,3606,3906,124659,214255,28250,11771
8600000US11772,36203,18198,18005,75856,93285,4598,11772
8600000US11776,19771,9632,10139,100350,115048,7816,11776
8600000US11777,7234,3608,3626,112372,156681,10875,11777
8600000US11778,8779,4422,4357,92731,111765,8289,11778
8600000US11779,29880,14643,15237,93777,104439,4264,11779
8600000US11780,12361,5875,6486,120595,167647,10931,11780
8600000US11782,11708,5547,6161,111581,139098,8562,11782
8600000US11783,16711,8231,8480,128015,147356,7527,11783
8600000US11784,19516,9348,10168,91162,100894,5394,11784
8600000US11786,4477,2282,2195,127092,145304,12689,11786
8600000US11787,26772,12933,13839,125369,147190,6452,11787
8600000US11788,12898,6492,6406,109036,126415,7812,11788
8600000US11789,6641,3206,3435,98148,118451,17012,11789
8600000US11790,14732,7306,7426,137090,163755,17500,11790
8600000US11791,19266,9485,9781,168902,234013,13403,11791
8600000US11792,6738,3431,3307,134803,153562,14946,11792
8600000US11793,24523,11793,12730,130957,153276,8363,11793
8600000US11794,2907,1542,1365,,,,11794
8600000US11795,19802,9418,10384,115506,135155,6493,11795
8600000US11796,3019,1413,1606,101250,118783,12830,11796
8600000US11797,7089,3316,3773,169099,245821,24775,11797
8600000US11798,10893,4963,5930,79771,96386,6285,11798
8600000US11801,33156,16404,16752,106151,124725,7408,11801
8600000US11803,21612,10521,11091,144444,175628,8209,11803
8600000US11804,3813,1812,2001,133281,170418,22191,11804
8600000US11901,22506,11592,10914,63461,83890,6840,11901
8600000US11930,811,377,434,100474,130926,25207,11930
8600000US11931,22,11,11,,,,11931
8600000US11932,949,464,485,104444,153556,38806,11932
8600000US11933,6315,3073,3242,64042,91188,10467,11933
8600000US11934,5949,2857,3092,93512,121251,18796,11934
8600000US11935,2612,1212,1400,94221,117063,18611,11935
8600000US11937,13206,6443,6763,101723,175016,18963,11937
8600000US11939,833,373,460,80694,103823,14711,11939
8600000US11940,4186,2101,2085,102397,123506,14805,11940
8600000US11941,1635,789,846,109545,131785,27077,11941
8600000US11942,3561,1639,1922,86890,116974,12615,11942
8600000US11944,3544,1527,2017,61250,93653,10517,11944
8600000US11946,12271,6092,6179,79516,110102,10057,11946
8600000US11947,511,170,341,,176432,114888,11947
8600000US11948,687,367,320,132813,118512,39052,11948
8600000US11949,11041,5540,5501,95851,118026,11634,11949
8600000US11950,11638,5801,5837,79149,93082,6298,11950
8600000US11951,9870,4895,4975,66057,82512,7485,11951
8600000US11952,4290,2136,2154,92045,125768,33888,11952
8600000US11953,10650,4867,5783,72733,85732,4336,11953
8600000US11954,3171,1698,1473,95278,123111,14242,11954
8600000US11955,3107,1422,1685,62105,87543,14250,11955
8600000US11956,193,87,106,64917,83587,23614,11956
8600000US11957,709,339,370,70250,153268,48730,11957
8600000US11958,679,342,337,,118920,37743,11958
8600000US11959,617,298,319,72917,123098,39512,11959
8600000US11960,596,281,315,87159,120717,26678,11960
8600000US11961,10849,4901,5948,65600,80492,5057,11961
8600000US11962,263,118,145,117500,215906,99467,11962
8600000US11963,5899,2703,3196,88686,151085,16344,11963
8600000US11964,1565,851,714,82686,123115,30371,11964
8600000US11965,545,245,300,120772,121289,32862,11965
8600000US11967,20966,9880,11086,83644,99670,7523,11967
8600000US11968,9007,4329,4678,92500,163490,22786,11968
8600000US11970,264,119,145,,57029,45882,11970
8600000US11971,5176,2685,2491,80771,106622,16893,11971
8600000US11972,965,520,445,100833,114888,33617,11972
8600000US11973,36,22,14,,,,11973
8600000US11975,184,95,89,141000,136923,57273,11975
8600000US11976,1715,822,893,112379,237599,61067,11976
8600000US11977,1883,929,954,112917,159412,26670,11977
8600000US11978,2511,1272,1239,100043,139031,15476,11978
8600000US11980,4656,2741,1915,96983,108560,10377,11980
8600000US12007,0,0,0,,,,12007
8600000US12008,486,222,264,94028,101912,28927,12008
8600000US12009,6320,3347,2973,88958,108665,6848,12009
8600000US12010,22031,10362,11669,46360,61826,3312,12010
8600000US12015,2517,1189,1328,61607,76768,7515,12015
8600000US12017,332,184,148,71429,89229,17921,12017
8600000US12018,5970,3119,2851,89577,102211,8744,12018
8600000US12019,11588,5700,5888,99844,117770,7000,12019
8600000US12020,26351,13260,13091,80952,98365,7817,12020
8600000US12022,541,264,277,54000,66172,13597,12022
8600000US12023,1694,884,810,72411,85823,6318,12023
8600000US12024,0,0,0,,,,12024
8600000US12025,4493,2140,2353,63981,80124,10224,12025
8600000US12027,2874,1414,1460,101058,126222,14455,12027
8600000US12028,741,349,392,67448,99585,32337,12028
8600000US12029,882,425,457,92500,121724,16315,12029
8600000US12031,144,79,65,,41506,16550,12031
8600000US12032,717,356,361,48750,63551,9778,12032
8600000US12033,6493,3069,3424,77340,105616,14647,12033
8600000US12035,655,347,308,37692,53351,11910,12035
8600000US12036,165,93,72,42222,66991,27615,12036
8600000US12037,3740,1764,1976,57841,74758,8865,12037
8600000US12040,131,44,87,40833,39127,13054,12040
8600000US12041,529,256,273,90347,85240,16729,12041
8600000US12042,196,114,82,46250,60584,18701,12042
8600000US12043,6714,3281,3433,51408,65582,5163,12043
8600000US12045,362,174,188,51161,51976,7473,12045
8600000US12046,742,408,334,84650,89467,13018,12046
8600000US12047,17064,7686,9378,56372,72577,4187,12047
8600000US12051,5441,4072,1369,67906,81144,9550,12051
8600000US12052,1277,637,640,75000,80125,9218,12052
8600000US12053,3496,1777,1719,88438,103727,10681,12053
8600000US12054,13089,6023,7066,103424,124745,8067,12054
8600000US12056,2078,1055,1023,88269,99210,9718,12056
8600000US12057,1691,827,864,61875,69724,12580,12057
8600000US12058,1125,557,568,65875,74623,10748,12058
8600000US12059,1349,662,687,79081,90918,8065,12059
8600000US12060,1295,629,666,75469,103456,18880,12060
8600000US12061,7445,3547,3898,93364,111740,8685,12061
8600000US12062,1313,677,636,72115,80703,8967,12062
8600000US12063,292,130,162,77981,87239,47377,12063
8600000US12064,344,171,173,59722,51140,12887,12064
8600000US12065,33642,16301,17341,90544,107143,3190,12065
8600000US12066,1483,761,722,64896,81588,10053,12066
8600000US12067,1318,691,627,86071,94475,15070,12067
8600000US12068,2376,1153,1223,62074,79228,16646,12068
8600000US12069,161,70,91,40625,33842,10976,12069
8600000US12070,1426,701,725,53654,98115,29596,12070
8600000US12071,310,157,153,52625,66999,17760,12071
8600000US12072,2063,1098,965,53542,71086,13244,12072
8600000US12074,2206,1079,1127,81141,89433,10252,12074
8600000US12075,2445,1274,1171,65144,78627,9091,12075
8600000US12076,1276,663,613,58958,64739,5840,12076
8600000US12077,5335,2415,2920,99662,140070,14358,12077
8600000US12078,18717,9391,9326,43135,55865,2394,12078
8600000US12083,2931,1434,1497,79419,84932,8438,12083
8600000US12084,3896,1915,1981,75930,96412,11431,12084
8600000US12085,320,141,179,31902,35751,10059,12085
8600000US12086,1352,654,698,59091,69937,10429,12086
8600000US12087,878,386,492,74167,69781,12421,12087
8600000US12089,115,51,64,97500,84820,20964,12089
8600000US12090,4649,2252,2397,52804,68895,8789,12090
8600000US12092,635,222,413,36701,59718,19782,12092
8600000US12093,1303,665,638,51481,62357,6907,12093
8600000US12094,1817,998,819,83432,89128,11297,12094
8600000US12095,9551,4755,4796,52541,69603,7723,12095
8600000US12106,2015,979,1036,73300,95417,10439,12106
8600000US12108,357,221,136,70893,76405,13826,12108
8600000US12110,18225,9019,9206,79107,93965,5047,12110
8600000US12115,127,86,41,90694,100889,41503,12115
8600000US12116,1431,711,720,46000,63588,15629,12116
8600000US12117,2509,1198,1311,53091,64150,5639,12117
8600000US12118,12023,5967,6056,73091,92045,5789,12118
8600000US12120,536,226,310,57917,74356,12708,12120
8600000US12121,1333,671,662,74009,85913,11353,12121
8600000US12122,3732,1979,1753,49289,62796,5394,12122
8600000US12123,4262,2149,2113,93092,99700,8278,12123
8600000US12124,549,260,289,62885,70516,23341,12124
8600000US12125,1150,551,599,53750,72544,15806,12125
8600000US12130,460,237,223,,87297,32980,12130
8600000US12131,71,35,36,58750,81717,27308,12131
8600000US12132,194,98,96,51767,67282,19124,12132
8600000US12134,3344,1653,1691,57153,67196,4143,12134
8600000US12136,582,269,313,72917,118286,44057,12136
8600000US12137,1490,682,808,64750,79982,14805,12137
8600000US12138,2601,1277,1324,57972,69726,5894,12138
8600000US12139,142,96,46,60000,84871,18478,12139
8600000US12140,1268,641,627,97639,94371,12660,12140
8600000US12143,3870,1885,1985,59159,72535,7629,12143
8600000US12144,16102,7860,8242,69025,82519,4806,12144
8600000US12147,413,200,213,67500,86909,14525,12147
8600000US12148,3369,1613,1756,116279,126993,12527,12148
8600000US12149,1883,906,977,56169,64608,7128,12149
8600000US12150,767,372,395,69432,74835,9772,12150
8600000US12151,678,331,347,93295,105432,13152,12151
8600000US12153,787,458,329,98750,97862,22222,12153
8600000US12154,2290,1182,1108,71875,83709,8498,12154
8600000US12155,1463,721,742,50288,62594,8222,12155
8600000US12156,748,398,350,89833,105339,27526,12156
8600000US12157,3317,1603,1714,60317,78112,11463,12157
8600000US12158,5535,2640,2895,84180,103459,10667,12158
8600000US12159,6296,2968,3328,91193,142114,16552,12159
8600000US12160,707,328,379,70278,82438,23189,12160
8600000US12161,169,141,28,78730,83411,27878,12161
8600000US12164,325,118,207,66458,77325,20509,12164
8600000US12165,152,78,74,108250,107171,21504,12165
8600000US12166,952,476,476,40089,54288,5330,12166
8600000US12167,2370,1151,1219,44839,64648,7245,12167
8600000US12168,1683,918,765,68510,93413,16059,12168
8600000US12169,192,82,110,99896,117833,25763,12169
8600000US12170,3966,2026,1940,71591,87429,9994,12170
8600000US12172,210,96,114,44313,42672,5775,12172
8600000US12173,1649,863,786,73958,79043,5816,12173
8600000US12174,214,98,116,86000,99318,30638,12174
8600000US12175,500,277,223,57188,70973,14532,12175
8600000US12176,435,242,193,75288,75770,19467,12176
8600000US12177,280,140,140,58250,82444,31633,12177
8600000US12180,44055,21387,22668,53007,70073,2913,12180
8600000US12182,11499,5182,6317,47021,66209,6289,12182
8600000US12183,2162,1087,1075,53454,62840,5669,12183
8600000US12184,5302,2556,2746,74132,97784,11381,12184
8600000US12185,1731,887,844,67917,100348,16124,12185
8600000US12186,4885,2414,2471,102052,125834,10415,12186
8600000US12187,479,252,227,51050,67472,20746,12187
8600000US12188,8796,4254,4542,67405,86276,5088,12188
8600000US12189,14105,6588,7517,51748,67289,4357,12189
8600000US12190,659,356,303,57778,60164,10966,12190
8600000US12192,1583,783,800,85212,87263,11590,12192
8600000US12193,1522,735,787,78295,86850,15603,12193
8600000US12194,86,42,44,41667,52284,14055,12194
8600000US12195,121,31,90,35625,42192,16087,12195
8600000US12196,2605,1329,1276,91890,113096,19462,12196
8600000US12197,1593,772,821,46964,67430,5775,12197
8600000US12198,6180,3044,3136,76962,100465,9755,12198
8600000US12202,7409,3434,3975,29229,45082,4246,12202
8600000US12203,27340,12756,14584,59394,80893,4764,12203
8600000US12204,5953,3206,2747,51923,74863,11721,12204
8600000US12205,22219,10780,11439,69411,79103,3139,12205
8600000US12206,11348,5241,6107,30870,45041,4217,12206
8600000US12207,1453,862,591,15815,33522,8674,12207
8600000US12208,18501,8700,9801,62758,79442,4521,12208
8600000US12209,7083,3147,3936,52636,68443,10897,12209
8600000US12210,8242,3991,4251,45922,65719,9366,12210
8600000US12211,8891,4353,4538,100353,140312,14629,12211
8600000US12222,6073,2983,3090,,,,12222
8600000US12302,21236,9485,11751,73940,85897,4224,12302
8600000US12303,21740,10346,11394,66436,88205,4604,12303
8600000US12304,18158,9317,8841,49464,65698,4706,12304
8600000US12305,4702,2563,2139,31982,44967,5731,12305
8600000US12306,21237,10102,11135,66687,78194,2710,12306
8600000US12307,4384,1896,2488,21719,34365,5159,12307
8600000US12308,12529,6126,6403,50162,61229,4532,12308
8600000US12309,23219,11091,12128,107823,128556,6580,12309
8600000US12401,28163,13554,14609,52784,70782,3246,12401
8600000US12404,2770,1357,1413,62422,127326,29677,12404
8600000US12405,592,296,296,54750,70800,15637,12405
8600000US12406,763,411,352,40880,53626,12466,12406
8600000US12407,137,65,72,37404,42306,9154,12407
8600000US12409,627,361,266,90643,110225,20712,12409
8600000US12410,404,242,162,,69311,27113,12410
8600000US12411,325,172,153,72125,68802,11199,12411
8600000US12412,473,196,277,68470,72743,29585,12412
8600000US12413,2300,989,1311,45159,57854,9867,12413
8600000US12414,8753,4370,4383,39625,56205,5318,12414
8600000US12416,200,103,97,25800,40179,17591,12416
8600000US12417,370,204,166,82031,62717,20237,12417
8600000US12418,447,201,246,67500,76113,21179,12418
8600000US12419,452,192,260,59231,68605,19149,12419
8600000US12420,277,169,108,110583,106290,23765,12420
8600000US12421,274,147,127,60375,108410,46335,12421
8600000US12422,232,114,118,130313,117148,29302,12422
8600000US12423,807,369,438,44241,71378,20804,12423
8600000US12424,251,119,132,72625,69358,11595,12424
8600000US12427,318,182,136,,217271,183127,12427
8600000US12428,5355,2835,2520,46571,55973,6345,12428
8600000US12429,217,94,123,,95439,53091,12429
8600000US12430,936,478,458,52971,60848,8363,12430
8600000US12431,905,431,474,51250,65413,12270,12431
8600000US12432,360,180,180,52813,47102,12982,12432
8600000US12433,516,232,284,65847,85348,23223,12433
8600000US12434,662,343,319,35114,54837,12040,12434
8600000US12435,253,143,110,42778,55566,22129,12435
8600000US12436,39,19,20,,,,12436
8600000US12438,22,9,13,,,,12438
8600000US12439,268,117,151,33833,45172,10603,12439
8600000US12440,1764,875,889,70227,80198,14832,12440
8600000US12441,68,34,34,,,,12441
8600000US12442,720,341,379,25598,34791,8211,12442
8600000US12443,2908,1461,1447,93712,117496,21339,12443
8600000US12444,458,235,223,57917,75097,16383,12444
8600000US12446,3908,1915,1993,59472,74897,10759,12446
8600000US12448,411,189,222,123807,222503,106587,12448
8600000US12449,2926,1438,1488,52826,76121,13574,12449
8600000US12450,154,76,78,,,,12450
8600000US12451,1254,738,516,59725,60751,11834,12451
8600000US12452,204,74,130,,43129,14310,12452
8600000US12453,247,91,156,36923,76524,68026,12453
8600000US12454,298,145,153,62083,72490,11332,12454
8600000US12455,1533,695,838,44550,55376,11152,12455
8600000US12456,605,299,306,58611,71323,12231,12456
8600000US12457,807,333,474,51875,65718,23581,12457
8600000US12458,2484,1547,937,44539,65503,10417,12458
8600000US12459,189,98,91,42583,52623,21354,12459
8600000US12460,278,110,168,26850,50186,21809,12460
8600000US12461,1420,676,744,66739,77038,13290,12461
8600000US12463,1238,576,662,77542,88770,21218,12463
8600000US12464,642,253,389,40145,45095,9242,12464
8600000US12465,189,100,89,56500,60951,15591,12465
8600000US12466,2012,1014,998,72031,90264,10222,12466
8600000US12468,964,533,431,50417,80500,21023,12468
8600000US12469,506,254,252,47917,66415,10011,12469
8600000US12470,343,158,185,61420,59646,11997,12470
8600000US12471,219,107,112,,62958,40494,12471
8600000US12472,1270,701,569,67857,73846,10744,12472
8600000US12473,659,368,291,46563,67558,20137,12473
8600000US12474,923,527,396,49464,64077,10650,12474
8600000US12475,199,100,99,,60400,30709,12475
8600000US12477,14666,7232,7434,60279,79835,5322,12477
8600000US12480,697,338,359,,64145,14320,12480
8600000US12481,1221,588,633,54769,72654,16673,12481
8600000US12482,309,124,185,42016,50792,8458,12482
8600000US12483,257,65,192,,56550,28414,12483
8600000US12484,2258,1104,1154,64155,75855,10406,12484
8600000US12485,1304,649,655,52216,64498,11703,12485
8600000US12486,1258,654,604,98264,111004,17906,12486
8600000US12487,2884,1399,1485,64545,108070,31907,12487
8600000US12489,1004,905,99,,60761,26636,12489
8600000US12490,28,14,14,,,,12490
8600000US12491,1232,532,700,70345,88342,23171,12491
8600000US12492,210,95,115,50938,66629,14962,12492
8600000US12493,146,67,79,78359,64436,26432,12493
8600000US12494,553,299,254,91544,88565,21348,12494
8600000US12495,182,70,112,168214,157848,52769,12495
8600000US12496,1226,595,631,63365,80315,12348,12496
8600000US12498,4215,2092,2123,72768,105157,14106,12498
8600000US12501,2003,936,1067,65278,99960,25819,12501
8600000US12502,957,488,469,78098,95159,12158,12502
8600000US12503,473,250,223,69706,131341,43066,12503
8600000US12504,1469,640,829,151667,163533,45500,12504
8600000US12507,218,131,87,57386,82346,27269,12507
8600000US12508,16095,8228,7867,76599,97800,7693,12508
8600000US12512,155,64,91,,,,12512
8600000US12513,279,120,159,63571,66119,23192,12513
8600000US12514,2352,1219,1133,108149,139826,17936,12514
8600000US12515,1307,689,618,,89723,24713,12515
8600000US12516,1374,568,806,78684,102713,31129,12516
8600000US12517,376,234,142,,54390,12577,12517
8600000US12518,4506,2068,2438,77861,105632,11465,12518
8600000US12520,2254,1036,1218,105435,115733,12063,12520
8600000US12521,1314,703,611,85250,114292,26228,12521
8600000US12522,3968,1987,1981,51419,65461,7085,12522
8600000US12523,1313,727,586,69271,83276,13121,12523
8600000US12524,13001,6731,6270,81616,96859,4678,12524
8600000US12525,2192,1058,1134,77147,123239,36574,12525
8600000US12526,3019,1516,1503,76417,103614,11113,12526
8600000US12527,0,0,0,,,,12527
8600000US12528,10430,5090,5340,70451,85744,6860,12528
8600000US12529,2288,1203,1085,69018,111887,23572,12529
8600000US12530,117,92,25,,37347,33830,12530
8600000US12531,2514,1319,1195,101875,129833,18190,12531
8600000US12533,19598,9864,9734,102848,129933,8218,12533
8600000US12534,14785,7224,7561,48878,66565,5415,12534
8600000US12538,11660,5500,6160,74323,90689,8321,12538
8600000US12540,6157,3201,2956,115821,134539,10282,12540
8600000US12542,4481,2180,2301,73302,90388,7775,12542
8600000US12543,2825,1341,1484,60769,80953,9731,12543
8600000US12545,3930,1863,2067,88715,104434,12696,12545
8600000US12546,2274,1135,1139,58500,74271,9041,12546
8600000US12547,2227,1147,1080,93813,106581,10547,12547
8600000US12548,1061,544,517,56369,74563,14318,12548
8600000US12549,8652,4072,4580,91386,101266,7060,12549
8600000US12550,40600,19292,21308,59143,79749,4227,12550
8600000US12553,20430,10341,10089,78398,99067,4496,12553
8600000US12561,15875,6837,9038,66148,90441,7197,12561
8600000US12563,7043,3634,3409,91729,105884,8829,12563
8600000US12564,5578,2648,2930,89688,108943,8932,12564
8600000US12565,919,411,508,39914,49120,7987,12565
8600000US12566,8230,3961,4269,75856,88599,7878,12566
8600000US12567,2468,1133,1335,62750,103049,21808,12567
8600000US12569,8202,3852,4350,80322,103523,16982,12569
8600000US12570,5614,2649,2965,101214,126271,8263,12570
8600000US12571,7825,3670,4155,78641,102953,7741,12571
8600000US12572,7279,3248,4031,72243,112314,10451,12572
8600000US12574,211,105,106,,179587,61005,12574
8600000US12575,1702,1007,695,134179,138860,26572,12575
8600000US12577,1578,759,819,133864,141326,25883,12577
8600000US12578,1852,901,951,116705,116640,16132,12578
8600000US12580,3692,1843,1849,69554,101332,11854,12580
8600000US12581,1897,961,936,75139,107330,18434,12581
8600000US12582,5479,3731,1748,106842,127837,17581,12582
8600000US12583,2005,1031,974,77083,103527,17973,12583
8600000US12585,656,340,316,82557,100717,25984,12585
8600000US12586,9055,4429,4626,74849,91566,7395,12586
8600000US12589,14033,7479,6554,79982,104927,11803,12589
8600000US12590,28057,13931,14126,88982,107452,4672,12590
8600000US12592,1073,505,568,53728,78493,21984,12592
8600000US12594,3395,1797,1598,69792,84087,10083,12594
8600000US12601,33507,15993,17514,45903,64036,3170,12601
8600000US12603,34207,16750,17457,83636,106322,3935,12603
8600000US12604,603,290,313,,,,12604
8600000US12701,9059,4713,4346,37903,59905,6259,12701
8600000US12719,1130,583,547,63750,84060,13810,12719
8600000US12720,92,57,35,,78970,30751,12720
8600000US12721,4641,2433,2208,71953,89353,9080,12721
8600000US12722,92,63,29,,,,12722
8600000US12723,1338,634,704,54333,72864,9448,12723
8600000US12724,237,126,111,,71177,35733,12724
8600000US12725,111,51,60,83750,101775,32757,12725
8600000US12726,1021,550,471,62426,85100,15934,12726
8600000US12729,1494,749,745,46192,61564,9533,12729
8600000US12732,554,292,262,44318,85997,30145,12732
8600000US12733,1063,697,366,31422,36069,9980,12733
8600000US12734,668,331,337,56313,57272,11270,12734
8600000US12736,54,32,22,35714,42094,27723,12736
8600000US12737,1331,600,731,78967,80308,9068,12737
8600000US12738,198,79,119,61645,67480,20527,12738
8600000US12740,1489,748,741,70517,77045,10402,12740
8600000US12741,139,66,73,59375,63646,17719,12741
8600000US12742,80,26,54,31167,45663,20228,12742
8600000US12743,320,149,171,60962,102998,45978,12743
8600000US12745,143,61,82,37875,50642,17517,12745
8600000US12746,816,381,435,81563,90165,16697,12746
8600000US12747,1526,736,790,55114,68790,12644,12747
8600000US12748,1867,1023,844,73750,80083,9608,12748
8600000US12749,306,149,157,55563,58872,22703,12749
8600000US12750,227,110,117,79712,94667,23783,12750
8600000US12751,556,333,223,50185,50084,10511,12751
8600000US12752,204,104,100,41202,63788,16374,12752
8600000US12754,5342,2675,2667,45630,68824,14610,12754
8600000US12758,3190,1566,1624,60368,75300,13938,12758
8600000US12759,1569,744,825,25781,48860,18798,12759
8600000US12760,369,202,167,58375,70493,17340,12760
8600000US12762,494,247,247,39265,51205,13389,12762
8600000US12763,472,224,248,,62178,15902,12763
8600000US12764,1371,723,648,46488,65656,7409,12764
8600000US12765,765,380,385,88721,105461,22725,12765
8600000US12766,292,129,163,61786,64736,18431,12766
8600000US12767,114,56,58,74688,78468,21549,12767
8600000US12768,652,261,391,71083,77229,13475,12768
8600000US12769,135,63,72,,68184,24223,12769
8600000US12770,265,149,116,,78810,24511,12770
8600000US12771,11762,5460,6302,51829,74503,10118,12771
8600000US12775,1619,779,840,100714,116405,22530,12775
8600000US12776,1786,969,817,55398,95754,30912,12776
8600000US12777,721,366,355,84500,119912,21533,12777
8600000US12778,531,298,233,,114618,39238,12778
8600000US12779,1478,780,698,32077,55809,24704,12779
8600000US12780,1661,887,774,46250,57409,9086,12780
8600000US12781,204,134,70,81563,66537,19221,12781
8600000US12783,1495,874,621,69943,76484,12078,12783
8600000US12784,20,14,6,,,,12784
8600000US12785,876,418,458,84728,92322,19455,12785
8600000US12786,271,138,133,,82634,36216,12786
8600000US12787,272,127,145,95313,85267,20263,12787
8600000US12788,2433,1562,871,65060,85846,18775,12788
8600000US12789,1452,689,763,47028,66406,10590,12789
8600000US12790,3257,1570,1687,68611,82198,9151,12790
8600000US12791,387,184,203,74250,70933,15705,12791
8600000US12792,142,80,62,38125,48501,14930,12792
8600000US12801,11508,5485,6023,48485,62545,4785,12801
8600000US12803,6594,3049,3545,61643,73042,5543,12803
8600000US12804,20986,9957,11029,74272,90519,5281,12804
8600000US12808,288,171,117,64792,76508,12516,12808
8600000US12809,2822,1385,1437,54693,68129,9482,12809
8600000US12810,612,290,322,58125,65782,7109,12810
8600000US12811,16,10,6,,,,12811
8600000US12812,58,28,30,70750,71063,13077,12812
8600000US12814,1219,652,567,49602,84459,22851,12814
8600000US12815,899,430,469,64563,78494,8799,12815
8600000US12816,3484,1682,1802,51480,63540,3788,12816
8600000US12817,1856,992,864,62031,71776,9837,12817
8600000US12819,259,143,116,59464,74535,15410,12819
8600000US12821,2724,2603,121,82802,69082,25937,12821
8600000US12822,4750,2425,2325,57413,65757,4443,12822
8600000US12823,431,210,221,,59975,30701,12823
8600000US12824,899,490,409,76161,118207,40331,12824
8600000US12827,2957,1510,1447,65284,74049,7467,12827
8600000US12828,7114,3435,3679,53102,72773,9211,12828
8600000US12831,12807,6291,6516,83358,101193,7149,12831
8600000US12832,5236,2415,2821,45423,58101,4155,12832
8600000US12833,3354,1750,1604,81350,94677,10625,12833
8600000US12834,5131,2516,2615,75060,95751,9647,12834
8600000US12835,1961,962,999,56083,67743,6488,12835
8600000US12836,581,290,291,65781,82357,15575,12836
8600000US12837,792,465,327,59167,70099,26040,12837
8600000US12838,474,249,225,64375,69033,11593,12838
8600000US12839,10388,5196,5192,47826,60999,4325,12839
8600000US12841,107,39,68,81250,109031,43098,12841
8600000US12842,736,327,409,55700,56829,9213,12842
8600000US12843,344,182,162,32813,44648,10616,12843
8600000US12844,228,120,108,84063,84612,27908,12844
8600000US12845,3906,1940,1966,60208,84902,10607,12845
8600000US12846,2828,1405,1423,55694,67658,7498,12846
8600000US12847,341,166,175,59375,72431,9328,12847
8600000US12849,303,176,127,,56557,28779,12849
8600000US12850,2421,1233,1188,86429,99586,12707,12850
8600000US12851,302,169,133,49583,71357,19944,12851
8600000US12852,391,197,194,50000,64517,7793,12852
8600000US12853,1288,650,638,45625,52770,6901,12853
8600000US12855,219,103,116,41500,51797,9140,12855
8600000US12856,137,27,110,50952,47177,17649,12856
8600000US12857,475,249,226,61042,72877,10585,12857
8600000US12858,113,60,53,100625,148719,92755,12858
8600000US12859,1747,853,894,71354,88424,11553,12859
8600000US12860,510,289,221,67292,66023,14276,12860
8600000US12861,493,249,244,50625,71069,10030,12861
8600000US12862,5,5,0,,,,12862
8600000US12863,545,311,234,102727,103442,23832,12863
8600000US12864,24,13,11,,24981,12365,12864
8600000US12865,2985,1517,1468,54009,60979,4779,12865
8600000US12866,33192,15953,17239,80151,112159,7323,12866
8600000US12870,1142,518,624,50526,67109,10660,12870
8600000US12871,3253,1559,1694,72125,97118,20209,12871
8600000US12872,36,16,20,29519,31881,3382,12872
8600000US12873,712,363,349,62679,66654,8332,12873
8600000US12874,151,75,76,76250,101554,26497,12874
8600000US12878,519,263,256,55694,60895,5437,12878
8600000US12883,3936,1715,2221,48396,61011,7249,12883
8600000US12884,397,210,187,58036,67820,12522,12884
8600000US12885,3577,1791,1786,46280,60029,6819,12885
8600000US12886,243,104,139,57266,70216,20055,12886
8600000US12887,3734,1736,1998,54231,63254,6010,12887
8600000US12901,27765,13556,14209,48883,65250,3216,12901
8600000US12903,1043,470,573,63942,72509,7412,12903
8600000US12910,1514,997,517,49844,56309,7323,12910
8600000US12911,25,19,6,,,,12911
8600000US12912,1571,682,889,59261,72323,15183,12912
8600000US12913,915,438,477,60917,83041,14122,12913
8600000US12914,616,295,321,46875,55697,13105,12914
8600000US12916,1659,766,893,59758,75076,20800,12916
8600000US12917,1039,533,506,52500,61537,10419,12917
8600000US12918,1698,811,887,63648,72058,8867,12918
8600000US12919,2239,1053,1186,50634,56304,6903,12919
8600000US12920,1882,1029,853,53462,70276,11131,12920
8600000US12921,1939,921,1018,82056,94567,12570,12921
8600000US12922,34,20,14,,57495,28127,12922
8600000US12923,498,270,228,50750,59127,7613,12923
8600000US12924,77,39,38,70000,67455,26185,12924
8600000US12926,1811,987,824,50729,59002,6033,12926
8600000US12927,234,119,115,50227,61235,11129,12927
8600000US12928,1557,854,703,55521,67000,9954,12928
8600000US12929,3726,3441,285,50962,55148,8341,12929
8600000US12930,560,270,290,58472,64189,7191,12930
8600000US12932,1011,459,552,53487,70243,10164,12932
8600000US12933,47,24,23,,62812,32118,12933
8600000US12934,789,387,402,52778,56941,6731,12934
8600000US12935,1351,659,692,54583,65659,7861,12935
8600000US12936,361,168,193,62500,73834,10762,12936
8600000US12937,1408,763,645,45880,51914,5817,12937
8600000US12939,183,127,56,58438,72351,14573,12939
8600000US12941,1102,528,574,65236,74935,8226,12941
8600000US12942,754,353,401,69904,96235,15943,12942
8600000US12943,326,136,190,37750,46773,10603,12943
8600000US12944,3241,1613,1628,51176,65178,7871,12944
8600000US12945,448,189,259,64773,88940,26578,12945
8600000US12946,3645,1619,2026,63770,77966,10134,12946
8600000US12950,659,402,257,66136,71516,9762,12950
8600000US12952,370,180,190,38750,46864,16336,12952
8600000US12953,12901,8162,4739,49206,62749,4837,12953
8600000US12955,248,120,128,65625,101886,34802,12955
8600000US12956,1135,653,482,59757,62482,21383,12956
8600000US12957,1433,712,721,41287,50933,11970,12957
8600000US12958,2049,1002,1047,61114,80683,16652,12958
8600000US12959,838,400,438,29886,47273,11519,12959
8600000US12960,885,421,464,81758,81080,16306,12960
8600000US12961,190,138,52,,26732,11798,12961
8600000US12962,4765,2213,2552,75245,84615,7769,12962
8600000US12964,144,84,60,,78534,46745,12964
8600000US12965,411,216,195,41250,57580,8488,12965
8600000US12966,2150,1136,1014,48750,62863,8145,12966
8600000US12967,885,466,419,45508,55315,10096,12967
8600000US12969,344,183,161,39688,51412,8803,12969
8600000US12970,928,619,309,56250,90598,25100,12970
8600000US12972,4564,2283,2281,69332,80948,6963,12972
8600000US12973,73,37,36,46250,52037,15986,12973
8600000US12974,1385,673,712,53594,67109,10944,12974
8600000US12975,198,92,106,53563,68638,25056,12975
8600000US12976,197,90,107,76250,82396,18079,12976
8600000US12977,1849,1815,34,,,,12977
8600000US12978,226,120,106,,47417,28714,12978
8600000US12979,1807,898,909,58646,69105,9304,12979
8600000US12980,989,503,486,41944,52556,6315,12980
8600000US12981,1924,923,1001,66542,66074,12318,12981
8600000US12983,6009,3031,2978,54478,70551,4874,12983
8600000US12985,1085,505,580,41289,53538,13227,12985
8600000US12986,4934,2594,2340,56402,75908,7442,12986
8600000US12987,192,79,113,51979,63127,16267,12987
8600000US12989,866,428,438,69479,80680,9931,12989
8600000US12992,3507,1742,1765,54460,66766,7815,12992
8600000US12993,1199,650,549,49688,65038,10466,12993
8600000US12996,1761,947,814,63594,84106,24062,12996
8600000US12997,1014,524,490,60547,83186,10441,12997
8600000US12998,270,172,98,43769,49790,15668,12998
8600000US13020,92,52,40,75750,68608,14845,13020
8600000US13021,30571,14639,15932,51709,68024,2740,13021
8600000US13024,1723,1723,0,,,,13024
8600000US13026,1499,725,774,67992,83451,9058,13026
8600000US13027,26075,12598,13477,75301,89422,3561,13027
8600000US13028,899,506,393,49700,63930,17696,13028
8600000US13029,5570,2612,2958,67568,86359,10127,13029
8600000US13030,3174,1751,1423,63393,75949,8657,13030
8600000US13031,12097,5967,6130,72703,89930,4946,13031
8600000US13032,9651,4707,4944,59087,68569,4366,13032
8600000US13033,2895,1503,1392,66887,80562,6250,13033
8600000US13034,1538,739,799,68611,83688,7973,13034
8600000US13035,7289,3510,3779,79527,109073,10669,13035
8600000US13036,6981,3526,3455,55241,71758,5682,13036
8600000US13037,7201,3664,3537,74587,88800,6574,13037
8600000US13039,12982,6164,6818,90940,100926,4810,13039
8600000US13040,1925,996,929,51731,61960,4381,13040
8600000US13041,8685,4084,4601,89516,100147,7076,13041
8600000US13042,1791,944,847,63556,66494,10075,13042
8600000US13044,2107,1027,1080,64398,85882,20777,13044
8600000US13045,24194,11520,12674,52726,70167,4753,13045
8600000US13051,189,67,122,,49548,57698,13051
8600000US13052,1124,570,554,55536,67423,5603,13052
8600000US13053,4016,1805,2211,67857,89711,12948,13053
8600000US13054,1217,563,654,68646,68117,11702,13054
8600000US13057,11409,5235,6174,60971,73180,4316,13057
8600000US13060,2130,988,1142,59844,71884,9944,13060
8600000US13061,925,521,404,67625,74869,8331,13061
8600000US13062,23,7,16,,,,13062
8600000US13063,1602,817,785,95417,133917,51361,13063
8600000US13064,161,70,91,,133030,83631,13064
8600000US13066,9572,4629,4943,89840,132094,10293,13066
8600000US13068,4024,1915,2109,62635,75697,7567,13068
8600000US13069,18518,8823,9695,50293,64943,6138,13069
8600000US13071,705,382,323,63958,75084,10365,13071
8600000US13072,665,376,289,55547,59964,7701,13072
8600000US13073,5195,2687,2508,68209,80092,6943,13073
8600000US13074,3174,1482,1692,57310,62149,5339,13074
8600000US13076,1854,936,918,62614,80969,10938,13076
8600000US13077,5521,2544,2977,61186,80898,11848,13077
8600000US13078,8354,4195,4159,88150,122564,12906,13078
8600000US13080,2747,1329,1418,51173,74537,12352,13080
8600000US13081,869,429,440,83043,110903,17648,13081
8600000US13082,3627,1673,1954,67019,74884,7823,13082
8600000US13083,1609,812,797,67500,73376,7846,13083
8600000US13084,2844,1391,1453,65083,79802,9914,13084
8600000US13087,60,40,20,62500,67425,35823,13087
8600000US13088,18186,8332,9854,58183,74104,6035,13088
8600000US13090,22825,11202,11623,74396,89374,4474,13090
8600000US13092,1964,1028,936,70813,73792,6802,13092
8600000US13101,1761,838,923,62652,66043,6090,13101
8600000US13102,32,20,12,,,,13102
8600000US13103,248,119,129,69063,62668,35419,13103
8600000US13104,11661,5814,5847,104321,139052,11928,13104
8600000US13108,4743,2360,2383,74840,90185,6605,13108
8600000US13110,1671,860,811,81500,92155,9808,13110
8600000US13111,1281,706,575,40924,48823,7750,13111
8600000US13112,1519,762,757,70150,78264,9197,13112
8600000US13113,191,95,96,85938,84787,10668,13113
8600000US13114,4708,2407,2301,60996,74501,5971,13114
8600000US13115,163,96,67,42875,55555,14678,13115
8600000US13116,2588,980,1608,56048,67089,7628,13116
8600000US13117,197,103,94,55000,58113,13752,13117
8600000US13118,4899,2917,1982,55762,68029,4164,13118
8600000US13120,1857,890,967,56000,74941,13859,13120
8600000US13122,881,356,525,75250,75186,15389,13122
8600000US13123,314,129,185,58431,68267,24608,13123
8600000US13124,73,46,27,45625,50880,7412,13124
8600000US13126,29907,14807,15100,51460,70414,2810,13126
8600000US13131,2994,1566,1428,56723,75432,10739,13131
8600000US13132,2695,1275,1420,63245,73648,10783,13132
8600000US13134,174,92,82,76563,75892,23733,13134
8600000US13135,5179,2515,2664,55503,72111,9072,13135
8600000US13136,318,178,140,45972,57725,7757,13136
8600000US13138,0,0,0,,,,13138
8600000US13140,3562,1754,1808,54744,65712,5028,13140
8600000US13141,460,212,248,62768,70284,10355,13141
8600000US13142,4859,2459,2400,47198,65196,5662,13142
8600000US13143,2044,1104,940,54050,58937,6330,13143
8600000US13144,1311,654,657,42028,59759,9839,13144
8600000US13145,1208,610,598,53750,61861,6883,13145
8600000US13146,1759,928,831,52135,63274,5110,13146
8600000US13147,918,467,451,53333,70764,15548,13147
8600000US13148,8401,4083,4318,55621,73929,6860,13148
8600000US13152,6505,3182,3323,92691,143021,16601,13152
8600000US13153,332,192,140,49750,58463,13818,13153
8600000US13155,492,261,231,68636,74917,9575,13155
8600000US13156,1495,778,717,58056,69972,8685,13156
8600000US13157,492,222,270,46429,54444,10511,13157
8600000US13158,1214,615,599,56786,70559,7876,13158
8600000US13159,4143,2174,1969,71548,95451,7645,13159
8600000US13160,1596,762,834,64511,75820,7442,13160
8600000US13162,363,174,189,,165701,128586,13162
8600000US13163,410,252,158,45417,53633,12544,13163
8600000US13164,1767,844,923,92446,92562,8605,13164
8600000US13165,8354,3907,4447,54973,64954,4012,13165
8600000US13166,4308,2155,2153,62774,75674,7150,13166
8600000US13167,2339,1198,1141,53894,69533,6642,13167
8600000US13202,5081,2576,2505,17176,38395,5742,13202
8600000US13203,12469,5875,6594,35359,53592,3740,13203
8600000US13204,13704,6474,7230,33508,48138,2985,13204
8600000US13205,13197,5782,7415,31582,43850,2754,13205
8600000US13206,12980,6229,6751,41403,58971,7094,13206
8600000US13207,9890,4554,5336,50336,63310,3635,13207
8600000US13208,16270,7553,8717,38482,51365,3968,13208
8600000US13209,10359,4761,5598,54974,62346,2544,13209
8600000US13210,25258,11723,13535,29100,50336,4118,13210
8600000US13211,4586,2063,2523,47282,61938,10427,13211
8600000US13212,17025,8007,9018,58971,69809,3058,13212
8600000US13214,7086,3231,3855,75809,89915,7190,13214
8600000US13215,11936,5694,6242,87489,104014,6749,13215
8600000US13219,11886,5520,6366,62119,76153,3886,13219
8600000US13224,6620,3151,3469,56535,78037,6489,13224
8600000US13290,0,0,0,,,,13290
8600000US13301,91,35,56,88125,90614,35901,13301
8600000US13302,1287,716,571,48625,57640,4290,13302
8600000US13303,944,463,481,69886,85595,11298,13303
8600000US13304,1281,631,650,77813,91393,12775,13304
8600000US13305,204,117,87,48828,57407,13772,13305
8600000US13308,2548,1302,1246,61667,66712,9946,13308
8600000US13309,4489,2197,2292,57846,71690,6745,13309
8600000US13310,555,315,240,46328,52324,15077,13310
8600000US13312,320,153,167,50625,74309,12589,13312
8600000US13313,337,179,158,37188,51706,7710,13313
8600000US13314,310,169,141,50469,76994,19558,13314
8600000US13315,1195,592,603,60735,66540,6579,13315
8600000US13316,4864,2268,2596,47193,59615,5672,13316
8600000US13317,2944,1490,1454,51272,63390,6409,13317
8600000US13318,1059,536,523,69091,79088,6338,13318
8600000US13319,678,356,322,44619,54629,12828,13319
8600000US13320,1610,788,822,59297,70078,6058,13320
8600000US13321,760,349,411,51083,48788,6654,13321
8600000US13322,798,352,446,58125,68784,7888,13322
8600000US13323,9358,4339,5019,66172,90302,7448,13323
8600000US13324,1870,852,1018,52917,66152,6593,13324
8600000US13325,837,440,397,53250,71189,10577,13325
8600000US13326,4731,2217,2514,60966,89810,7615,13326
8600000US13327,1575,781,794,55573,61458,6856,13327
8600000US13328,1171,542,629,76591,82811,10231,13328
8600000US13329,3233,1544,1689,46190,55878,3780,13329
8600000US13331,120,65,55,59167,74915,35073,13331
8600000US13332,2042,966,1076,51458,67117,7679,13332
8600000US13333,34,11,23,,27482,19219,13333
8600000US13334,817,481,336,53224,63095,12988,13334
8600000US13335,1197,653,544,58000,73173,9338,13335
8600000US13337,485,260,225,81591,108217,40721,13337
8600000US13338,964,494,470,44904,56711,5558,13338
8600000US13339,4742,2404,2338,49071,59487,5968,13339
8600000US13340,6315,2982,3333,58065,68070,5949,13340
8600000US13341,99,48,51,115735,101148,28838,13341
8600000US13342,180,106,74,59107,78464,23371,13342
8600000US13343,1393,727,666,59167,72166,9544,13343
8600000US13345,139,77,62,,71210,21047,13345
8600000US13346,5330,2240,3090,67045,79262,6894,13346
8600000US13348,1125,604,521,61133,77501,9991,13348
8600000US13350,8239,4181,4058,48471,59905,4758,13350
8600000US13352,32,0,32,,,,13352
8600000US13353,10,6,4,,21325,11331,13353
8600000US13354,2921,1573,1348,74496,86474,9585,13354
8600000US13355,693,360,333,65956,73214,10215,13355
8600000US13357,8269,4105,4164,49832,60115,3973,13357
8600000US13360,143,71,72,47500,83115,34582,13360
8600000US13361,576,319,257,54219,62075,9191,13361
8600000US13362,137,59,78,,92767,54733,13362
8600000US13363,1861,899,962,72738,84602,12918,13363
8600000US13364,90,53,37,31563,38487,8525,13364
8600000US13365,6612,3158,3454,51520,68333,5815,13365
8600000US13367,6641,3360,3281,53689,71787,5195,13367
8600000US13368,792,356,436,46765,57587,5917,13368
8600000US13402,1517,948,569,60870,73814,10782,13402
8600000US13403,6374,4418,1956,81344,112127,26497,13403
8600000US13404,120,47,73,42750,41535,10683,13404
8600000US13406,527,289,238,54375,76001,18916,13406
8600000US13407,4132,1956,2176,51336,57309,4422,13407
8600000US13408,3415,1591,1824,53932,63347,7821,13408
8600000US13409,1950,988,962,52216,58848,4647,13409
8600000US13410,229,117,112,70938,75006,14180,13410
8600000US13411,2570,1261,1309,49556,59637,5735,13411
8600000US13413,13596,6132,7464,72576,97037,8588,13413
8600000US13415,53,27,26,48750,64927,26318,13415
8600000US13416,1852,888,964,51585,65849,5103,13416
8600000US13417,2694,1153,1541,35720,48720,7625,13417
8600000US13418,227,103,124,63438,69571,20028,13418
8600000US13420,876,384,492,54787,65131,8395,13420
8600000US13421,10314,5060,5254,53179,62604,4043,13421
8600000US13424,2121,1162,959,58367,64034,6487,13424
8600000US13425,1622,874,748,48875,60114,8115,13425
8600000US13428,1247,564,683,40662,53955,6134,13428
8600000US13431,1279,630,649,59792,82832,8847,13431
8600000US13433,1297,626,671,48935,54358,4493,13433
8600000US13435,202,94,108,67778,71302,13503,13435
8600000US13436,123,91,32,55625,80654,24386,13436
8600000US13437,368,196,172,44688,55627,8497,13437
8600000US13438,2692,1306,1386,55761,71600,6146,13438
8600000US13439,2859,1394,1465,49832,62435,5105,13439
8600000US13440,32787,16633,16154,53067,67454,2263,13440
8600000US13441,87,48,39,48333,50502,17033,13441
8600000US13450,36,25,11,51328,50381,8741,13450
8600000US13452,3579,1802,1777,41042,55795,4160,13452
8600000US13454,470,236,234,40400,48144,7258,13454
8600000US13456,3151,1562,1589,69528,88044,10542,13456
8600000US13459,1949,952,997,55346,68538,6335,13459
8600000US13460,3351,1537,1814,47143,62720,6859,13460
8600000US13461,2465,1201,1264,63204,78998,10964,13461
8600000US13464,1125,561,564,41532,60350,12025,13464
8600000US13468,343,159,184,60625,71818,15285,13468
8600000US13469,799,387,412,81201,83597,9826,13469
8600000US13470,562,298,264,38750,49013,8060,13470
8600000US13471,2468,1291,1177,53158,59221,5110,13471
8600000US13472,66,66,0,,,,13472
8600000US13473,498,265,233,60313,72516,11581,13473
8600000US13475,8,0,8,,,,13475
8600000US13476,2864,1378,1486,67083,76518,8718,13476
8600000US13477,1051,505,546,45000,85363,35082,13477
8600000US13478,2215,1192,1023,62944,72145,7205,13478
8600000US13480,2730,1313,1417,56033,66872,4728,13480
8600000US13483,253,140,113,80000,73264,14817,13483
8600000US13484,144,64,80,98703,92752,14687,13484
8600000US13485,858,436,422,50050,58570,8332,13485
8600000US13486,672,295,377,51250,69516,12652,13486
8600000US13488,111,73,38,51250,73886,28900,13488
8600000US13489,534,282,252,51944,59986,8189,13489
8600000US13490,1204,557,647,64592,73751,16206,13490
8600000US13491,2866,1491,1375,57557,72537,5719,13491
8600000US13492,9182,4351,4831,62632,83233,7165,13492
8600000US13493,1425,754,671,51055,55966,4373,13493
8600000US13494,319,142,177,61458,80099,24007,13494
8600000US13495,1634,869,765,55643,55951,6464,13495
8600000US13501,27792,13392,14400,36079,55484,4191,13501
8600000US13502,25439,12626,12813,41333,61512,5464,13502
8600000US13601,28668,14631,14037,46683,62018,2770,13601
8600000US13602,3793,3475,318,45156,49664,14246,13602
8600000US13603,5954,3235,2719,45272,53412,3444,13603
8600000US13605,3412,1703,1709,52212,62166,5260,13605
8600000US13606,2138,1119,1019,67787,69986,9521,13606
8600000US13607,1067,550,517,49048,65453,9256,13607
8600000US13608,1133,538,595,47065,58150,6458,13608
8600000US13612,1735,896,839,65636,77811,9819,13612
8600000US13613,1843,939,904,50652,56324,4676,13613
8600000US13614,271,137,134,,67207,22605,13614
8600000US13615,900,424,476,61389,71140,9687,13615
8600000US13616,1534,799,735,53021,59169,10321,13616
8600000US13617,9552,4546,5006,60016,74581,7075,13617
8600000US13618,1299,577,722,52941,64014,5736,13618
8600000US13619,8030,3895,4135,53566,61332,4159,13619
8600000US13620,1543,699,844,39235,57106,7546,13620
8600000US13621,366,182,184,54500,57325,11431,13621
8600000US13622,1870,888,982,66736,79193,10995,13622
8600000US13623,13,10,3,,40050,34989,13623
8600000US13624,4798,2780,2018,74505,76323,5691,13624
8600000US13625,1515,694,821,56500,66766,6318,13625
8600000US13626,1727,883,844,50583,61479,8586,13626
8600000US13628,148,64,84,47500,55520,13120,13628
8600000US13630,1041,511,530,45500,58093,12041,13630
8600000US13633,232,128,104,72614,66993,14218,13633
8600000US13634,3198,1659,1539,63605,77034,8646,13634
8600000US13635,899,433,466,52546,57297,6762,13635
8600000US13636,196,97,99,55000,64030,12944,13636
8600000US13637,3102,1645,1457,52666,61528,4710,13637
8600000US13638,250,155,95,39278,40690,5099,13638
8600000US13639,219,108,111,48889,66623,18765,13639
8600000US13640,336,176,160,46581,86143,30989,13640
8600000US13641,65,31,34,,56684,33539,13641
8600000US13642,8041,4511,3530,38438,54785,5101,13642
8600000US13643,10,0,10,,,,13643
8600000US13646,1658,816,842,41528,53781,4848,13646
8600000US13647,37,18,19,,,,13647
8600000US13648,1777,937,840,50227,60129,5202,13648
8600000US13650,1303,699,604,62120,95537,29285,13650
8600000US13651,142,64,78,135833,139705,34780,13651
8600000US13652,1298,644,654,45417,59293,9299,13652
8600000US13654,1882,954,928,47273,60445,7025,13654
8600000US13655,2631,1226,1405,41613,53568,13129,13655
8600000US13656,2061,1118,943,56953,75212,11637,13656
8600000US13658,1709,873,836,59583,70878,13612,13658
8600000US13659,396,207,189,55625,61457,10340,13659
8600000US13660,1175,602,573,54189,65923,7298,13660
8600000US13661,1024,500,524,64111,75463,8731,13661
8600000US13662,12451,5650,6801,50154,62493,4349,13662
8600000US13664,246,119,127,66875,71453,11234,13664
8600000US13665,624,360,264,47439,54408,10363,13665
8600000US13666,189,84,105,44375,70148,26035,13666
8600000US13667,2264,1111,1153,41682,52221,6389,13667
8600000US13668,2576,1325,1251,53832,68343,5247,13668
8600000US13669,12738,6933,5805,48177,60305,2996,13669
8600000US13670,355,180,175,41389,53268,8424,13670
8600000US13672,552,272,280,57650,68530,10788,13672
8600000US13673,1717,874,843,48575,62668,9635,13673
8600000US13674,61,31,30,,,,13674
8600000US13675,181,72,109,64605,76853,16007,13675
8600000US13676,14427,7592,6835,50292,70206,5840,13676
8600000US13677,112,68,44,,,,13677
8600000US13678,227,155,72,42708,57367,17927,13678
8600000US13679,1483,711,772,52063,68690,10527,13679
8600000US13680,1056,497,559,42750,61144,13765,13680
8600000US13681,608,322,286,58125,65816,13369,13681
8600000US13682,684,352,332,70625,83154,9784,13682
8600000US13684,811,428,383,47279,67130,14774,13684
8600000US13685,1918,930,988,62583,74530,7492,13685
8600000US13687,394,186,208,49609,65379,14540,13687
8600000US13690,659,375,284,41429,53835,6878,13690
8600000US13691,2144,1021,1123,59313,75676,14751,13691
8600000US13692,64,29,35,41964,42890,14683,13692
8600000US13693,338,177,161,45438,55613,13196,13693
8600000US13694,1155,553,602,60625,75796,11234,13694
8600000US13695,163,90,73,105139,90176,17624,13695
8600000US13696,47,18,29,,,,13696
8600000US13697,1395,681,714,42623,59366,13456,13697
8600000US13730,2246,1248,998,54274,74163,16233,13730
8600000US13731,792,386,406,42917,61155,7615,13731
8600000US13732,6190,3075,3115,83078,95360,7144,13732
8600000US13733,3817,1978,1839,53428,64253,5238,13733
8600000US13734,1511,718,793,46700,57483,10135,13734
8600000US13736,1552,749,803,63309,76413,13003,13736
8600000US13739,688,316,372,62841,75295,9027,13739
8600000US13740,459,228,231,70313,107184,25500,13740
8600000US13743,2809,1373,1436,60433,71923,7894,13743
8600000US13744,940,534,406,60909,71450,11064,13744
8600000US13746,1654,753,901,61350,70409,7454,13746
8600000US13748,2850,1422,1428,57560,70068,9795,13748
8600000US13750,840,471,369,39414,58919,17038,13750
8600000US13751,74,31,43,,38523,23706,13751
8600000US13752,624,285,339,54583,81742,15048,13752
8600000US13753,5030,2548,2482,54211,72106,7668,13753
8600000US13754,2557,1254,1303,40417,54307,3968,13754
8600000US13755,1004,494,510,48611,61384,10542,13755
8600000US13756,355,200,155,52411,63003,16483,13756
8600000US13757,1038,519,519,53904,65911,6660,13757
8600000US13760,34907,16939,17968,56959,72202,2751,13760
8600000US13774,130,72,58,34200,41884,10235,13774
8600000US13775,1504,780,724,54500,69984,11650,13775
8600000US13776,451,200,251,65714,69821,10207,13776
8600000US13777,321,183,138,67292,73371,13395,13777
8600000US13778,4272,2034,2238,58555,69519,4590,13778
8600000US13780,742,415,327,60139,64840,14765,13780
8600000US13782,569,258,311,54896,69929,9539,13782
8600000US13783,2121,1026,1095,41458,57602,7416,13783
8600000US13784,73,30,43,43750,53755,12306,13784
8600000US13786,330,188,142,52500,58630,12519,13786
8600000US13787,2622,1145,1477,46013,53696,7783,13787
8600000US13788,821,469,352,52639,68455,10030,13788
8600000US13790,14183,6590,7593,45114,58601,3551,13790
8600000US13794,38,21,17,43125,43558,15076,13794
8600000US13795,2755,1220,1535,56008,69380,8472,13795
8600000US13796,1121,557,564,61250,72084,12212,13796
8600000US13797,1660,831,829,52462,61083,4719,13797
8600000US13801,1103,580,523,35592,52007,7604,13801
8600000US13802,390,188,202,110625,92473,27453,13802
8600000US13803,3082,1622,1460,61111,70362,4942,13803
8600000US13804,304,145,159,56181,65897,14367,13804
8600000US13806,242,134,108,41000,58354,18778,13806
8600000US13807,1067,493,574,58182,72466,10986,13807
8600000US13808,1245,599,646,49375,70617,12354,13808
8600000US13809,1266,656,610,52344,63740,12091,13809
8600000US13810,960,437,523,54250,71320,10464,13810
8600000US13811,3289,1744,1545,68550,91682,18023,13811
8600000US13812,1872,980,892,66696,72665,7902,13812
8600000US13813,415,212,203,51719,63200,15782,13813
8600000US13815,10365,4944,5421,47874,62309,4276,13815
8600000US13820,19266,8789,10477,48875,64886,4144,13820
8600000US13825,2724,1257,1467,51047,62563,5734,13825
8600000US13826,15,0,15,,,,13826
8600000US13827,9470,4687,4783,56359,71298,4659,13827
8600000US13830,4148,2156,1992,46250,57185,4548,13830
8600000US13832,497,251,246,48750,64750,12962,13832
8600000US13833,3313,1790,1523,54375,68579,8002,13833
8600000US13834,168,87,81,72852,59992,17985,13834
8600000US13835,1046,533,513,51053,65398,13374,13835
8600000US13838,3186,1562,1624,36815,51800,5324,13838
8600000US13839,919,475,444,45817,49382,7605,13839
8600000US13841,482,232,250,53125,73057,16231,13841
8600000US13842,444,265,179,54375,79235,12757,13842
8600000US13843,1611,849,762,51207,60314,7138,13843
8600000US13844,586,277,309,53125,64344,12478,13844
8600000US13845,138,71,67,,,,13845
8600000US13846,277,132,145,37917,47565,13132,13846
8600000US13847,55,23,32,,72604,44261,13847
8600000US13849,3435,1750,1685,49554,60717,5158,13849
8600000US13850,17932,8782,9150,65030,90415,5546,13850
8600000US13856,4642,2363,2279,50764,54516,6007,13856
8600000US13859,189,91,98,54750,72779,26378,13859
8600000US13860,14,7,7,,,,13860
8600000US13861,318,148,170,75700,92194,29257,13861
8600000US13862,3396,1701,1695,61714,70615,3778,13862
8600000US13863,562,315,247,54167,59738,7359,13863
8600000US13864,776,460,316,40347,62012,12695,13864
8600000US13865,4696,2260,2436,62629,70184,6385,13865
8600000US13901,15052,7363,7689,44159,62430,5650,13901
8600000US13902,6038,3186,2852,,,,13902
8600000US13903,14811,7365,7446,46813,69645,4288,13903
8600000US13904,7551,3537,4014,49189,58808,4543,13904
8600000US13905,21786,10254,11532,39832,56643,4527,13905
8600000US14001,7614,3949,3665,60615,77134,8520,14001
8600000US14004,10061,5737,4324,73586,81411,4436,14004
8600000US14005,1509,778,731,70673,76836,8074,14005
8600000US14006,8219,4106,4113,56941,73781,7440,14006
8600000US14008,1029,485,544,57400,66805,10056,14008
8600000US14009,4183,2042,2141,50284,60212,4115,14009
8600000US14011,7918,5436,2482,66178,77354,5532,14011
8600000US14012,1851,935,916,58707,75077,9286,14012
8600000US14013,1454,809,645,57746,61482,5113,14013
8600000US14020,18154,8840,9314,52825,65969,3327,14020
8600000US14024,1208,607,601,63158,73870,7564,14024
8600000US14025,2627,1309,1318,56172,75479,11001,14025
8600000US14026,551,302,249,,88870,43846,14026
8600000US14028,1311,701,610,75667,83712,13739,14028
8600000US14030,1352,708,644,63036,69771,6595,14030
8600000US14031,8061,3866,4195,82727,103360,9923,14031
8600000US14032,6344,3249,3095,121111,150222,11353,14032
8600000US14033,1384,629,755,85278,93983,18131,14033
8600000US14034,2537,1778,759,61292,69465,8314,14034
8600000US14035,41,0,41,,,,14035
8600000US14036,3955,2008,1947,68448,77181,7024,14036
8600000US14037,883,508,375,56389,71349,15561,14037
8600000US14039,60,28,32,57188,62646,17712,14039
8600000US14040,1710,852,858,71774,83015,18032,14040
8600000US14041,100,54,46,55313,73296,25639,14041
8600000US14042,2976,1445,1531,49632,56536,6168,14042
8600000US14043,20168,9914,10254,59520,71639,3087,14043
8600000US14047,5095,2406,2689,67447,78844,7356,14047
8600000US14048,11262,5305,5957,37588,51113,3728,14048
8600000US14051,15182,7358,7824,117803,139167,8603,14051
8600000US14052,13636,6583,7053,79174,95931,5354,14052
8600000US14054,1100,571,529,62067,76613,9343,14054
8600000US14055,1275,681,594,68667,75847,9701,14055
8600000US14057,6702,3416,3286,70298,83470,6962,14057
8600000US14058,1526,727,799,65268,74231,6191,14058
8600000US14059,8194,3879,4315,73456,94447,8570,14059
8600000US14060,256,143,113,44375,55176,14486,14060
8600000US14061,298,162,136,54375,63511,12206,14061
8600000US14062,2685,1405,1280,52644,64810,6350,14062
8600000US14063,12068,5871,6197,55713,72029,6617,14063
8600000US14065,1331,646,685,56823,59108,4949,14065
8600000US14066,1000,513,487,56850,63940,7546,14066
8600000US14067,4108,1933,2175,54000,71445,6497,14067
8600000US14068,5385,2377,3008,78705,113368,19153,14068
8600000US14069,601,307,294,66071,67414,10753,14069
8600000US14070,5841,3663,2178,44023,62382,8831,14070
8600000US14072,16256,8028,8228,80569,95747,5424,14072
8600000US14075,34212,15565,18647,70300,85940,3658,14075
8600000US14080,3377,1799,1578,66000,75084,7561,14080
8600000US14081,2598,1265,1333,45900,58986,5608,14081
8600000US14082,485,237,248,61429,75691,14966,14082
8600000US14085,5420,2716,2704,82071,93543,7335,14085
8600000US14086,25332,11946,13386,82221,98100,4632,14086
8600000US14091,880,481,399,56429,66467,10021,14091
8600000US14092,9216,4218,4998,65072,84497,5284,14092
8600000US14094,39376,19611,19765,56138,70842,2136,14094
8600000US14098,2200,1108,1092,55417,67213,4637,14098
8600000US14101,1449,724,725,54276,67725,8235,14101
8600000US14102,905,442,463,89792,100386,19836,14102
8600000US14103,8325,4030,4295,47848,55422,3212,14103
8600000US14105,3518,1635,1883,59625,71300,6588,14105
8600000US14108,4724,2282,2442,58903,71904,7252,14108
8600000US14109,1107,462,645,,,,14109
8600000US14111,2537,1290,1247,57313,73156,8748,14111
8600000US14112,18,0,18,,,,14112
8600000US14113,441,225,216,60250,63748,8648,14113
8600000US14120,35754,17644,18110,62998,76848,2671,14120
8600000US14125,2937,1528,1409,60573,73736,8826,14125
8600000US14126,448,171,277,61125,64742,18452,14126
8600000US14127,23970,11544,12426,89780,116265,7436,14127
8600000US14129,1154,550,604,50846,61467,6966,14129
8600000US14130,120,60,60,45500,46895,10408,14130
8600000US14131,4215,2214,2001,73250,90776,12855,14131
8600000US14132,4668,2190,2478,68812,74765,4732,14132
8600000US14134,97,48,49,49091,73481,33084,14134
8600000US14135,118,78,40,,31561,20258,14135
8600000US14136,3598,1743,1855,56294,63955,4490,14136
8600000US14138,1430,723,707,50875,65350,11579,14138
8600000US14139,1755,924,831,86149,98642,14489,14139
8600000US14141,5987,2905,3082,55779,70302,5535,14141
8600000US14143,812,422,390,58500,64974,9033,14143
8600000US14145,1384,630,754,65750,78701,11532,14145
8600000US14150,33464,15577,17887,53982,64339,1944,14150
8600000US14167,1313,720,593,69276,76573,7041,14167
8600000US14168,14,7,7,,,,14168
8600000US14169,68,21,47,31765,39290,11272,14169
8600000US14170,1989,975,1014,74264,124083,66157,14170
8600000US14171,1566,794,772,55972,66497,5720,14171
8600000US14172,2274,1044,1230,60438,88982,23567,14172
8600000US14173,297,139,158,,57560,15443,14173
8600000US14174,4354,2243,2111,71000,93515,15068,14174
8600000US14201,8910,4232,4678,26771,43854,4512,14201
8600000US14202,3036,1777,1259,46439,96688,17749,14202
8600000US14203,1441,562,879,38578,52699,7188,14203
8600000US14204,6750,2855,3895,23886,41117,6268,14204
8600000US14206,15700,7731,7969,37946,49815,3044,14206
8600000US14207,16760,7473,9287,27633,42896,3777,14207
8600000US14208,8408,3732,4676,27876,40951,3721,14208
8600000US14209,6479,2916,3563,37869,57714,5955,14209
8600000US14210,11306,5547,5759,38811,49923,4292,14210
8600000US14211,15935,6912,9023,26496,39490,4269,14211
8600000US14212,7855,3978,3877,24060,37991,3690,14212
8600000US14213,17204,8389,8815,33303,47809,3545,14213
8600000US14214,16381,8243,8138,47642,65103,5346,14214
8600000US14215,29502,12612,16890,34928,46044,2517,14215
8600000US14216,18634,9071,9563,57416,75460,5074,14216
8600000US14217,18930,8795,10135,56015,69450,3311,14217
8600000US14218,14162,6854,7308,38634,49891,2988,14218
8600000US14219,9820,4807,5013,51998,63341,4431,14219
8600000US14220,18682,9148,9534,54369,64278,2430,14220
8600000US14221,43398,20004,23394,81106,108188,6048,14221
8600000US14222,12846,6278,6568,54841,84084,5931,14222
8600000US14223,17639,8251,9388,63629,75628,4162,14223
8600000US14224,33276,15621,17655,67691,77867,3339,14224
8600000US14225,27381,12630,14751,49516,61804,2920,14225
8600000US14226,23493,10567,12926,69746,89895,6446,14226
8600000US14227,18982,9011,9971,54525,63422,2454,14227
8600000US14228,17996,8871,9125,54132,75566,4081,14228
8600000US14261,5612,2906,2706,,,,14261
8600000US14301,9467,4278,5189,27317,40725,3551,14301
8600000US14302,109,10,99,,,,14302
8600000US14303,4306,2059,2247,27148,47079,15066,14303
8600000US14304,24233,11686,12547,53797,67511,3632,14304
8600000US14305,12667,5416,7251,35712,54071,3919,14305
8600000US14411,11752,5951,5801,50084,64224,6869,14411
8600000US14414,5722,2767,2955,57604,73506,6373,14414
8600000US14415,179,95,84,,57146,23359,14415
8600000US14416,2792,1476,1316,59514,70080,5795,14416
8600000US14418,1057,494,563,58355,86694,21179,14418
8600000US14420,17074,8140,8934,57320,73150,4329,14420
8600000US14422,1826,863,963,68478,79774,7926,14422
8600000US14423,3710,1807,1903,55750,68298,4107,14423
8600000US14424,22501,10561,11940,62717,88677,5532,14424
8600000US14425,8809,4042,4767,68330,80038,6039,14425
8600000US14427,1514,716,798,55833,63598,6844,14427
8600000US14428,6075,2939,3136,69930,87029,13060,14428
8600000US14432,4868,2273,2595,59550,66377,6216,14432
8600000US14433,3003,1513,1490,54542,63280,4274,14433
8600000US14435,2343,1177,1166,68984,81499,8116,14435
8600000US14437,9439,5520,3919,49398,65973,5678,14437
8600000US14441,246,138,108,56250,66881,13791,14441
8600000US14445,6212,3009,3203,50259,63064,4495,14445
8600000US14450,32513,14939,17574,83593,100823,3499,14450
8600000US14454,9952,4438,5514,45316,67348,7688,14454
8600000US14456,15715,7744,7971,47522,62763,4588,14456
8600000US14462,387,195,192,70000,78512,8729,14462
8600000US14464,5800,2866,2934,56569,69420,5309,14464
8600000US14466,1290,695,595,70893,70608,9945,14466
8600000US14467,7851,3996,3855,69861,86063,9450,14467
8600000US14468,13352,6551,6801,70090,83378,5501,14468
8600000US14469,4918,2542,2376,61221,73292,5483,14469
8600000US14470,6130,2985,3145,53824,72240,7531,14470
8600000US14471,2134,1009,1125,62114,71225,7489,14471
8600000US14472,6328,3150,3178,88262,124227,18290,14472
8600000US14475,204,121,83,49750,71285,24743,14475
8600000US14476,1737,862,875,54803,66500,8450,14476
8600000US14477,1085,560,525,64688,76863,12175,14477
8600000US14478,1326,573,753,92981,91393,12990,14478
8600000US14479,131,76,55,67400,76428,17083,14479
8600000US14480,815,343,472,45678,52671,17380,14480
8600000US14481,1420,741,679,59394,65193,6387,14481
8600000US14482,6286,3072,3214,63162,72895,6120,14482
8600000US14485,3277,1667,1610,59427,74017,5513,14485
8600000US14486,342,162,180,66708,94303,25955,14486
8600000US14487,4630,2172,2458,72000,79270,5710,14487
8600000US14489,5794,2900,2894,52285,58880,4330,14489
8600000US14502,7966,3807,4159,69067,83809,4558,14502
8600000US14504,1477,755,722,56279,62673,4240,14504
8600000US14505,3973,1967,2006,63316,70231,5655,14505
8600000US14506,1067,510,557,133167,135163,25230,14506
8600000US14507,966,444,522,60125,72691,10559,14507
8600000US14510,3649,1768,1881,48272,57601,7359,14510
8600000US14511,394,216,178,53854,56260,14343,14511
8600000US14512,3718,1824,1894,57337,75035,7272,14512
8600000US14513,11142,5168,5974,45446,61688,7337,14513
8600000US14514,5286,2500,2786,64112,85360,11843,14514
8600000US14516,1888,895,993,61029,77349,9672,14516
8600000US14517,2452,1212,1240,49395,56569,5051,14517
8600000US14519,9426,4693,4733,63766,79641,5276,14519
8600000US14521,1757,898,859,49420,71293,11326,14521
8600000US14522,7328,3726,3602,53259,71580,9045,14522
8600000US14525,2078,1046,1032,72353,81343,7689,14525
8600000US14526,15397,7073,8324,78250,101802,6164,14526
8600000US14527,9975,4772,5203,51875,70263,5464,14527
8600000US14529,106,68,38,,,,14529
8600000US14530,4174,2117,2057,52599,65562,7841,14530
8600000US14532,3347,1721,1626,64583,77300,6611,14532
8600000US14533,1476,807,669,54342,70051,9404,14533
8600000US14534,23646,11338,12308,116043,160779,6925,14534
8600000US14536,446,236,210,45208,51398,7593,14536
8600000US14537,87,54,33,,53771,40122,14537
8600000US14539,112,51,61,54318,65070,18752,14539
8600000US14541,3614,2714,900,58382,71525,6497,14541
8600000US14542,55,21,34,,40223,12541,14542
8600000US14543,2640,1300,1340,90057,98442,9124,14543
8600000US14544,1597,723,874,56441,66211,7263,14544
8600000US14545,148,57,91,49688,63248,17139,14545
8600000US14546,3734,1861,1873,67569,75300,6956,14546
8600000US14548,3082,1606,1476,62557,69820,5403,14548
8600000US14549,62,34,28,50556,52415,14391,14549
8600000US14550,1212,564,648,45917,83182,41337,14550
8600000US14551,4290,2062,2228,49010,60774,7297,14551
8600000US14555,889,434,455,46389,62071,9677,14555
8600000US14559,14746,7154,7592,80735,93596,4819,14559
8600000US14560,1677,889,788,58750,68938,5347,14560
8600000US14561,2284,1084,1200,65000,79503,8728,14561
8600000US14564,11362,5531,5831,96798,134767,14674,14564
8600000US14568,4560,2289,2271,84750,97883,9203,14568
8600000US14569,4871,2315,2556,57585,67854,7585,14569
8600000US14571,1082,590,492,55781,66004,16197,14571
8600000US14572,3944,1903,2041,50950,61054,5290,14572
8600000US14580,41442,19472,21970,80596,95315,3146,14580
8600000US14585,89,41,48,51250,54395,9982,14585
8600000US14586,8859,4418,4441,81792,87152,9091,14586
8600000US14588,664,586,78,67750,65810,26682,14588
8600000US14589,5716,2759,2957,60945,76405,7984,14589
8600000US14590,4158,2247,1911,48327,60531,4634,14590
8600000US14591,1189,600,589,59722,69403,8608,14591
8600000US14592,175,94,81,57250,57150,28656,14592
8600000US14604,2166,1221,945,21899,42677,10992,14604
8600000US14605,8629,3763,4866,21475,43958,13624,14605
8600000US14606,21453,10047,11406,43237,53436,2077,14606
8600000US14607,15610,7735,7875,45315,60068,4369,14607
8600000US14608,8808,4057,4751,21531,35347,3002,14608
8600000US14609,32268,15190,17078,46117,58218,2767,14609
8600000US14610,12259,5767,6492,66767,91627,6169,14610
8600000US14611,11563,4803,6760,25868,35949,3140,14611
8600000US14612,28024,13581,14443,61218,76832,4959,14612
8600000US14613,9436,4517,4919,35259,45512,3021,14613
8600000US14614,1163,1054,109,80208,66426,28496,14614
8600000US14615,12987,6318,6669,39995,52385,6421,14615
8600000US14616,21609,9973,11636,48562,60867,2775,14616
8600000US14617,17807,8385,9422,65522,83658,4529,14617
8600000US14618,17975,7926,10049,98254,127577,8899,14618
8600000US14619,10803,4579,6224,37801,55733,7809,14619
8600000US14620,21858,11129,10729,44167,60610,3581,14620
8600000US14621,23667,10729,12938,26506,37688,1848,14621
8600000US14622,10063,4734,5329,53977,67561,4556,14622
8600000US14623,22607,11744,10863,50199,61843,3495,14623
8600000US14624,28894,13757,15137,69257,81578,2911,14624
8600000US14625,8174,3939,4235,80053,97009,7206,14625
8600000US14626,24486,11486,13000,62550,76542,3229,14626
8600000US14627,2284,1252,1032,,,,14627
8600000US14701,30995,14809,16186,38891,50694,2125,14701
8600000US14706,4992,2340,2652,52708,66044,4907,14706
8600000US14707,138,79,59,62917,67706,20605,14707
8600000US14708,113,54,59,61875,68465,14612,14708
8600000US14709,1107,569,538,49145,74102,18116,14709
8600000US14710,2665,1327,1338,58004,71041,6464,14710
8600000US14711,1332,677,655,49893,53892,3823,14711
8600000US14712,2523,1318,1205,57202,76136,11172,14712
8600000US14714,403,211,192,56250,62078,7147,14714
8600000US14715,2086,1046,1040,41500,51342,3877,14715
8600000US14716,2386,1402,984,37661,47484,4967,14716
8600000US14717,466,256,210,43875,55381,11180,14717
8600000US14718,1676,866,810,54375,63801,5507,14718
8600000US14719,2583,1283,1300,46771,60166,4496,14719
8600000US14720,510,251,259,30521,35432,5425,14720
8600000US14721,84,50,34,47500,40334,12472,14721
8600000US14722,269,118,151,134135,144410,21069,14722
8600000US14723,827,409,418,58958,65876,6338,14723
8600000US14724,1666,888,778,52778,70820,8242,14724
8600000US14726,1197,576,621,35417,45671,4791,14726
8600000US14727,4114,2062,2052,49481,62423,4945,14727
8600000US14728,857,437,420,52232,65898,16684,14728
8600000US14729,763,440,323,63654,63307,7391,14729
8600000US14731,951,457,494,64000,83729,8788,14731
8600000US14732,116,59,57,51429,51338,7418,14732
8600000US14733,2833,1380,1453,43839,52409,4986,14733
8600000US14735,2135,1106,1029,39278,52026,5010,14735
8600000US14736,223,121,102,54583,79203,30580,14736
8600000US14737,3382,1752,1630,46698,55572,3954,14737
8600000US14738,2782,1421,1361,53400,63101,6868,14738
8600000US14739,2103,1034,1069,42102,49335,4223,14739
8600000US14740,956,469,487,56131,71743,16603,14740
8600000US14741,1368,698,670,61161,69934,5292,14741
8600000US14742,276,129,147,100227,79196,29197,14742
8600000US14743,1423,712,711,41818,56998,6527,14743
8600000US14744,1824,837,987,56719,65642,6919,14744
8600000US14747,1689,877,812,51161,73641,22817,14747
8600000US14748,491,240,251,33929,48461,8683,14748
8600000US14750,3653,1587,2066,55425,83232,8424,14750
8600000US14752,222,75,147,,38821,19764,14752
8600000US14753,871,430,441,40341,54985,7533,14753
8600000US14754,475,216,259,47625,54259,7604,14754
8600000US14755,2436,1299,1137,50056,58416,3365,14755
8600000US14756,70,49,21,38650,52020,45776,14756
8600000US14757,2615,1327,1288,48162,64375,6869,14757
8600000US14760,14584,7125,7459,45326,59938,4437,14760
8600000US14767,1405,753,652,49773,62305,9537,14767
8600000US14769,850,390,460,48317,61129,10925,14769
8600000US14770,2059,1010,1049,49355,61001,7277,14770
8600000US14772,2852,1396,1456,44810,58398,4278,14772
8600000US14774,54,28,26,65417,73608,25436,14774
8600000US14775,2041,1077,964,47548,67753,18486,14775
8600000US14777,517,252,265,45662,55710,8902,14777
8600000US14778,1351,620,731,,,,14778
8600000US14779,4869,2260,2609,34777,45565,2704,14779
8600000US14781,1467,735,732,42007,52062,4897,14781
8600000US14782,1754,870,884,46641,54529,4324,14782
8600000US14783,242,120,122,34205,61919,31039,14783
8600000US14784,818,419,399,52639,62040,10278,14784
8600000US14787,3874,1880,1994,45042,59141,6639,14787
8600000US14788,69,37,32,,,,14788
8600000US14801,4012,2016,1996,51393,60419,2970,14801
8600000US14802,4138,2261,1877,36417,55801,8021,14802
8600000US14803,703,403,300,42321,59729,8196,14803
8600000US14804,1046,535,511,59605,69940,6207,14804
8600000US14805,844,412,432,48068,66409,14792,14805
8600000US14806,1529,771,758,53523,63015,6662,14806
8600000US14807,2253,1058,1195,53992,61291,4512,14807
8600000US14808,449,258,191,52386,69440,13134,14808
8600000US14809,1799,937,862,50208,65579,7992,14809
8600000US14810,9852,4882,4970,41079,58730,6058,14810
8600000US14812,2529,1283,1246,61643,65950,5382,14812
8600000US14813,1802,977,825,39680,54568,6779,14813
8600000US14814,1318,671,647,79375,89667,9549,14814
8600000US14815,718,402,316,47440,77685,20182,14815
8600000US14816,418,229,189,74000,89145,28877,14816
8600000US14817,1958,934,1024,55227,71318,11729,14817
8600000US14818,1860,898,962,59886,67479,8749,14818
8600000US14819,609,272,337,36071,62324,21507,14819
8600000US14820,610,313,297,47857,57838,8131,14820
8600000US14821,2661,1322,1339,55833,64124,4965,14821
8600000US14822,818,429,389,48625,56858,5184,14822
8600000US14823,2750,1388,1362,51336,67294,15034,14823
8600000US14824,426,240,186,41726,47473,5775,14824
8600000US14825,642,294,348,75806,80939,12222,14825
8600000US14826,1555,779,776,50455,58709,5700,14826
8600000US14827,148,83,65,65429,65372,15058,14827
8600000US14830,15432,7443,7989,55967,81057,5165,14830
8600000US14836,683,358,325,90385,85597,10336,14836
8600000US14837,4408,2070,2338,54704,73819,6745,14837
8600000US14838,1427,725,702,60368,71732,5582,14838
8600000US14839,535,258,277,52083,57043,7413,14839
8600000US14840,2346,1151,1195,55027,75472,5966,14840
8600000US14841,467,172,295,75074,75226,40233,14841
8600000US14842,598,317,281,38707,42375,6169,14842
8600000US14843,10107,5080,5027,45000,55657,2807,14843
8600000US14845,16141,7585,8556,64468,83120,5342,14845
8600000US14846,597,309,288,48977,56705,7291,14846
8600000US14847,1900,880,1020,50430,57520,3586,14847
8600000US14850,56421,27555,28866,53239,79236,3492,14850
8600000US14853,2671,1329,1342,,,,14853
8600000US14854,13,0,13,,,,14854
8600000US14855,724,365,359,55917,62930,8836,14855
8600000US14856,137,58,79,15089,20746,13204,14856
8600000US14858,1015,521,494,54063,63940,7788,14858
8600000US14859,647,317,330,52083,70975,15141,14859
8600000US14860,983,492,491,51786,62386,6710,14860
8600000US14861,1088,509,579,46667,56303,6043,14861
8600000US14864,1043,647,396,58750,62220,19023,14864
8600000US14865,2347,1115,1232,44208,57962,5583,14865
8600000US14867,4606,2253,2353,62238,74294,11312,14867
8600000US14869,1060,581,479,53790,62089,7370,14869
8600000US14870,7449,3552,3897,63065,88847,9401,14870
8600000US14871,4090,2188,1902,63790,75920,8544,14871
8600000US14872,519,270,249,61726,92002,15617,14872
8600000US14873,1894,986,908,50045,61910,7468,14873
8600000US14874,192,107,85,41827,53916,13196,14874
8600000US14877,365,208,157,58438,64390,9101,14877
8600000US14878,427,198,229,77083,100414,23735,14878
8600000US14879,1650,806,844,52656,60391,5572,14879
8600000US14880,1254,617,637,46563,54671,5198,14880
8600000US14881,310,155,155,117885,117102,31882,14881
8600000US14882,3168,1480,1688,78358,93293,11048,14882
8600000US14883,3545,1781,1764,51028,62451,6610,14883
8600000US14884,197,84,113,55179,64099,11798,14884
8600000US14885,549,280,269,53438,60455,7369,14885
8600000US14886,5610,2746,2864,69881,80635,6014,14886
8600000US14889,1261,628,633,59010,68591,6497,14889
8600000US14891,3310,1577,1733,48571,60007,3929,14891
8600000US14892,6096,2782,3314,44647,60485,5645,14892
8600000US14893,0,0,0,,,,14893
8600000US14894,1007,513,494,56364,63300,5844,14894
8600000US14895,7740,3640,4100,45839,59367,4156,14895
8600000US14897,590,277,313,42463,53793,6300,14897
8600000US14898,1354,671,683,48750,60704,5847,14898
8600000US14901,12379,6622,5757,30375,45970,3297,14901
8600000US14903,5953,2969,2984,57526,88086,17130,14903
8600000US14904,11702,5444,6258,45719,54942,3966,14904
8600000US14905,6819,3155,3664,56219,71466,6008,14905
8600000US15001,25258,12204,13054,54308,66984,2390,15001
8600000US15003,9205,4482,4723,48766,59757,3496,15003
8600000US15004,270,142,128,,55479,11501,15004
8600000US15005,7731,3786,3945,73285,90530,7516,15005
8600000US15006,408,197,211,104838,111848,14056,15006
8600000US15007,337,164,173,61438,52190,14505,15007
8600000US15009,12219,5662,6557,66346,85100,4699,15009
8600000US15010,22219,10626,11593,54457,73505,5156,15010
8600000US15012,12673,6367,6306,64773,78594,4073,15012
8600000US15014,2444,1116,1328,44028,68817,16855,15014
8600000US15015,954,480,474,112344,145328,15500,15015
8600000US15017,13065,5874,7191,63279,88488,7893,15017
8600000US15018,644,322,322,45804,55326,11708,15018
8600000US15019,1337,668,669,41141,61452,9716,15019
8600000US15020,194,102,92,,88320,34665,15020
8600000US15021,5967,2819,3148,57269,70733,4169,15021
8600000US15022,8095,3957,4138,45610,61913,4754,15022
8600000US15024,7111,3480,3631,67500,85819,6100,15024
8600000US15025,12872,5988,6884,57699,85956,9089,15025
8600000US15026,2632,1332,1300,70625,79899,8557,15026
8600000US15027,1808,860,948,58472,69820,8054,15027
8600000US15028,115,63,52,35625,45879,14503,15028
8600000US15030,885,495,390,47768,57972,13697,15030
8600000US15031,331,115,216,,39764,18907,15031
8600000US15033,3645,1756,1889,36392,49467,6205,15033
8600000US15034,1541,661,880,34583,58187,13484,15034
8600000US15035,1702,843,859,45292,56422,6085,15035
8600000US15037,8720,4101,4619,61450,75001,4636,15037
8600000US15038,253,108,145,75078,75244,24749,15038
8600000US15042,7038,3306,3732,61400,74484,4463,15042
8600000US15043,1691,804,887,64125,69814,6981,15043
8600000US15044,20680,9887,10793,106403,135182,8964,15044
8600000US15045,3560,1715,1845,38950,48057,4019,15045
8600000US15046,2001,949,1052,73042,81296,6240,15046
8600000US15047,118,52,66,61875,66132,10668,15047
8600000US15049,776,352,424,48125,58097,6099,15049
8600000US15050,2065,1008,1057,73182,79689,7881,15050
8600000US15051,342,150,192,59954,91042,31728,15051
8600000US15052,2675,1190,1485,59683,68219,4968,15052
8600000US15053,104,51,53,47969,47788,11268,15053
8600000US15054,246,111,135,32981,52037,17546,15054
8600000US15055,1078,457,621,44476,56774,8448,15055
8600000US15056,887,435,452,47227,58623,7660,15056
8600000US15057,11852,5958,5894,78566,97026,5407,15057
8600000US15059,3276,1564,1712,40625,47560,5180,15059
8600000US15060,572,296,276,52656,61097,7778,15060
8600000US15061,9883,4647,5236,53811,67200,4930,15061
8600000US15062,6071,2779,3292,40583,54028,3788,15062
8600000US15063,9169,4506,4663,54347,68621,4647,15063
8600000US15064,277,152,125,67083,82912,25833,15064
8600000US15065,9146,4207,4939,54321,62799,3204,15065
8600000US15066,9929,4671,5258,50597,62535,5406,15066
8600000US15067,1814,912,902,39961,51559,5176,15067
8600000US15068,30208,14593,15615,52424,68955,3303,15068
8600000US15071,8321,3982,4339,70722,91557,6440,15071
8600000US15072,9,0,9,,,,15072
8600000US15074,6537,3099,3438,45159,56770,3803,15074
8600000US15075,144,61,83,,50975,28972,15075
8600000US15076,748,364,384,41429,49208,14813,15076
8600000US15077,127,68,59,45000,56619,17177,15077
8600000US15078,364,188,176,62778,65082,20658,15078
8600000US15081,319,167,152,54464,59085,8250,15081
8600000US15082,131,32,99,,45607,30412,15082
8600000US15083,563,273,290,37279,47441,6088,15083
8600000US15084,7918,4048,3870,43070,56498,4196,15084
8600000US15085,5899,2792,3107,62015,79423,9014,15085
8600000US15086,299,221,78,63375,87490,42432,15086
8600000US15087,121,65,56,83382,78188,25303,15087
8600000US15088,315,145,170,39583,60372,22073,15088
8600000US15089,5409,2476,2933,52574,65660,5336,15089
8600000US15090,17507,8463,9044,111405,153541,9054,15090
8600000US15101,19447,9403,10044,85178,107169,6055,15101
8600000US15102,23663,11189,12474,76197,97792,5619,15102
8600000US15104,6375,3033,3342,29485,38834,3419,15104
8600000US15106,15981,7450,8531,53077,70895,4368,15106
8600000US15108,33337,16603,16734,74978,98456,3898,15108
8600000US15110,3780,1407,2373,26532,60277,29085,15110
8600000US15112,2147,911,1236,31250,43491,4497,15112
8600000US15116,11818,5733,6085,76170,94285,6661,15116
8600000US15120,14724,6930,7794,42328,59126,3950,15120
8600000US15122,16070,7484,8586,51717,66954,4719,15122
8600000US15126,6032,2937,3095,76298,86691,8355,15126
8600000US15129,8327,3932,4395,68878,80228,4625,15129
8600000US15131,6615,2989,3626,55169,70239,6424,15131
8600000US15132,17095,7423,9672,30599,42905,2517,15132
8600000US15133,5212,2531,2681,53181,60500,4105,15133
8600000US15135,4427,2163,2264,58323,68756,7286,15135
8600000US15136,17657,8599,9058,51600,70595,4081,15136
8600000US15137,8193,4003,4190,42714,61972,6496,15137
8600000US15139,5517,2379,3138,64054,90807,7197,15139
8600000US15140,2500,1234,1266,33769,46597,8513,15140
8600000US15142,971,538,433,174000,247559,66352,15142
8600000US15143,16054,7650,8404,100668,156075,8632,15143
8600000US15144,3333,1560,1773,54449,67313,7314,15144
8600000US15145,5468,2318,3150,36163,44893,4891,15145
8600000US15146,23067,10731,12336,61886,75343,3257,15146
8600000US15147,14542,6980,7562,51351,66305,4618,15147
8600000US15148,1974,980,994,32065,40859,4692,15148
8600000US15201,10994,5323,5671,61642,84888,5452,15201
8600000US15202,16463,7877,8586,50210,68684,3216,15202
8600000US15203,9227,5014,4213,51457,69941,5899,15203
8600000US15204,6392,2876,3516,41101,54142,4988,15204
8600000US15205,18138,8721,9417,57200,72709,3547,15205
8600000US15206,25030,11811,13219,46250,74375,3891,15206
8600000US15207,9135,4265,4870,43319,57526,3504,15207
8600000US15208,7604,3495,4109,35945,83371,9682,15208
8600000US15209,10004,5119,4885,55997,75738,8894,15209
8600000US15210,20239,9691,10548,39365,53854,4258,15210
8600000US15211,9377,4701,4676,53590,75462,5859,15211
8600000US15212,22250,10790,11460,44908,59456,2477,15212
8600000US15213,27084,12774,14310,22099,44943,4455,15213
8600000US15214,10488,4958,5530,43862,59915,3443,15214
8600000US15215,9918,4653,5265,72475,110919,10569,15215
8600000US15216,18367,9064,9303,60808,81172,5609,15216
8600000US15217,23246,11495,11751,75618,109948,5903,15217
8600000US15218,11140,5247,5893,52680,71910,3530,15218
8600000US15219,14298,7094,7204,21274,43297,4204,15219
8600000US15220,14926,7171,7755,70511,81986,3314,15220
8600000US15221,25338,10816,14522,41189,58776,2965,15221
8600000US15222,4763,2342,2421,99419,136218,14542,15222
8600000US15223,5511,2802,2709,52319,62560,5725,15223
8600000US15224,9872,4610,5262,45462,61305,4438,15224
8600000US15225,898,392,506,39063,49433,4722,15225
8600000US15226,11425,5460,5965,54746,68759,4931,15226
8600000US15227,22289,10802,11487,58838,73131,4633,15227
8600000US15228,13453,6557,6896,100359,133586,9858,15228
8600000US15229,11026,4984,6042,62889,80153,5963,15229
8600000US15232,10716,5175,5541,54722,88294,8363,15232
8600000US15233,3808,2837,971,46406,62572,11455,15233
8600000US15234,11294,5540,5754,59248,76273,5425,15234
8600000US15235,27863,12888,14975,58026,76575,5539,15235
8600000US15236,23642,10948,12694,66006,80112,3353,15236
8600000US15237,33932,15761,18171,80520,101874,3886,15237
8600000US15238,10025,4859,5166,95373,163308,13552,15238
8600000US15239,16573,8058,8515,72500,82400,3354,15239
8600000US15241,15202,7259,7943,116909,162714,9824,15241
8600000US15243,10515,4716,5799,86862,117746,7512,15243
8600000US15260,0,0,0,,,,15260
8600000US15290,0,0,0,,,,15290
8600000US15301,40512,19354,21158,55685,74803,2825,15301
8600000US15310,204,92,112,35875,51317,11653,15310
8600000US15311,1384,683,701,75833,82697,10198,15311
8600000US15312,3056,1523,1533,69318,90259,7729,15312
8600000US15313,307,135,172,63500,76969,26587,15313
8600000US15314,2864,1294,1570,44406,57263,5311,15314
8600000US15315,453,215,238,49167,57722,10025,15315
8600000US15316,81,30,51,70625,54248,16450,15316
8600000US15317,30064,14800,15264,86631,107719,4408,15317
8600000US15320,4046,1709,2337,46524,62213,7040,15320
8600000US15321,1259,673,586,60139,90939,16629,15321
8600000US15322,1665,775,890,52448,77472,25402,15322
8600000US15323,3711,1908,1803,61487,75859,6258,15323
8600000US15324,470,213,257,33750,45785,6742,15324
8600000US15325,347,162,185,35147,40844,14880,15325
8600000US15327,1358,746,612,56618,74201,12085,15327
8600000US15329,1142,592,550,72188,86701,8537,15329
8600000US15330,4357,2269,2088,86176,108885,12459,15330
8600000US15331,502,231,271,41111,53840,9743,15331
8600000US15332,6789,3408,3381,64054,75467,4750,15332
8600000US15333,1732,823,909,44196,64628,9685,15333
8600000US15334,99,49,50,48333,63650,25920,15334
8600000US15337,500,273,227,63875,71806,8615,15337
8600000US15338,1348,688,660,50977,82971,20114,15338
8600000US15340,1038,470,568,80000,101669,45542,15340
8600000US15341,633,341,292,56250,73587,10815,15341
8600000US15342,4032,1839,2193,63823,72067,6927,15342
8600000US15344,1100,580,520,63385,74439,7823,15344
8600000US15345,1098,543,555,57019,69489,10935,15345
8600000US15346,387,179,208,40568,57521,13077,15346
8600000US15347,569,178,391,,66524,36292,15347
8600000US15348,209,130,79,44018,52159,17457,15348
8600000US15349,1241,588,653,60893,69025,6561,15349
8600000US15350,314,157,157,48281,48842,12141,15350
8600000US15351,551,259,292,52857,54626,12695,15351
8600000US15352,759,374,385,47500,65461,8065,15352
8600000US15353,88,44,44,49643,70130,24269,15353
8600000US15357,1097,557,540,63482,70525,7395,15357
8600000US15358,512,192,320,27324,42946,9181,15358
8600000US15359,143,65,78,80313,73736,21814,15359
8600000US15360,1431,748,683,73393,93155,12472,15360
8600000US15361,217,137,80,,76941,47978,15361
8600000US15362,587,301,286,54063,69187,13021,15362
8600000US15363,445,242,203,89432,81528,28805,15363
8600000US15364,619,327,292,75769,97544,22658,15364
8600000US15366,171,65,106,,88867,34825,15366
8600000US15367,6423,3092,3331,132059,169918,12618,15367
8600000US15368,295,118,177,36481,50546,13164,15368
8600000US15370,12427,7144,5283,57636,72429,5298,15370
8600000US15376,1339,647,692,65417,103293,45535,15376
8600000US15377,473,239,234,58438,69969,11175,15377
8600000US15378,114,59,55,,87461,49607,15378
8600000US15379,83,45,38,63750,69671,13645,15379
8600000US15380,419,234,185,50000,66684,12094,15380
8600000US15401,25332,12308,13024,41927,63724,4038,15401
8600000US15410,994,518,476,49313,54639,14508,15410
8600000US15411,522,256,266,54792,81453,13392,15411
8600000US15412,394,192,202,50313,65939,14751,15412
8600000US15413,482,222,260,36219,50181,13080,15413
8600000US15417,6419,2975,3444,39656,56372,4841,15417
8600000US15419,4063,1686,2377,31473,57255,14814,15419
8600000US15420,159,83,76,23900,34424,16711,15420
8600000US15421,39,19,20,,,,15421
8600000US15422,136,49,87,,50651,39294,15422
8600000US15423,1963,915,1048,63859,85472,12079,15423
8600000US15424,1639,797,842,36215,50371,5423,15424
8600000US15425,15062,7271,7791,44599,59337,3923,15425
8600000US15427,910,492,418,39118,56343,5518,15427
8600000US15428,1619,828,791,54650,72654,9187,15428
8600000US15429,224,111,113,,59672,23823,15429
8600000US15430,273,140,133,,54731,20419,15430
8600000US15431,3332,1507,1825,46802,63367,10000,15431
8600000US15432,402,206,196,34375,50177,6614,15432
8600000US15433,681,443,238,34844,55073,14800,15433
8600000US15434,210,115,95,33125,50281,11119,15434
8600000US15435,474,247,227,44653,61624,18685,15435
8600000US15436,2164,956,1208,41618,53511,6364,15436
8600000US15437,2161,1096,1065,57232,59426,6956,15437
8600000US15438,1612,748,864,55570,60402,6739,15438
8600000US15440,154,93,61,59081,59966,12525,15440
8600000US15442,1418,686,732,40326,55534,7245,15442
8600000US15443,31,16,15,,,,15443
8600000US15444,322,117,205,19554,35511,15345,15444
8600000US15445,2258,1024,1234,56536,66714,11501,15445
8600000US15446,270,100,170,40625,43231,13093,15446
8600000US15447,48,7,41,,,,15447
8600000US15448,237,147,90,63707,66043,13108,15448
8600000US15449,313,115,198,44955,65332,37295,15449
8600000US15450,2211,2136,75,,295238,428702,15450
8600000US15451,898,328,570,30880,84372,60243,15451
8600000US15454,128,80,48,,29801,13769,15454
8600000US15455,412,191,221,43194,43440,15768,15455
8600000US15456,2155,1098,1057,29720,46314,5958,15456
8600000US15458,1911,1041,870,42813,56130,10108,15458
8600000US15459,1360,673,687,53500,57033,8192,15459
8600000US15460,73,35,38,,51264,14745,15460
8600000US15461,3269,1347,1922,30869,44975,6659,15461
8600000US15462,388,232,156,,40752,22766,15462
8600000US15463,33,17,16,,,,15463
8600000US15464,1197,616,581,56622,71440,16628,15464
8600000US15466,336,199,137,54125,55765,7237,15466
8600000US15467,116,50,66,31786,35569,8503,15467
8600000US15468,1814,883,931,39934,51629,9764,15468
8600000US15469,1689,712,977,40042,65463,27342,15469
8600000US15470,576,297,279,62393,84466,24992,15470
8600000US15472,156,32,124,,49288,35837,15472
8600000US15473,3177,1538,1639,59063,66353,5638,15473
8600000US15474,1582,735,847,50714,58932,11529,15474
8600000US15475,1132,523,609,46635,63259,12591,15475
8600000US15476,55,15,40,,,,15476
8600000US15477,732,331,401,56250,62119,7121,15477
8600000US15478,4700,2267,2433,53258,65772,6845,15478
8600000US15479,1578,775,803,54458,63789,11302,15479
8600000US15480,1524,712,812,49306,61308,9617,15480
8600000US15482,348,168,180,48056,57485,11433,15482
8600000US15483,372,200,172,46458,58509,8204,15483
8600000US15484,57,31,26,,61120,28529,15484
8600000US15486,1867,875,992,55568,70259,10142,15486
8600000US15489,379,175,204,29792,58468,21444,15489
8600000US15490,497,254,243,,67904,33794,15490
8600000US15492,115,66,49,,21415,8349,15492
8600000US15501,13434,7081,6353,48734,64699,4815,15501
8600000US15502,122,53,69,90972,77480,18289,15502
8600000US15510,2553,2553,0,,,,15510
8600000US15520,226,100,126,43235,45407,16394,15520
8600000US15521,1425,686,739,47083,69426,13012,15521
8600000US15522,9580,4562,5018,51675,62105,4310,15522
8600000US15530,4183,2095,2088,51563,61104,4344,15530
8600000US15531,3071,1572,1499,46976,58043,4947,15531
8600000US15532,90,43,47,49167,54298,20274,15532
8600000US15533,1101,547,554,41813,63796,11580,15533
8600000US15534,821,393,428,44375,70966,18482,15534
8600000US15535,1758,925,833,52614,63202,7263,15535
8600000US15536,393,176,217,60208,66772,9601,15536
8600000US15537,6431,3168,3263,46265,59681,4688,15537
8600000US15538,601,304,297,55000,69543,17439,15538
8600000US15539,492,278,214,69167,74619,23654,15539
8600000US15540,196,106,90,33250,69973,23808,15540
8600000US15541,2842,1385,1457,61012,75405,12386,15541
8600000US15542,886,478,408,49950,61885,10159,15542
8600000US15544,103,51,52,36875,40723,11075,15544
8600000US15545,2156,1106,1050,47969,58232,4586,15545
8600000US15546,191,134,57,64769,80295,29336,15546
8600000US15547,374,187,187,45833,56478,10528,15547
8600000US15550,1352,700,652,47833,58234,4539,15550
8600000US15551,592,303,289,53468,58910,5643,15551
8600000US15552,4589,2231,2358,45912,60431,6678,15552
8600000US15554,1770,895,875,40966,59400,10790,15554
8600000US15555,86,41,45,,55717,29524,15555
8600000US15557,2829,1383,1446,50344,64642,4330,15557
8600000US15558,1640,785,855,47344,56183,4685,15558
8600000US15559,1564,788,776,52321,58473,5101,15559
8600000US15560,134,66,68,46250,61738,11918,15560
8600000US15561,162,87,75,60455,60134,10682,15561
8600000US15562,138,75,63,90833,82400,18465,15562
8600000US15563,2547,1266,1281,52893,60439,5090,15563
8600000US15564,42,20,22,59375,63122,14655,15564
8600000US15601,48393,22666,25727,58080,75808,2882,15601
8600000US15610,3187,1636,1551,71290,74421,6683,15610
8600000US15611,584,389,195,31307,46939,17869,15611
8600000US15612,323,174,149,33071,234505,330995,15612
8600000US15613,11554,5628,5926,55997,73903,5319,15613
8600000US15615,260,100,160,103224,87924,23158,15615
8600000US15616,0,0,0,,,,15616
8600000US15617,288,155,133,47083,54953,8051,15617
8600000US15618,1868,869,999,43676,57714,5655,15618
8600000US15620,525,228,297,43278,45938,10618,15620
8600000US15621,68,22,46,,,,15621
8600000US15622,1080,601,479,56806,79246,20120,15622
8600000US15623,526,243,283,54574,60690,10094,15623
8600000US15624,222,103,119,58893,53328,16079,15624
8600000US15625,26,12,14,,,,15625
8600000US15626,4271,2007,2264,63366,83384,9148,15626
8600000US15627,5359,2574,2785,48016,60356,6374,15627
8600000US15628,539,303,236,52583,60875,9825,15628
8600000US15629,620,346,274,41625,43298,6422,15629
8600000US15631,961,455,506,39890,51864,5702,15631
8600000US15632,7618,3787,3831,77043,105071,8557,15632
8600000US15633,493,246,247,,54029,17716,15633
8600000US15634,217,82,135,16250,31936,15152,15634
8600000US15635,106,72,34,73875,62042,27368,15635
8600000US15636,3022,1604,1418,118264,132613,14437,15636
8600000US15637,1261,615,646,71927,76142,9199,15637
8600000US15638,180,85,95,44667,46810,15947,15638
8600000US15639,1629,729,900,64884,74372,13017,15639
8600000US15640,476,245,231,78750,77475,14774,15640
8600000US15641,390,188,202,43750,53294,6987,15641
8600000US15642,35036,16868,18168,72524,89075,3022,15642
8600000US15644,15245,7347,7898,54783,72160,4199,15644
8600000US15646,156,58,98,67750,65010,16901,15646
8600000US15647,196,95,101,81750,92416,24894,15647
8600000US15650,22025,10591,11434,57523,75574,5734,15650
8600000US15655,275,134,141,61932,80780,25296,15655
8600000US15656,8008,3936,4072,59219,70493,3576,15656
8600000US15658,7540,3666,3874,56507,81607,7425,15658
8600000US15660,301,163,138,78942,74124,12882,15660
8600000US15661,507,270,237,,58003,21174,15661
8600000US15662,121,45,76,,45939,22592,15662
8600000US15663,386,185,201,43250,54376,10791,15663
8600000US15665,999,365,634,,61210,20300,15665
8600000US15666,13078,6328,6750,52599,63413,3366,15666
8600000US15668,9925,4758,5167,94590,120945,9467,15668
8600000US15670,2997,1487,1510,54948,70500,8346,15670
8600000US15671,529,301,228,64028,67836,14040,15671
8600000US15672,2847,1450,1397,68000,82392,10415,15672
8600000US15673,1070,517,553,50833,65542,12801,15673
8600000US15675,753,424,329,44531,56936,10251,15675
8600000US15676,547,276,271,41014,61279,22598,15676
8600000US15677,300,147,153,45625,62922,12588,15677
8600000US15678,595,315,280,55188,62134,12162,15678
8600000US15679,2230,1093,1137,57112,64974,7186,15679
8600000US15680,116,50,66,39375,53067,17754,15680
8600000US15681,3772,1987,1785,50917,66092,5076,15681
8600000US15683,6435,3005,3430,51976,63314,4877,15683
8600000US15684,588,253,335,55625,64873,16758,15684
8600000US15686,665,317,348,61968,68128,13611,15686
8600000US15687,1056,563,493,54375,67509,9575,15687
8600000US15688,940,467,473,60192,66748,10097,15688
8600000US15689,271,176,95,78365,71004,22788,15689
8600000US15690,6685,3221,3464,44879,53332,3346,15690
8600000US15691,78,0,78,,,,15691
8600000US15692,993,547,446,37384,51282,10966,15692
8600000US15693,168,92,76,63696,71154,32521,15693
8600000US15695,372,209,163,,62737,27466,15695
8600000US15696,326,197,129,60625,64136,7578,15696
8600000US15697,2383,1275,1108,53363,62318,7090,15697
8600000US15698,498,261,237,52708,59191,10585,15698
8600000US15701,29621,14643,14978,45353,65534,4511,15701
8600000US15710,184,105,79,85208,71619,14305,15710
8600000US15711,344,187,157,59375,58955,8199,15711
8600000US15712,143,85,58,68125,73526,19253,15712
8600000US15713,304,149,155,23571,32076,17769,15713
8600000US15714,3741,1876,1865,45495,52681,4002,15714
8600000US15715,358,166,192,44500,54933,11288,15715
8600000US15716,763,352,411,22778,61397,45085,15716
8600000US15717,8213,3968,4245,51915,66507,5519,15717
8600000US15721,176,102,74,45673,52467,10127,15721
8600000US15722,1861,936,925,48426,60337,4033,15722
8600000US15723,13,0,13,,,,15723
8600000US15724,1855,859,996,44837,57596,6182,15724
8600000US15725,1314,651,663,53287,62532,5577,15725
8600000US15727,134,48,86,40208,45023,12057,15727
8600000US15728,2540,1317,1223,41207,58531,8698,15728
8600000US15729,1079,553,526,36780,53510,10674,15729
8600000US15730,66,18,48,,33223,16971,15730
8600000US15731,423,195,228,53475,47359,14709,15731
8600000US15732,1220,610,610,57500,68713,6992,15732
8600000US15733,121,61,60,28750,31712,9157,15733
8600000US15734,280,110,170,33646,51661,17609,15734
8600000US15736,694,308,386,63393,63778,8171,15736
8600000US15737,52,33,19,39375,43737,8036,15737
8600000US15738,169,80,89,37500,43392,5742,15738
8600000US15739,349,165,184,56250,57954,9147,15739
8600000US15741,49,25,24,52500,56892,9398,15741
8600000US15742,712,355,357,43125,70377,23726,15742
8600000US15744,119,66,53,41389,49564,19229,15744
8600000US15745,175,85,90,62250,64054,18202,15745
8600000US15746,121,54,67,29896,42849,13974,15746
8600000US15747,1582,831,751,44009,59614,10340,15747
8600000US15748,5299,2621,2678,49200,60083,4401,15748
8600000US15750,266,131,135,33793,44677,13726,15750
8600000US15752,37,16,21,,,,15752
8600000US15753,341,168,173,40268,44789,6891,15753
8600000US15754,580,294,286,71969,63153,15260,15754
8600000US15756,211,143,68,37330,48038,9403,15756
8600000US15757,1255,657,598,48438,59070,4781,15757
8600000US15759,2210,1154,1056,58090,67754,7344,15759
8600000US15760,105,51,54,43333,51641,16611,15760
8600000US15761,122,62,60,39333,40521,12255,15761
8600000US15762,719,378,341,65167,70572,7349,15762
8600000US15764,152,90,62,47679,50995,11316,15764
8600000US15765,1359,749,610,59125,72967,9320,15765
8600000US15767,11115,5391,5724,43482,55518,2569,15767
8600000US15770,196,101,95,64167,60036,13032,15770
8600000US15771,758,373,385,47500,59028,8000,15771
8600000US15772,1228,646,582,42566,57136,7147,15772
8600000US15773,426,205,221,49375,59044,9437,15773
8600000US15774,2148,1065,1083,60288,76136,13681,15774
8600000US15775,661,360,301,38664,57081,14501,15775
8600000US15776,45,26,19,34821,51772,15705,15776
8600000US15777,88,55,33,46111,49312,14394,15777
8600000US15778,146,84,62,42500,66428,22893,15778
8600000US15779,640,422,218,63466,63864,10950,15779
8600000US15780,136,60,76,58750,56303,11563,15780
8600000US15781,78,44,34,53750,63857,25169,15781
8600000US15783,97,51,46,44583,64158,29866,15783
8600000US15784,61,30,31,71250,95097,76846,15784
8600000US15801,15054,7317,7737,50829,62582,4275,15801
8600000US15821,108,55,53,45875,46720,8810,15821
8600000US15823,1024,504,520,50375,59897,6189,15823
8600000US15824,4109,1961,2148,49364,60981,4163,15824
8600000US15825,7174,3555,3619,53598,66473,3501,15825
8600000US15827,230,110,120,54375,54760,8201,15827
8600000US15828,200,104,96,35625,51594,12468,15828
8600000US15829,958,478,480,52038,80906,25606,15829
8600000US15832,212,121,91,39464,44193,6427,15832
8600000US15834,3543,1740,1803,41679,54496,4229,15834
8600000US15840,1629,799,830,51477,61077,5573,15840
8600000US15841,278,131,147,40357,56966,21529,15841
8600000US15845,2457,1269,1188,48486,57021,3393,15845
8600000US15846,2749,1444,1305,55669,64097,7366,15846
8600000US15847,260,121,139,35833,41408,6512,15847
8600000US15848,831,413,418,40179,56940,9979,15848
8600000US15849,995,513,482,49821,55858,4857,15849
8600000US15851,5134,2550,2584,43761,54397,3346,15851
8600000US15853,5037,2558,2479,49765,60518,5421,15853
8600000US15856,774,404,370,56406,68008,5974,15856
8600000US15857,10298,5028,5270,51684,69414,4320,15857
8600000US15860,864,457,407,53333,61982,7608,15860
8600000US15861,120,69,51,30500,43068,13156,15861
8600000US15863,212,98,114,40313,45111,9722,15863
8600000US15864,1276,660,616,51250,65842,7832,15864
8600000US15865,1033,520,513,39318,49991,5436,15865
8600000US15866,205,106,99,54063,61234,12582,15866
8600000US15868,1120,559,561,49972,59118,6559,15868
8600000US15870,910,466,444,55804,63711,6116,15870
8600000US15901,2949,1400,1549,15204,22300,2266,15901
8600000US15902,8999,4084,4915,31783,42744,2013,15902
8600000US15904,13170,6096,7074,56828,69279,3573,15904
8600000US15905,16347,7676,8671,54894,74437,5761,15905
8600000US15906,8415,3993,4422,32736,42547,3495,15906
8600000US15909,4135,1986,2149,51122,62889,4748,15909
8600000US15920,628,312,316,58375,71634,11875,15920
8600000US15921,83,33,50,33036,36321,11068,15921
8600000US15922,164,85,79,37167,44939,11690,15922
8600000US15923,1200,592,608,44716,66224,9498,15923
8600000US15924,777,377,400,50000,59460,7880,15924
8600000US15925,133,75,58,46250,61815,14167,15925
8600000US15926,2124,1096,1028,47460,61828,5476,15926
8600000US15927,795,341,454,39688,46972,11508,15927
8600000US15928,1337,561,776,43971,54020,8775,15928
8600000US15929,32,18,14,,18344,11821,15929
8600000US15930,94,40,54,,,,15930
8600000US15931,7192,3586,3606,55532,75469,10305,15931
8600000US15934,204,144,60,99464,98479,16442,15934
8600000US15935,2760,1415,1345,54637,65467,7516,15935
8600000US15936,1108,598,510,51652,52386,4483,15936
8600000US15937,622,275,347,51333,53128,10724,15937
8600000US15938,1843,895,948,50074,62933,4998,15938
8600000US15940,3640,2221,1419,72656,76843,5707,15940
8600000US15942,1818,927,891,54330,69652,10385,15942
8600000US15943,2883,1419,1464,47615,53611,4525,15943
8600000US15944,2539,1279,1260,51518,60508,4013,15944
8600000US15945,88,55,33,46944,51472,10137,15945
8600000US15946,5328,2657,2671,53240,62240,4738,15946
8600000US15948,476,250,226,65804,54728,12879,15948
8600000US15949,445,222,223,53281,56679,8903,15949
8600000US15951,374,232,142,,56232,18459,15951
8600000US15952,1317,629,688,53750,62796,9844,15952
8600000US15953,97,27,70,38661,42149,7504,15953
8600000US15954,1711,831,880,42692,52786,4198,15954
8600000US15955,1847,922,925,51442,59083,6982,15955
8600000US15956,1912,986,926,40847,55053,8246,15956
8600000US15957,522,293,229,69500,69055,12374,15957
8600000US15958,1650,868,782,59659,71959,7536,15958
8600000US15960,368,183,185,34714,48472,12835,15960
8600000US15961,639,336,303,47386,63365,14791,15961
8600000US15962,118,50,68,58438,67436,20738,15962
8600000US15963,8648,4263,4385,42168,61784,5492,15963
8600000US16001,31784,15162,16622,55533,67044,2385,16001
8600000US16002,11920,5876,6044,69887,83048,4969,16002
8600000US16020,901,458,443,51625,65770,6676,16020
8600000US16022,254,124,130,52500,54535,8611,16022
8600000US16023,3693,1617,2076,44098,59437,6416,16023
8600000US16024,212,114,98,70000,72098,13057,16024
8600000US16025,4164,2080,2084,68768,86764,7201,16025
8600000US16027,207,103,104,58750,77990,22195,16027
8600000US16028,1455,721,734,42500,56736,5961,16028
8600000US16029,630,304,326,49226,61381,9282,16029
8600000US16030,267,129,138,58125,56382,7533,16030
8600000US16033,5164,2615,2549,62945,78651,4463,16033
8600000US16034,1476,677,799,62284,74979,8265,16034
8600000US16035,77,32,45,91000,83335,29341,16035
8600000US16036,150,66,84,40000,54369,12468,16036
8600000US16037,3658,1908,1750,79085,93991,7190,16037
8600000US16038,2837,1425,1412,60313,76287,7470,16038
8600000US16040,781,415,366,49676,64321,6369,16040
8600000US16041,1660,821,839,51393,56690,4806,16041
8600000US16045,830,372,458,47069,60358,8422,16045
8600000US16046,12066,6075,5991,114973,151130,10493,16046
8600000US16048,130,73,57,68750,64740,22736,16048
8600000US16049,2359,1199,1160,47292,63809,4335,16049
8600000US16050,1160,563,597,48646,64604,8014,16050
8600000US16051,2266,1138,1128,54406,63370,5361,16051
8600000US16052,1981,1053,928,64063,70712,6374,16052
8600000US16053,3680,1902,1778,76083,95188,9617,16053
8600000US16054,304,156,148,42143,49526,8251,16054
8600000US16055,6420,3215,3205,82933,96191,9172,16055
8600000US16056,3887,1738,2149,59300,75885,6591,16056
8600000US16057,12772,5906,6866,48610,62190,3646,16057
8600000US16059,6488,3261,3227,74491,98597,9806,16059
8600000US16061,2054,1093,961,58438,68452,6110,16061
8600000US16063,5340,2433,2907,56794,75868,6513,16063
8600000US16066,22780,11544,11236,103947,128106,5287,16066
8600000US16101,26083,12154,13929,40236,54587,2226,16101
8600000US16102,4625,2316,2309,46211,66648,10904,16102
8600000US16105,12202,5617,6585,64337,85965,6203,16105
8600000US16110,269,140,129,57500,74438,14086,16110
8600000US16111,1039,494,545,43427,57497,8026,16111
8600000US16112,1273,664,609,61181,70708,9760,16112
8600000US16113,392,181,211,65625,81398,15163,16113
8600000US16114,469,258,211,46429,62045,10918,16114
8600000US16115,2571,1242,1329,56333,71239,6200,16115
8600000US16116,2335,1135,1200,51650,73971,16028,16116
8600000US16117,13246,6331,6915,51045,64483,3428,16117
8600000US16120,1726,906,820,53688,63716,6159,16120
8600000US16121,3432,1325,2107,28611,38281,3979,16121
8600000US16123,1772,904,868,82250,87958,11491,16123
8600000US16124,1580,768,812,49718,65631,7854,16124
8600000US16125,13967,6637,7330,48333,70242,8758,16125
8600000US16127,12577,6156,6421,60354,74041,4831,16127
8600000US16130,1727,851,876,43438,54534,3117,16130
8600000US16131,723,358,365,58553,79977,15848,16131
8600000US16132,217,121,96,,41998,17218,16132
8600000US16133,1204,571,633,57734,72792,9006,16133
8600000US16134,2869,1452,1417,44403,54730,3645,16134
8600000US16136,583,281,302,53958,59008,7245,16136
8600000US16137,10637,6114,4523,56476,68281,2409,16137
8600000US16140,20,7,13,,,,16140
8600000US16141,1397,732,665,52500,66079,8405,16141
8600000US16142,5354,2581,2773,57344,79940,7070,16142
8600000US16143,2249,1170,1079,48235,63191,6989,16143
8600000US16145,2183,1088,1095,50455,64130,4470,16145
8600000US16146,10544,4915,5629,31137,46117,4213,16146
8600000US16148,13446,6427,7019,53413,72582,5184,16148
8600000US16150,5491,2588,2903,54254,64783,4849,16150
8600000US16151,98,51,47,50000,48085,8606,16151
8600000US16153,1917,959,958,55588,66213,3901,16153
8600000US16154,1973,987,986,58775,61675,7917,16154
8600000US16155,121,20,101,28125,33384,11479,16155
8600000US16156,2262,1174,1088,56406,69741,5740,16156
8600000US16157,2573,1240,1333,56182,65697,6243,16157
8600000US16159,3729,1771,1958,56686,64111,5194,16159
8600000US16160,708,326,382,42250,52275,7850,16160
8600000US16161,584,261,323,33846,40606,5203,16161
8600000US16201,14262,6914,7348,49550,66404,3486,16201
8600000US16210,704,352,352,43274,64530,11065,16210
8600000US16211,112,57,55,41111,47404,9477,16211
8600000US16212,295,151,144,37083,49127,12893,16212
8600000US16213,78,43,35,33750,39170,14928,16213
8600000US16214,8652,4117,4535,37804,53219,4132,16214
8600000US16217,64,43,21,33125,48086,14140,16217
8600000US16218,822,446,376,46042,64745,10440,16218
8600000US16222,1866,926,940,44464,58254,4866,16222
8600000US16223,154,65,89,32188,42370,14238,16223
8600000US16224,1033,516,517,54554,63561,5940,16224
8600000US16226,6298,2988,3310,43383,54296,3856,16226
8600000US16228,409,212,197,49464,59286,7841,16228
8600000US16229,4338,2184,2154,64296,85751,12732,16229
8600000US16230,329,152,177,41364,51178,7644,16230
8600000US16232,3218,1512,1706,48438,61530,5368,16232
8600000US16233,882,427,455,39038,70871,25431,16233
8600000US16235,998,505,493,62500,71745,7542,16235
8600000US16236,187,111,76,,31303,18036,16236
8600000US16238,340,157,183,61125,71191,13089,16238
8600000US16239,4812,4333,479,40433,44895,4291,16239
8600000US16240,1122,554,568,46420,56702,5077,16240
8600000US16242,3523,1648,1875,46992,57928,2942,16242
8600000US16244,214,97,117,56667,65018,19333,16244
8600000US16245,175,103,72,36964,44892,7850,16245
8600000US16246,202,99,103,47500,57174,9924,16246
8600000US16248,2501,1219,1282,38311,48151,2876,16248
8600000US16249,1551,809,742,54405,64443,5860,16249
8600000US16250,409,211,198,21250,37819,12246,16250
8600000US16253,64,36,28,43750,43379,7114,16253
8600000US16254,2626,1295,1331,52153,67510,4956,16254
8600000US16255,1295,639,656,50167,61860,4826,16255
8600000US16256,1245,624,621,43750,66760,10284,16256
8600000US16258,1646,737,909,49861,58834,7509,16258
8600000US16259,1470,743,727,47317,56188,4406,16259
8600000US16260,258,117,141,48000,56540,16617,16260
8600000US16262,2254,1149,1105,52857,67904,5492,16262
8600000US16263,192,67,125,,44188,13904,16263
8600000US16301,12463,5982,6481,43548,58761,4044,16301
8600000US16311,361,165,196,54375,63878,7986,16311
8600000US16312,3,0,3,,,,16312
8600000US16313,1409,731,678,46217,52849,3166,16313
8600000US16314,4138,2055,2083,58159,65913,3087,16314
8600000US16316,4398,2118,2280,57271,73203,6736,16316
8600000US16317,1032,533,499,53289,63012,6557,16317
8600000US16319,1121,581,540,53250,70937,10572,16319
8600000US16321,55,38,17,40795,40423,11886,16321
8600000US16322,60,33,27,40750,58041,19857,16322
8600000US16323,12800,6028,6772,46214,59034,3096,16323
8600000US16326,310,186,124,48542,59099,8623,16326
8600000US16327,2410,1215,1195,50278,69926,6384,16327
8600000US16328,108,49,59,42500,48836,9518,16328
8600000US16329,436,238,198,55833,59491,11070,16329
8600000US16331,54,23,31,66375,67124,17636,16331
8600000US16332,27,15,12,,,,16332
8600000US16333,283,139,144,42500,63254,28049,16333
8600000US16334,274,136,138,51250,60260,9517,16334
8600000US16335,22027,10580,11447,46280,61518,3360,16335
8600000US16340,1417,751,666,52313,62216,5593,16340
8600000US16341,1418,688,730,45263,55833,3811,16341
8600000US16342,1822,938,884,56750,65580,5381,16342
8600000US16343,387,148,239,42188,47955,12349,16343
8600000US16344,373,187,186,50250,53275,7419,16344
8600000US16345,2841,1424,1417,60156,104581,24969,16345
8600000US16346,2474,1275,1199,49651,57449,5389,16346
8600000US16347,1725,914,811,42024,52859,5480,16347
8600000US16350,1899,948,951,43824,53738,3153,16350
8600000US16351,1287,647,640,41842,54704,5376,16351
8600000US16352,196,122,74,58750,58137,9136,16352
8600000US16353,2025,1066,959,37883,48865,3492,16353
8600000US16354,8658,4179,4479,41760,53590,2717,16354
8600000US16360,1088,518,570,54479,62736,5581,16360
8600000US16361,35,13,22,63750,67623,15635,16361
8600000US16362,855,426,429,58125,71102,11061,16362
8600000US16364,1048,503,545,57250,67538,11522,16364
8600000US16365,14608,7093,7515,48037,61777,2346,16365
8600000US16370,147,94,53,45333,46348,7466,16370
8600000US16371,2581,1199,1382,43250,55649,4264,16371
8600000US16372,344,163,181,48125,53854,8570,16372
8600000US16373,2656,1335,1321,52383,66277,3589,16373
8600000US16374,1469,795,674,47596,64664,7512,16374
8600000US16401,5821,4074,1747,49116,60027,3641,16401
8600000US16402,692,365,327,57250,71918,16926,16402
8600000US16403,5429,2234,3195,55925,74730,7415,16403
8600000US16404,2600,1325,1275,49730,55902,3191,16404
8600000US16405,624,319,305,49306,56628,7794,16405
8600000US16406,2409,1203,1206,51993,59699,3978,16406
8600000US16407,8785,4155,4630,48770,56773,4712,16407
8600000US16410,1314,623,691,66250,74953,5933,16410
8600000US16411,1314,608,706,56389,69987,10835,16411
8600000US16412,8383,4064,4319,58382,74692,5204,16412
8600000US16415,6984,3293,3691,94806,110852,10391,16415
8600000US16416,121,62,59,35234,49369,17396,16416
8600000US16417,5946,2780,3166,50466,67448,5735,16417
8600000US16420,527,269,258,44079,49574,5187,16420
8600000US16421,2066,919,1147,69821,75847,10376,16421
8600000US16422,270,119,151,38636,48477,13697,16422
8600000US16423,3264,1503,1761,50321,65228,10963,16423
8600000US16424,3823,1947,1876,47083,64612,7257,16424
8600000US16426,2896,1439,1457,56952,67978,6262,16426
8600000US16427,118,59,59,47083,67067,25333,16427
8600000US16428,9869,4752,5117,58964,77187,5629,16428
8600000US16433,4053,2020,2033,54892,71206,5356,16433
8600000US16434,1967,996,971,41676,56225,5641,16434
8600000US16435,1408,677,731,55156,66069,8234,16435
8600000US16436,504,261,243,41875,55743,6654,16436
8600000US16438,6046,2862,3184,53510,63752,4827,16438
8600000US16440,769,364,405,55446,61127,5171,16440
8600000US16441,7923,3991,3932,67388,79735,6413,16441
8600000US16442,2252,1096,1156,64811,78640,8998,16442
8600000US16443,989,452,537,44228,59949,15491,16443
8600000US16444,1224,538,686,,,,16444
8600000US16501,1774,1004,770,11049,16101,3506,16501
8600000US16502,12179,5910,6269,32864,43900,3191,16502
8600000US16503,11712,5902,5810,25099,34630,4778,16503
8600000US16504,12239,5634,6605,41281,52780,4185,16504
8600000US16505,13526,6363,7163,59605,84990,6394,16505
8600000US16506,18885,8806,10079,63376,83484,4621,16506
8600000US16507,7621,3744,3877,36441,44163,4608,16507
8600000US16508,12363,5924,6439,47966,60091,3755,16508
8600000US16509,22208,11113,11095,59304,77873,3832,16509
8600000US16510,19593,9767,9826,51751,67111,3631,16510
8600000US16511,9037,4028,5009,44902,61442,3738,16511
8600000US16546,868,375,493,,,,16546
8600000US16563,1639,1096,543,,,,16563
8600000US16601,25484,12434,13050,43813,56436,2475,16601
8600000US16602,22984,10937,12047,41159,57924,4028,16602
8600000US16611,1984,956,1028,55556,64635,5685,16611
8600000US16613,1120,535,585,60139,67857,4612,16613
8600000US16616,95,59,36,30313,38253,12200,16616
8600000US16617,2133,1050,1083,56607,75109,21877,16617
8600000US16619,222,108,114,36500,56685,14984,16619
8600000US16620,287,137,150,43750,63922,11685,16620
8600000US16621,590,278,312,58000,64976,6737,16621
8600000US16622,131,68,63,58750,63041,15529,16622
8600000US16623,460,195,265,48333,65052,10767,16623
8600000US16624,125,70,55,63750,64887,11860,16624
8600000US16625,2999,1437,1562,44199,53906,4168,16625
8600000US16627,1690,799,891,46438,59185,5676,16627
8600000US16630,3924,1703,2221,47301,62282,4008,16630
8600000US16631,74,44,30,,63833,35816,16631
8600000US16633,198,96,102,57321,56862,14130,16633
8600000US16634,269,137,132,51250,52128,7929,16634
8600000US16635,10130,4790,5340,54136,68260,5666,16635
8600000US16636,607,327,280,72981,87414,13901,16636
8600000US16637,1892,939,953,45785,48908,9054,16637
8600000US16638,24,10,14,59688,73600,22453,16638
8600000US16639,1283,668,615,43889,55980,6160,16639
8600000US16640,585,281,304,54079,62728,6638,16640
8600000US16641,1900,956,944,45909,57286,3631,16641
8600000US16645,138,72,66,61875,66759,13264,16645
8600000US16646,1862,877,985,49805,63681,6279,16646
8600000US16647,614,304,310,54625,72913,15745,16647
8600000US16648,12175,5564,6611,58951,80428,5545,16648
8600000US16650,1501,791,710,47250,57123,5795,16650
8600000US16651,5036,3721,1315,44088,58402,4608,16651
8600000US16652,15470,9275,6195,48008,59724,2710,16652
8600000US16655,1145,538,607,51406,59847,4636,16655
8600000US16656,968,476,492,45750,52780,4956,16656
8600000US16657,1013,498,515,48083,57873,4154,16657
8600000US16659,217,113,104,37222,50635,11325,16659
8600000US16661,679,356,323,47386,53833,6932,16661
8600000US16662,4269,2017,2252,54438,67507,5310,16662
8600000US16664,1507,765,742,53750,63434,5518,16664
8600000US16665,201,94,107,36042,68786,31712,16665
8600000US16666,2609,1333,1276,44703,52860,4064,16666
8600000US16667,1115,578,537,39489,49113,7321,16667
8600000US16668,2731,1358,1373,49651,58481,2946,16668
8600000US16669,1629,819,810,55950,64586,4764,16669
8600000US16670,43,23,20,26250,40380,12270,16670
8600000US16671,387,191,196,49922,57332,7983,16671
8600000US16672,137,58,79,40000,41021,13435,16672
8600000US16673,4249,2084,2165,55869,70029,4719,16673
8600000US16674,536,262,274,47721,50724,6118,16674
8600000US16677,263,111,152,26136,44207,28625,16677
8600000US16678,2053,945,1108,47500,55209,4887,16678
8600000US16679,648,320,328,36250,43564,4936,16679
8600000US16680,314,163,151,49453,61529,10012,16680
8600000US16682,23,17,6,,45979,31524,16682
8600000US16683,298,154,144,63750,65311,8523,16683
8600000US16685,119,49,70,41875,72440,22016,16685
8600000US16686,10395,5234,5161,51097,62760,3779,16686
8600000US16689,417,212,205,46429,57152,7098,16689
8600000US16691,269,139,130,37750,56754,12261,16691
8600000US16692,562,331,231,44943,57452,7165,16692
8600000US16693,3311,1701,1610,50867,64956,5644,16693
8600000US16694,99,42,57,33472,41005,11168,16694
8600000US16695,846,413,433,50357,58321,5630,16695
8600000US16699,224,224,0,,,,16699
8600000US16701,13833,6823,7010,45071,61878,4509,16701
8600000US16720,1031,513,518,48571,58876,7219,16720
8600000US16724,86,49,37,40577,42229,10703,16724
8600000US16725,237,125,112,49773,56471,14183,16725
8600000US16726,540,292,248,46250,65397,16534,16726
8600000US16727,127,69,58,106000,90113,20853,16727
8600000US16728,48,26,22,71250,72567,11677,16728
8600000US16729,681,321,360,48095,55338,6610,16729
8600000US16730,60,26,34,35865,50655,17501,16730
8600000US16731,1942,961,981,51534,64598,6501,16731
8600000US16732,265,154,111,43333,56427,13926,16732
8600000US16733,171,79,92,43194,53120,11467,16733
8600000US16734,227,115,112,41000,51480,9670,16734
8600000US16735,4547,2116,2431,45784,59029,4195,16735
8600000US16738,2332,1819,513,54412,66351,8189,16738
8600000US16740,794,401,393,44402,55417,6473,16740
8600000US16743,3004,1496,1508,50862,63781,5670,16743
8600000US16744,186,102,84,43750,114062,114002,16744
8600000US16745,422,200,222,50962,57459,6597,16745
8600000US16746,1005,531,474,43036,53081,4801,16746
8600000US16748,2145,970,1175,37880,51900,4951,16748
8600000US16749,3269,1582,1687,50058,60852,3305,16749
8600000US16750,381,247,134,46444,56110,8924,16750
8600000US16801,39359,21251,18108,46211,68367,2914,16801
8600000US16802,11561,5473,6088,,,,16802
8600000US16803,21993,11753,10240,58550,81798,4866,16803
8600000US16820,792,390,402,55179,62167,8006,16820
8600000US16821,303,148,155,40000,54152,26229,16821
8600000US16822,1754,802,952,46800,59840,5164,16822
8600000US16823,25173,14309,10864,62272,73501,2786,16823
8600000US16825,169,89,80,47102,47761,16439,16825
8600000US16826,328,132,196,55833,61353,11228,16826
8600000US16827,3875,1813,2062,102363,110445,11792,16827
8600000US16828,3432,1747,1685,66891,98329,18495,16828
8600000US16829,557,264,293,50268,61972,8274,16829
8600000US16830,11075,5256,5819,46872,65006,7601,16830
8600000US16832,406,238,168,78750,120742,63908,16832
8600000US16833,4362,2122,2240,40093,52325,2995,16833
8600000US16834,170,88,82,73214,73686,20476,16834
8600000US16835,164,76,88,62250,68004,12524,16835
8600000US16836,887,459,428,53438,58470,4714,16836
8600000US16837,88,36,52,40357,39668,9334,16837
8600000US16838,1469,746,723,48413,56401,5488,16838
8600000US16839,540,322,218,39125,54090,17395,16839
8600000US16840,471,225,246,69511,73583,22225,16840
8600000US16841,5146,2665,2481,60304,75457,7614,16841
8600000US16843,602,337,265,26094,37068,9874,16843
8600000US16844,2303,1159,1144,65536,72544,4538,16844
8600000US16845,820,462,358,53750,63921,7806,16845
8600000US16847,253,81,172,,43787,25788,16847
8600000US16848,337,168,169,39375,63485,24217,16848
8600000US16849,283,170,113,46477,61322,26052,16849
8600000US16851,771,385,386,106250,102938,14731,16851
8600000US16852,230,121,109,48438,82589,26498,16852
8600000US16853,136,71,65,,42935,13075,16853
8600000US16854,510,258,252,54453,62253,6930,16854
8600000US16855,182,53,129,,28867,16412,16855
8600000US16858,2932,1404,1528,54495,63302,7119,16858
8600000US16859,468,256,212,53393,64678,10193,16859
8600000US16860,205,97,108,,41218,26603,16860
8600000US16861,222,112,110,46250,67373,16995,16861
8600000US16863,561,261,300,47617,53981,12193,16863
8600000US16865,1537,785,752,73125,90934,22759,16865
8600000US16866,8441,4985,3456,43043,57485,4831,16866
8600000US16868,297,193,104,,57427,39604,16868
8600000US16870,5366,2739,2627,93931,126917,10943,16870
8600000US16871,40,20,20,45417,44187,10586,16871
8600000US16872,1116,533,583,55750,66359,5934,16872
8600000US16874,1102,547,555,62768,70139,5943,16874
8600000US16875,3147,1641,1506,55817,82885,10403,16875
8600000US16876,243,131,112,42321,47109,6799,16876
8600000US16877,1642,831,811,65139,79970,7333,16877
8600000US16878,1472,682,790,49444,54530,4929,16878
8600000US16879,354,162,192,37500,36629,10480,16879
8600000US16881,1880,1093,787,57083,61270,11637,16881
8600000US16882,305,176,129,44904,62895,15834,16882
8600000US16901,8267,4012,4255,54852,68519,6355,16901
8600000US16911,305,158,147,57917,67114,14481,16911
8600000US16912,1597,810,787,51591,73074,13280,16912
8600000US16914,1619,822,797,51372,67042,6173,16914
8600000US16915,4707,2335,2372,49085,64316,4883,16915
8600000US16917,937,444,493,50625,62666,7129,16917
8600000US16920,1627,818,809,42109,55367,7074,16920
8600000US16921,390,206,184,44286,55490,8350,16921
8600000US16922,1552,741,811,39286,53281,6597,16922
8600000US16923,1185,624,561,45469,52915,3756,16923
8600000US16925,2538,1305,1233,55607,67897,4526,16925
8600000US16926,755,372,383,60096,72154,6888,16926
8600000US16927,448,240,208,38958,48665,7096,16927
8600000US16928,1123,567,556,50750,59684,4792,16928
8600000US16929,1995,1060,935,55924,74829,8181,16929
8600000US16930,930,460,470,47000,65364,8800,16930
8600000US16932,582,269,313,49375,58221,12597,16932
8600000US16933,5533,2610,2923,48038,60447,4353,16933
8600000US16935,1021,493,528,62500,69849,6344,16935
8600000US16936,1615,860,755,54602,72340,11735,16936
8600000US16937,184,94,90,66250,57425,15227,16937
8600000US16938,541,263,278,54643,59442,7354,16938
8600000US16939,252,120,132,70417,63311,11473,16939
8600000US16940,183,86,97,47361,60886,11015,16940
8600000US16941,70,34,36,35938,49153,14928,16941
8600000US16942,657,336,321,49107,60948,8554,16942
8600000US16943,406,215,191,44063,49200,5750,16943
8600000US16946,1981,968,1013,45667,57495,4484,16946
8600000US16947,4014,1863,2151,54133,67942,5460,16947
8600000US16948,1213,616,597,41290,53092,4406,16948
8600000US16950,2713,1320,1393,39000,50652,3719,16950
8600000US17002,537,291,246,40882,70940,22112,17002
8600000US17003,9797,4948,4849,64228,82210,4890,17003
8600000US17004,3380,1583,1797,44741,58283,4809,17004
8600000US17005,265,142,123,56250,70791,11210,17005
8600000US17006,678,356,322,48654,62154,5612,17006
8600000US17007,4791,2440,2351,87755,99090,9063,17007
8600000US17009,1532,762,770,52981,60342,8081,17009
8600000US17010,130,66,64,,,,17010
8600000US17011,29591,16004,13587,75352,90120,3834,17011
8600000US17013,29050,13830,15220,61122,77208,3702,17013
8600000US17015,16458,8275,8183,78374,99587,7390,17015
8600000US17016,791,387,404,82188,84245,14056,17016
8600000US17017,1273,639,634,63864,76904,6928,17017
8600000US17018,3488,1755,1733,75368,89270,10359,17018
8600000US17019,14337,7066,7271,73370,89661,6109,17019
8600000US17020,7458,3634,3824,63464,74136,3888,17020
8600000US17021,728,384,344,37353,55288,7723,17021
8600000US17022,24449,11399,13050,67834,84806,3807,17022
8600000US17023,2689,1338,1351,53715,69531,5707,17023
8600000US17024,1551,830,721,76250,87776,9658,17024
8600000US17025,13173,6365,6808,67665,86341,6083,17025
8600000US17026,2664,1348,1316,74898,89950,13794,17026
8600000US17027,2155,914,1241,71507,103295,36497,17027
8600000US17028,3139,1699,1440,63953,75954,9100,17028
8600000US17029,151,67,84,44620,46261,15609,17029
8600000US17030,715,361,354,53750,72867,14253,17030
8600000US17032,6375,3176,3199,63857,78491,4894,17032
8600000US17033,14186,5851,8335,65875,103214,8841,17033
8600000US17034,1943,886,1057,42212,51903,5289,17034
8600000US17035,710,354,356,50556,52272,6537,17035
8600000US17036,17681,8500,9181,78520,115591,9795,17036
8600000US17037,746,403,343,50469,70678,22533,17037
8600000US17038,6803,3364,3439,62926,73695,4772,17038
8600000US17039,64,32,32,,,,17039
8600000US17040,1773,909,864,60625,71146,5249,17040
8600000US17041,205,106,99,,131014,85985,17041
8600000US17042,29486,14156,15330,59550,76096,3241,17042
8600000US17043,4724,2499,2225,56290,85042,13318,17043
8600000US17044,16681,7934,8747,43756,55949,3410,17044
8600000US17045,2458,1167,1291,60662,75169,6227,17045
8600000US17046,23070,11250,11820,48979,57988,2628,17046
8600000US17047,1902,952,950,58375,68230,4387,17047
8600000US17048,2805,1403,1402,52115,61262,3300,17048
8600000US17049,2329,1129,1200,63662,72966,13596,17049
8600000US17050,28809,13655,15154,87753,111511,4750,17050
8600000US17051,3776,1813,1963,51143,56735,2843,17051
8600000US17052,1213,613,600,50972,63179,5394,17052
8600000US17053,3904,1832,2072,67615,75058,3877,17053
8600000US17055,29147,13729,15418,67171,90018,3963,17055
8600000US17056,23,12,11,,,,17056
8600000US17057,17968,8873,9095,60407,68668,3254,17057
8600000US17058,1418,706,712,48696,59920,5745,17058
8600000US17059,6410,3263,3147,52928,63927,5757,17059
8600000US17060,917,465,452,42981,54732,5653,17060
8600000US17061,5645,2783,2862,50469,67414,6628,17061
8600000US17062,3194,1592,1602,62743,83345,10154,17062
8600000US17063,2639,1412,1227,49444,64393,12667,17063
8600000US17064,755,345,410,93846,120106,30046,17064
8600000US17065,3222,1588,1634,60708,74350,9478,17065
8600000US17066,4172,1944,2228,37881,49339,3522,17066
8600000US17067,11557,5496,6061,60846,73748,4272,17067
8600000US17068,3390,1764,1626,62952,78793,10717,17068
8600000US17069,94,44,50,48438,51516,17606,17069
8600000US17070,12662,6094,6568,67756,82642,6366,17070
8600000US17071,103,58,45,65417,71081,18835,17071
8600000US17072,159,54,105,46546,40395,8629,17072
8600000US17073,3970,2004,1966,64931,77603,6717,17073
8600000US17074,5692,2796,2896,56934,67640,3476,17074
8600000US17075,84,44,40,57500,58783,14195,17075
8600000US17076,14,0,14,,,,17076
8600000US17077,74,18,56,,,,17077
8600000US17078,16510,7728,8782,63425,79076,4428,17078
8600000US17080,187,98,89,49861,62831,9974,17080
8600000US17081,349,135,214,37000,42115,15147,17081
8600000US17082,2493,1236,1257,52123,66571,5321,17082
8600000US17083,34,19,15,,85520,43447,17083
8600000US17084,3367,1590,1777,53969,78302,16379,17084
8600000US17086,1874,891,983,62273,73638,6913,17086
8600000US17087,2034,1013,1021,68681,73536,6362,17087
8600000US17088,762,377,385,73911,74218,13393,17088
8600000US17090,4557,2288,2269,56391,71243,6931,17090
8600000US17093,1040,500,540,62733,64500,13744,17093
8600000US17094,2020,989,1031,50774,60187,4788,17094
8600000US17097,613,315,298,45326,56422,8796,17097
8600000US17098,1845,913,932,48068,56806,3646,17098
8600000US17099,1000,508,492,50530,58619,12036,17099
8600000US17101,1847,1063,784,29939,35699,5985,17101
8600000US17102,6475,2998,3477,42260,70805,14140,17102
8600000US17103,8555,3724,4831,36862,47345,5522,17103
8600000US17104,13704,6147,7557,34693,45885,4133,17104
8600000US17109,18692,8603,10089,52281,65197,4893,17109
8600000US17110,19523,9284,10239,58965,77462,3695,17110
8600000US17111,26172,12871,13301,68167,84190,3994,17111
8600000US17112,28026,13923,14103,81050,97314,4398,17112
8600000US17113,7461,3431,4030,48578,55195,5459,17113
8600000US17120,0,0,0,,,,17120
8600000US17201,20201,9433,10768,50426,63918,3495,17201
8600000US17202,22827,11256,11571,71946,93762,7765,17202
8600000US17210,118,64,54,96583,92826,17053,17210
8600000US17211,321,163,158,54167,59844,12077,17211
8600000US17212,551,279,272,67679,75894,9175,17212
8600000US17213,428,222,206,46071,61190,7876,17213
8600000US17214,783,394,389,36298,59357,13195,17214
8600000US17215,232,118,114,64286,76781,16098,17215
8600000US17217,175,100,75,65417,55229,14514,17217
8600000US17219,246,131,115,48958,50477,8530,17219
8600000US17220,363,161,202,,45361,10253,17220
8600000US17221,460,206,254,39559,52678,9406,17221
8600000US17222,9306,4544,4762,61042,69078,4154,17222
8600000US17223,246,115,131,38750,48620,14577,17223
8600000US17224,1438,679,759,55357,74515,13232,17224
8600000US17225,15018,7373,7645,71593,87135,9466,17225
8600000US17228,813,422,391,56346,69646,7011,17228
8600000US17229,1017,487,530,50096,59311,5601,17229
8600000US17233,4075,1993,2082,47688,55058,2477,17233
8600000US17235,613,285,328,75963,75134,13906,17235
8600000US17236,6792,3458,3334,64610,72839,3739,17236
8600000US17237,1654,798,856,63750,71515,5927,17237
8600000US17238,1346,707,639,54811,60631,4902,17238
8600000US17239,182,90,92,55536,61807,10038,17239
8600000US17240,2730,1421,1309,65921,76100,4823,17240
8600000US17241,9267,4624,4643,57203,69205,4246,17241
8600000US17243,1048,547,501,45000,60269,8523,17243
8600000US17244,1876,924,952,61357,68304,6917,17244
8600000US17246,139,75,64,69000,69191,20460,17246
8600000US17247,393,157,236,41278,45437,10554,17247
8600000US17249,332,159,173,45833,57355,8377,17249
8600000US17250,95,60,35,,,,17250
8600000US17251,118,65,53,,67487,20174,17251
8600000US17252,3097,1476,1621,44792,58816,6777,17252
8600000US17253,205,90,115,43542,54703,8132,17253
8600000US17254,88,42,46,,,,17254
8600000US17255,813,396,417,52885,67937,9459,17255
8600000US17256,179,116,63,95078,71924,26928,17256
8600000US17257,23107,11129,11978,52130,67241,3643,17257
8600000US17260,985,468,517,41856,50140,6160,17260
8600000US17261,245,143,102,,,,17261
8600000US17262,1105,535,570,51587,59756,5739,17262
8600000US17263,261,143,118,71250,75332,26394,17263
8600000US17264,1847,929,918,46974,56422,3684,17264
8600000US17265,482,246,236,58750,78559,26256,17265
8600000US17266,399,210,189,60833,69684,10397,17266
8600000US17267,2216,1159,1057,60366,71431,6186,17267
8600000US17268,22625,10738,11887,54321,68644,3600,17268
8600000US17270,53,26,27,,,,17270
8600000US17271,202,101,101,52614,54546,10590,17271
8600000US17272,345,193,152,,28156,11259,17272
8600000US17301,3290,1553,1737,70804,75327,4278,17301
8600000US17302,2094,1126,968,72539,75834,7121,17302
8600000US17304,2352,1216,1136,73810,84306,9318,17304
8600000US17306,237,127,110,62083,69796,10979,17306
8600000US17307,4573,2237,2336,64087,78443,6799,17307
8600000US17309,1519,725,794,66760,71667,12067,17309
8600000US17311,143,64,79,46875,42911,9300,17311
8600000US17313,8710,4334,4376,58360,70545,5647,17313
8600000US17314,4505,2333,2172,68668,78147,7204,17314
8600000US17315,20816,10023,10793,64870,77117,4332,17315
8600000US17316,6662,3247,3415,82759,94654,6983,17316
8600000US17317,483,254,229,62917,70721,8859,17317
8600000US17318,398,165,233,42474,47979,12155,17318
8600000US17319,8991,4335,4656,68860,79110,4159,17319
8600000US17320,6260,2996,3264,74931,87332,4321,17320
8600000US17321,1869,959,910,73264,84865,7936,17321
8600000US17322,4877,2385,2492,70957,81960,6301,17322
8600000US17324,3308,1700,1608,65363,80889,11047,17324
8600000US17325,23113,11262,11851,61815,77990,2642,17325
8600000US17327,5873,3109,2764,69783,84447,5011,17327
8600000US17329,1969,899,1070,83469,98078,12654,17329
8600000US17331,40572,19407,21165,62130,75926,3115,17331
8600000US17339,5793,2842,2951,80593,113083,12002,17339
8600000US17340,8452,4005,4447,68941,81264,3986,17340
8600000US17343,19,19,0,,,,17343
8600000US17344,2764,1286,1478,44167,49842,4812,17344
8600000US17345,6368,3235,3133,59337,72122,6293,17345
8600000US17347,4804,2449,2355,83810,91797,6036,17347
8600000US17349,5402,2578,2824,94554,107438,12067,17349
8600000US17350,9900,4767,5133,54920,69835,4796,17350
8600000US17352,997,495,502,60921,68956,6492,17352
8600000US17353,2759,1449,1310,67946,78639,11131,17353
8600000US17355,226,120,106,62250,74810,13537,17355
8600000US17356,16929,8088,8841,64762,76617,3923,17356
8600000US17360,5165,2622,2543,83246,100630,10899,17360
8600000US17361,5160,2553,2607,78063,92955,11855,17361
8600000US17362,10284,5130,5154,70816,89281,6578,17362
8600000US17363,7382,3640,3742,81521,95637,7268,17363
8600000US17364,3027,1463,1564,59479,72625,8699,17364
8600000US17365,2045,1084,961,66641,79073,10130,17365
8600000US17366,4047,1953,2094,61000,69190,5660,17366
8600000US17368,5925,2976,2949,62545,82404,8039,17368
8600000US17370,4046,2123,1923,67238,80417,7333,17370
8600000US17371,221,127,94,76111,80690,15367,17371
8600000US17372,3409,1647,1762,64609,72365,4184,17372
8600000US17401,12293,6139,6154,26715,39557,4960,17401
8600000US17402,29864,14724,15140,65184,85532,5424,17402
8600000US17403,30717,14187,16530,52005,76315,4510,17403
8600000US17404,26577,12719,13858,60832,76902,4065,17404
8600000US17406,18672,9055,9617,61947,78051,4807,17406
8600000US17407,1689,835,854,97697,99079,10322,17407
8600000US17408,18622,9226,9396,68966,79604,4158,17408
8600000US17501,3353,1649,1704,57451,66453,6338,17501
8600000US17502,2126,1063,1063,76722,78621,11431,17502
8600000US17505,1196,572,624,58229,76356,15129,17505
8600000US17507,30,14,16,,,,17507
8600000US17508,385,189,196,90417,96987,38666,17508
8600000US17509,3069,1523,1546,66641,84026,8954,17509
8600000US17512,13717,6493,7224,46362,64757,6182,17512
8600000US17516,3499,1750,1749,76250,84788,5723,17516
8600000US17517,12696,6506,6190,70151,82811,7136,17517
8600000US17518,1148,592,556,69010,96770,18330,17518
8600000US17519,4913,2373,2540,71290,90665,13255,17519
8600000US17520,3756,1967,1789,82809,90169,7180,17520
8600000US17522,25681,12591,13090,58448,71674,2725,17522
8600000US17527,4331,2105,2226,67500,86902,7471,17527
8600000US17529,3035,1498,1537,60329,81642,12420,17529
8600000US17532,2275,1156,1119,67371,83136,10279,17532
8600000US17535,1841,798,1043,65938,92943,22297,17535
8600000US17536,1765,901,864,81464,91969,9825,17536
8600000US17538,5160,2255,2905,83900,89571,8067,17538
8600000US17540,7596,3748,3848,68561,81050,5675,17540
8600000US17543,34134,16193,17941,73411,103059,5453,17543
8600000US17545,16819,8201,8618,62058,80276,5404,17545
8600000US17547,5411,2636,2775,66376,74731,4997,17547
8600000US17550,689,312,377,43665,60367,17884,17550
8600000US17551,9758,4461,5297,60720,74997,6687,17551
8600000US17552,15835,7736,8099,70944,83703,5083,17552
8600000US17554,5372,2381,2991,59688,68611,5620,17554
8600000US17555,5014,2327,2687,77454,104835,19134,17555
8600000US17557,11016,5124,5892,59192,70676,6234,17557
8600000US17560,3834,1915,1919,54516,72025,11475,17560
8600000US17562,3057,1598,1459,62097,84686,19608,17562
8600000US17563,2688,1320,1368,61786,74894,9006,17563
8600000US17565,2046,1098,948,82763,107613,27035,17565
8600000US17566,8874,4630,4244,66368,80249,4177,17566
8600000US17569,4702,2371,2331,81463,98144,12079,17569
8600000US17570,170,94,76,100585,86161,29006,17570
8600000US17572,3226,1587,1639,51932,74924,15672,17572
8600000US17576,155,81,74,,,,17576
8600000US17578,5194,2631,2563,62756,79480,8706,17578
8600000US17579,4463,2194,2269,69468,83196,7041,17579
8600000US17581,629,326,303,73906,80436,12289,17581
8600000US17582,1706,844,862,79280,81249,9789,17582
8600000US17584,8081,3832,4249,68673,82189,7846,17584
8600000US17601,40753,19243,21510,72484,98519,4229,17601
8600000US17602,39804,19956,19848,53192,73696,3866,17602
8600000US17603,49624,23099,26525,52917,67599,2444,17603
8600000US17606,416,126,290,,31375,15902,17606
8600000US17701,34752,17431,17321,44059,59219,2970,17701
8600000US17702,8189,4015,4174,56006,66608,3579,17702
8600000US17721,1274,628,646,48036,54645,6815,17721
8600000US17723,29,19,10,39375,58926,18170,17723
8600000US17724,3737,1881,1856,51799,57225,3025,17724
8600000US17727,85,49,36,42188,54335,14187,17727
8600000US17728,4118,2036,2082,60110,67257,3307,17728
8600000US17729,50,30,20,32500,41429,26593,17729
8600000US17730,105,52,53,,,,17730
8600000US17731,215,107,108,88750,126804,41643,17731
8600000US17737,4971,2412,2559,58172,68661,4161,17737
8600000US17739,32,12,20,,152129,146791,17739
8600000US17740,9751,4877,4874,54614,64324,3419,17740
8600000US17742,16,11,5,,70792,68749,17742
8600000US17744,2618,1300,1318,53239,61588,3594,17744
8600000US17745,15431,7508,7923,44683,58518,2326,17745
8600000US17747,2320,1185,1135,59219,72062,4903,17747
8600000US17748,201,86,115,34700,41175,13812,17748
8600000US17749,277,131,146,57778,65066,9995,17749
8600000US17750,138,79,59,,68745,28024,17750
8600000US17751,5432,2686,2746,57661,68072,4112,17751
8600000US17752,3466,1654,1812,56593,66809,4370,17752
8600000US17754,9798,4606,5192,64403,82607,4742,17754
8600000US17756,10094,4200,5894,59019,67237,4143,17756
8600000US17758,743,370,373,48625,63843,7008,17758
8600000US17760,566,263,303,59063,66546,6750,17760
8600000US17762,409,219,190,55417,76853,13389,17762
8600000US17763,140,63,77,46875,50629,7268,17763
8600000US17764,1767,907,860,35577,44352,3073,17764
8600000US17765,904,484,420,54500,60251,6113,17765
8600000US17767,122,60,62,50469,48944,14029,17767
8600000US17768,306,163,143,48889,66114,10829,17768
8600000US17771,2595,1259,1336,55774,73490,5078,17771
8600000US17772,1994,976,1018,62857,75968,7692,17772
8600000US17774,1077,545,532,52361,67125,7037,17774
8600000US17776,224,120,104,50000,55004,7095,17776
8600000US17777,5686,2666,3020,53798,67581,5278,17777
8600000US17778,82,43,39,40000,50595,16227,17778
8600000US17779,155,61,94,,77356,28418,17779
8600000US17801,12889,6478,6411,44867,57340,3415,17801
8600000US17810,5265,4415,850,56111,66983,6268,17810
8600000US17812,984,476,508,41845,55262,5789,17812
8600000US17813,1598,795,803,54318,63784,6734,17813
8600000US17814,3950,2066,1884,52854,64062,3561,17814
8600000US17815,25650,12048,13602,50491,67334,3989,17815
8600000US17820,4326,2098,2228,53850,68319,4146,17820
8600000US17821,14563,6876,7687,58042,82375,5213,17821
8600000US17822,0,0,0,,,,17822
8600000US17823,946,497,449,58173,65581,4875,17823
8600000US17824,3143,1500,1643,56938,69023,7103,17824
8600000US17827,580,316,264,60893,71369,11930,17827
8600000US17829,178,91,87,61250,77035,30369,17829
8600000US17830,1539,800,739,55313,68430,8957,17830
8600000US17832,601,311,290,45313,54545,8193,17832
8600000US17834,2881,1394,1487,42083,55949,6902,17834
8600000US17835,238,116,122,63750,76543,25154,17835
8600000US17836,141,75,66,46875,67668,10395,17836
8600000US17837,16790,8912,7878,56497,83133,7278,17837
8600000US17840,403,211,192,61625,59028,11265,17840
8600000US17841,3706,1907,1799,51912,60582,4366,17841
8600000US17842,6619,3279,3340,55000,67363,4144,17842
8600000US17844,7645,3718,3927,56842,69705,3179,17844
8600000US17845,1586,712,874,50500,59689,5302,17845
8600000US17846,3010,1489,1521,54082,63896,3848,17846
8600000US17847,9188,4592,4596,48447,63843,5507,17847
8600000US17850,595,335,260,53385,59382,10800,17850
8600000US17851,6458,2931,3527,32446,50572,6771,17851
8600000US17853,2402,1215,1187,53074,66113,5682,17853
8600000US17855,835,390,445,63125,66784,7063,17855
8600000US17856,2473,1155,1318,56180,71110,13334,17856
8600000US17857,5908,2699,3209,58638,69028,5111,17857
8600000US17859,2307,1097,1210,53571,71887,6326,17859
8600000US17860,1850,961,889,69000,86912,16969,17860
8600000US17861,123,54,69,86500,93414,38626,17861
8600000US17862,404,196,208,34167,44913,10209,17862
8600000US17864,1604,808,796,53188,66608,9436,17864
8600000US17865,76,35,41,47054,56395,14289,17865
8600000US17866,8794,5362,3432,38380,50327,4143,17866
8600000US17867,91,47,44,37031,47553,12105,17867
8600000US17868,911,422,489,63529,90608,16192,17868
8600000US17870,12999,6241,6758,64812,76444,4312,17870
8600000US17872,6971,3200,3771,33860,46807,3892,17872
8600000US17876,1474,684,790,42578,54810,6106,17876
8600000US17878,1153,554,599,57813,62717,5812,17878
8600000US17880,114,62,52,,63931,16758,17880
8600000US17881,1202,613,589,57222,57913,5720,17881
8600000US17884,175,76,99,45096,41997,11559,17884
8600000US17885,177,90,87,65938,65901,10972,17885
8600000US17886,1223,740,483,53365,62723,17416,17886
8600000US17887,157,109,48,,32072,10478,17887
8600000US17888,232,111,121,39306,46934,8483,17888
8600000US17889,2003,998,1005,67361,89635,10496,17889
8600000US17901,18691,9275,9416,45889,63375,4977,17901
8600000US17920,319,151,168,47679,53366,8713,17920
8600000US17921,6418,3786,2632,47610,56328,4407,17921
8600000US17922,3681,1751,1930,74903,81523,8132,17922
8600000US17923,436,210,226,57634,54432,8320,17923
8600000US17925,303,143,160,54643,66338,10144,17925
8600000US17929,1181,536,645,52240,57022,5106,17929
8600000US17930,366,182,184,46016,55614,9100,17930
8600000US17931,7722,5677,2045,51714,56587,5151,17931
8600000US17933,94,60,34,116250,113517,12245,17933
8600000US17934,339,174,165,41750,46765,7576,17934
8600000US17935,1214,581,633,35526,42825,5701,17935
8600000US17936,597,284,313,54286,76976,18612,17936
8600000US17938,1770,871,899,63333,74150,9147,17938
8600000US17941,621,333,288,53250,72320,8594,17941
8600000US17943,105,60,45,66848,75030,40205,17943
8600000US17944,109,55,54,58250,66168,8168,17944
8600000US17945,150,76,74,87988,73136,19007,17945
8600000US17946,182,99,83,68906,61016,18490,17946
8600000US17948,3542,1577,1965,33523,47864,7372,17948
8600000US17949,247,120,127,49135,51595,9432,17949
8600000US17951,205,101,104,59375,62400,20730,17951
8600000US17952,178,82,96,39375,51461,11280,17952
8600000US17953,414,223,191,50625,55241,5095,17953
8600000US17954,3422,1513,1909,32324,44639,6156,17954
8600000US17957,299,170,129,,91995,54860,17957
8600000US17959,1117,535,582,53056,58741,5752,17959
8600000US17960,3236,1600,1636,61848,74186,6521,17960
8600000US17961,5214,2454,2760,58438,82802,7474,17961
8600000US17963,6882,3566,3316,57652,72031,6806,17963
8600000US17964,605,326,279,49250,61714,5998,17964
8600000US17965,1640,806,834,51532,55690,4026,17965
8600000US17967,2022,1011,1011,55313,66444,6108,17967
8600000US17968,196,103,93,66875,79574,21910,17968
8600000US17970,2534,1263,1271,39659,50119,6490,17970
8600000US17972,8984,4351,4633,55932,67983,4128,17972
8600000US17974,244,99,145,45650,42062,10550,17974
8600000US17976,4988,2285,2703,30411,47941,8464,17976
8600000US17978,212,101,111,38750,47017,8923,17978
8600000US17979,171,73,98,55417,47652,12289,17979
8600000US17980,2428,1220,1208,56250,62016,3391,17980
8600000US17981,2183,1086,1097,47880,56229,4839,17981
8600000US17982,398,167,231,51250,63123,10506,17982
8600000US17983,1189,592,597,61071,65255,7568,17983
8600000US17985,1010,508,502,55625,62183,4922,17985
8600000US18011,4328,2054,2274,82500,92622,6112,18011
8600000US18013,14435,7228,7207,63287,80285,6493,18013
8600000US18014,9096,4598,4498,63368,79222,5324,18014
8600000US18015,27159,13628,13531,51597,80988,6437,18015
8600000US18016,0,0,0,,,,18016
8600000US18017,30522,13985,16537,72842,90986,4156,18017
8600000US18018,26301,12685,13616,55996,71444,3814,18018
8600000US18020,17075,8347,8728,83018,110933,7575,18020
8600000US18030,617,302,315,39063,59822,16470,18030
8600000US18031,7335,3663,3672,86711,105874,9662,18031
8600000US18032,7291,3421,3870,60039,64774,4332,18032
8600000US18034,7006,3337,3669,89886,125202,12700,18034
8600000US18035,68,37,31,82574,63209,20804,18035
8600000US18036,10866,5454,5412,94695,125050,9928,18036
8600000US18037,6184,3001,3183,64949,78851,5183,18037
8600000US18038,2339,1205,1134,87031,93889,11839,18038
8600000US18040,12897,6158,6739,86452,110816,9534,18040
8600000US18041,4140,2042,2098,74888,87322,7458,18041
8600000US18042,33835,16449,17386,55003,72469,3529,18042
8600000US18045,21371,10048,11323,82346,96573,4668,18045
8600000US18046,36,0,36,,,,18046
8600000US18049,13998,6694,7304,71334,89659,5353,18049
8600000US18051,3028,1521,1507,114205,131829,19203,18051
8600000US18052,21847,10428,11419,62908,72519,2724,18052
8600000US18053,1698,869,829,77039,80108,8486,18053
8600000US18054,3493,1754,1739,68469,95647,8831,18054
8600000US18055,9435,4891,4544,66844,88035,6862,18055
8600000US18056,592,306,286,44013,61216,9720,18056
8600000US18058,8196,4218,3978,64347,77004,7331,18058
8600000US18059,955,503,452,92917,108027,15798,18059
8600000US18062,19865,9555,10310,82951,104819,4692,18062
8600000US18063,494,260,234,,61771,24009,18063
8600000US18064,20165,9586,10579,79144,98388,4897,18064
8600000US18066,4918,2382,2536,87937,102610,6711,18066
8600000US18067,14209,6979,7230,64735,77330,4786,18067
8600000US18068,0,0,0,,,,18068
8600000US18069,6027,3036,2991,84602,118096,10560,18069
8600000US18070,830,373,457,68508,72534,11674,18070
8600000US18071,8045,4074,3971,63791,72272,6163,18071
8600000US18072,4969,2295,2674,62136,84356,18912,18072
8600000US18073,7769,3861,3908,86006,98949,9430,18073
8600000US18074,4494,2169,2325,86724,100663,9483,18074
8600000US18076,2286,1033,1253,64871,82734,11386,18076
8600000US18077,1930,960,970,81557,107376,15159,18077
8600000US18078,5954,3097,2857,88011,109591,9187,18078
8600000US18079,474,291,183,60375,68648,29439,18079
8600000US18080,8791,4398,4393,62898,75420,5927,18080
8600000US18081,155,79,76,40462,35327,10801,18081
8600000US18083,352,168,184,68438,73766,13717,18083
8600000US18085,746,375,371,67670,86163,12005,18085
8600000US18086,465,228,237,47328,82974,40645,18086
8600000US18087,425,219,206,38021,74030,34982,18087
8600000US18088,6874,3424,3450,66949,84220,10925,18088
8600000US18091,4404,2195,2209,54781,77525,15556,18091
8600000US18092,2570,1321,1249,86856,112042,14610,18092
8600000US18101,3031,1537,1494,23906,36524,6397,18101
8600000US18102,34448,16528,17920,32265,44179,3291,18102
8600000US18103,35230,17248,17982,54595,78199,4821,18103
8600000US18104,35960,16187,19773,74104,97035,4286,18104
8600000US18105,27,18,9,,,,18105
8600000US18106,5608,2609,2999,68952,95860,16497,18106
8600000US18109,13715,6486,7229,45128,51411,3189,18109
8600000US18195,0,0,0,,,,18195
8600000US18201,20183,9870,10313,41167,52934,2692,18201
8600000US18202,9954,4778,5176,41329,58503,4875,18202
8600000US18210,5642,2665,2977,53508,67597,7003,18210
8600000US18211,1114,563,551,62548,75189,13877,18211
8600000US18212,152,70,82,65724,70558,23773,18212
8600000US18214,1641,823,818,55781,70165,7339,18214
8600000US18216,898,423,475,40950,53394,8507,18216
8600000US18218,1712,779,933,35436,45710,4585,18218
8600000US18219,1221,576,645,62449,80265,11324,18219
8600000US18220,280,146,134,47019,52631,9016,18220
8600000US18221,241,134,107,,68653,38980,18221
8600000US18222,7683,3883,3800,76413,85485,7165,18222
8600000US18223,177,93,84,26845,30283,7674,18223
8600000US18224,4824,2151,2673,46525,54101,5879,18224
8600000US18225,155,103,52,,31477,502,18225
8600000US18229,7203,3419,3784,57963,67116,4563,18229
8600000US18230,87,36,51,34306,40377,8549,18230
8600000US18231,339,135,204,43092,46524,11054,18231
8600000US18232,2966,1498,1468,34107,47170,5869,18232
8600000US18234,121,57,64,,50466,30191,18234
8600000US18235,15562,7653,7909,57950,68724,5230,18235
8600000US18237,2671,1305,1366,41111,51509,5359,18237
8600000US18239,363,131,232,,36574,18261,18239
8600000US18240,3188,1574,1614,51065,60470,8398,18240
8600000US18241,566,238,328,46667,60228,9598,18241
8600000US18242,118,62,56,35000,45961,13413,18242
8600000US18244,230,122,108,46250,50550,8239,18244
8600000US18245,311,150,161,56875,53235,15213,18245
8600000US18246,187,123,64,51875,51237,11259,18246
8600000US18248,491,276,215,52578,71767,19486,18248
8600000US18249,2946,1404,1542,71443,85595,7142,18249
8600000US18250,2322,1188,1134,52391,65760,10204,18250
8600000US18251,18,18,0,,,,18251
8600000US18252,8199,4033,4166,49557,57793,3856,18252
8600000US18254,751,377,374,40643,49504,5502,18254
8600000US18255,3814,1812,2002,52328,64599,3934,18255
8600000US18256,314,189,125,57688,56941,14138,18256
8600000US18301,23709,11187,12522,65026,80276,4804,18301
8600000US18302,13575,7167,6408,66108,78584,5255,18302
8600000US18321,1615,517,1098,41010,50957,9794,18321
8600000US18322,1951,966,985,54598,72223,12146,18322
8600000US18323,131,71,60,113500,104251,16817,18323
8600000US18324,7433,3623,3810,53170,67939,7287,18324
8600000US18325,1846,963,883,90929,94906,21980,18325
8600000US18326,3340,1521,1819,48086,64731,10389,18326
8600000US18327,457,248,209,67604,75452,14964,18327
8600000US18328,5785,3269,2516,62226,76469,6230,18328
8600000US18330,6674,3280,3394,73554,88518,13046,18330
8600000US18331,550,212,338,45625,55214,19121,18331
8600000US18332,1975,1025,950,79741,85565,15475,18332
8600000US18333,482,168,314,,67240,31527,18333
8600000US18334,3911,2040,1871,66294,74153,11297,18334
8600000US18335,776,441,335,75417,95329,22981,18335
8600000US18336,3140,1361,1779,66715,80964,10042,18336
8600000US18337,11630,5657,5973,75758,99284,8617,18337
8600000US18340,200,81,119,151579,130901,43226,18340
8600000US18342,482,256,226,,28623,13030,18342
8600000US18343,3411,1672,1739,70921,91039,11318,18343
8600000US18344,2959,1460,1499,48520,72061,15185,18344
8600000US18346,1782,923,859,69357,77075,12648,18346
8600000US18347,2328,1240,1088,51215,57887,6138,18347
8600000US18349,100,35,65,72667,116511,118266,18349
8600000US18350,1292,567,725,60625,90543,22163,18350
8600000US18351,345,191,154,47188,70480,24287,18351
8600000US18352,649,369,280,82642,100759,32010,18352
8600000US18353,10195,4566,5629,72449,88855,9373,18353
8600000US18354,737,407,330,70962,78442,14825,18354
8600000US18355,1295,694,601,107361,109703,23162,18355
8600000US18356,78,32,46,74875,90713,24165,18356
8600000US18357,119,59,60,,,,18357
8600000US18360,21894,11195,10699,61902,77057,4517,18360
8600000US18370,795,327,468,58932,65030,18416,18370
8600000US18371,594,297,297,79291,97692,26827,18371
8600000US18372,2072,1066,1006,49448,72628,22263,18372
8600000US18403,5630,2555,3075,58050,71415,7026,18403
8600000US18405,2206,1053,1153,59684,68162,7539,18405
8600000US18407,10355,4845,5510,45341,62542,6074,18407
8600000US18411,17175,8056,9119,74961,100264,7193,18411
8600000US18413,182,61,121,20288,101960,114870,18413
8600000US18414,4224,2067,2157,70793,93400,6193,18414
8600000US18415,1018,522,496,59706,78173,16192,18415
8600000US18417,842,435,407,55469,63611,8044,18417
8600000US18419,3776,1874,1902,55256,69977,4642,18419
8600000US18420,40,11,29,51250,62027,29661,18420
8600000US18421,4143,2072,2071,52007,70132,5526,18421
8600000US18424,4228,2133,2095,62415,77689,6463,18424
8600000US18425,952,544,408,53750,72049,12134,18425
8600000US18426,3594,1691,1903,45089,58813,5773,18426
8600000US18427,140,54,86,,,,18427
8600000US18428,9800,4852,4948,58647,73639,5270,18428
8600000US18430,6,3,3,,,,18430
8600000US18431,9535,4426,5109,50433,63458,3390,18431
8600000US18433,5375,2570,2805,57585,77347,10175,18433
8600000US18434,3047,1429,1618,47689,64829,10527,18434
8600000US18435,823,451,372,88250,136981,51747,18435
8600000US18436,10275,4968,5307,57891,71668,7089,18436
8600000US18437,144,67,77,39167,46865,12304,18437
8600000US18438,941,488,453,72917,77144,10042,18438
8600000US18439,399,230,169,60278,78895,19412,18439
8600000US18441,132,60,72,41667,59175,18966,18441
8600000US18443,361,158,203,77647,75795,21499,18443
8600000US18444,10913,5412,5501,72373,90646,4886,18444
8600000US18445,2407,1256,1151,56000,82872,17425,18445
8600000US18446,2729,1355,1374,54250,70221,7657,18446
8600000US18447,8166,3743,4423,52242,62948,5330,18447
8600000US18451,645,352,293,67031,90314,27408,18451
8600000US18452,4186,1999,2187,52873,64513,7292,18452
8600000US18453,834,453,381,49808,61343,6142,18453
8600000US18454,15,4,11,,,,18454
8600000US18455,71,41,30,,64329,22579,18455
8600000US18456,302,155,147,48750,66323,17737,18456
8600000US18457,111,50,61,,34404,18601,18457
8600000US18458,2180,1171,1009,63274,86549,14020,18458
8600000US18459,8,2,6,,,,18459
8600000US18460,123,59,64,67599,55309,12798,18460
8600000US18461,298,169,129,62500,64061,12134,18461
8600000US18462,284,146,138,61912,69777,10437,18462
8600000US18463,228,114,114,88571,116344,60575,18463
8600000US18464,1028,552,476,64293,94649,24136,18464
8600000US18465,1121,594,527,49737,59030,5619,18465
8600000US18466,13579,6490,7089,61902,75832,6044,18466
8600000US18469,175,97,78,75795,86820,29382,18469
8600000US18470,1698,909,789,71250,82373,10412,18470
8600000US18471,536,262,274,93750,129451,32172,18471
8600000US18472,6609,4901,1708,55575,63799,3975,18472
8600000US18473,503,264,239,42344,51127,12914,18473
8600000US18503,1140,730,410,17105,36329,11386,18503
8600000US18504,16196,7829,8367,42210,55753,3610,18504
8600000US18505,15871,7451,8420,39764,55867,3968,18505
8600000US18507,4186,2102,2084,58482,72593,7992,18507
8600000US18508,9861,4687,5174,34884,45715,3790,18508
8600000US18509,11241,5691,5550,47852,65783,4630,18509
8600000US18510,11155,5178,5977,35340,52145,3749,18510
8600000US18512,9726,4618,5108,54419,67518,4539,18512
8600000US18517,4352,1980,2372,45561,53915,6272,18517
8600000US18518,6630,3024,3606,52000,63001,5714,18518
8600000US18519,3802,1807,1995,45354,61682,6369,18519
8600000US18602,188,93,95,121875,193594,51795,18602
8600000US18603,15652,7519,8133,47842,60237,4174,18603
8600000US18610,4160,2074,2086,65810,71767,7311,18610
8600000US18612,15416,8201,7215,71507,91467,5442,18612
8600000US18614,2007,1049,958,45944,58005,3966,18614
8600000US18615,1602,789,813,62895,80003,12426,18615
8600000US18616,539,274,265,60542,66587,5877,18616
8600000US18617,1586,841,745,38477,54484,9656,18617
8600000US18618,3116,1507,1609,67898,81537,10257,18618
8600000US18619,229,120,109,48636,58211,9727,18619
8600000US18621,5637,3522,2115,59672,74529,6254,18621
8600000US18622,132,62,70,34911,50960,20027,18622
8600000US18623,2168,1057,1111,52946,68643,6249,18623
8600000US18624,316,162,154,36354,59170,27070,18624
8600000US18625,326,165,161,48750,72716,18292,18625
8600000US18626,487,240,247,64306,68565,6985,18626
8600000US18628,165,86,79,23194,39004,9407,18628
8600000US18629,1258,644,614,58958,69110,5524,18629
8600000US18630,2422,1243,1179,54472,74277,6993,18630
8600000US18631,1064,470,594,47206,61016,8453,18631
8600000US18632,430,230,200,41736,51387,8624,18632
8600000US18634,10702,5367,5335,41576,54921,4189,18634
8600000US18635,3059,1496,1563,56420,67080,3803,18635
8600000US18636,1064,533,531,58958,84551,18796,18636
8600000US18640,13930,6282,7648,45376,61750,3201,18640
8600000US18641,5355,2572,2783,54821,72160,7920,18641
8600000US18642,3472,1616,1856,62500,76262,10426,18642
8600000US18643,10164,4942,5222,56151,73397,7302,18643
8600000US18644,6035,2888,3147,62972,78164,5770,18644
8600000US18651,6657,3102,3555,39564,50943,2562,18651
8600000US18653,190,94,96,80938,87412,27503,18653
8600000US18655,4590,2315,2275,54351,63787,2918,18655
8600000US18656,1695,887,808,52469,67859,10600,18656
8600000US18657,9597,4819,4778,62710,73558,3461,18657
8600000US18660,2912,1495,1417,57661,69559,5268,18660
8600000US18661,4275,2262,2013,61134,71318,3915,18661
8600000US18701,3419,1616,1803,21097,31995,4780,18701
8600000US18702,30743,14913,15830,40916,54787,2050,18702
8600000US18704,24800,11776,13024,53065,64973,2761,18704
8600000US18705,11756,5854,5902,49169,63204,4454,18705
8600000US18706,12758,6158,6600,49279,60580,3852,18706
8600000US18707,12833,6430,6403,84746,108929,5793,18707
8600000US18708,6864,3255,3609,85235,100351,11266,18708
8600000US18709,2499,1063,1436,35778,46066,6563,18709
8600000US18801,6641,3192,3449,52083,70660,4140,18801
8600000US18810,4311,2079,2232,47941,65032,10730,18810
8600000US18812,1379,731,648,72813,87071,6926,18812
8600000US18814,131,61,70,55833,53775,13699,18814
8600000US18816,113,57,56,74615,73455,18727,18816
8600000US18817,177,85,92,75469,73484,16642,18817
8600000US18818,1025,517,508,55000,62666,4721,18818
8600000US18821,1024,483,541,42625,56342,8079,18821
8600000US18822,2632,1325,1307,44559,57419,5716,18822
8600000US18823,227,105,122,62813,56821,11132,18823
8600000US18824,1228,639,589,58750,75798,8031,18824
8600000US18825,63,42,21,,50768,15597,18825
8600000US18826,1262,662,600,62321,92249,11555,18826
8600000US18828,236,129,107,39732,53668,11432,18828
8600000US18829,601,298,303,50500,64108,7783,18829
8600000US18830,479,257,222,47857,64873,9806,18830
8600000US18831,1076,529,547,56477,65394,7817,18831
8600000US18832,1428,731,697,50625,60518,4775,18832
8600000US18833,1635,854,781,51394,62065,4710,18833
8600000US18834,2829,1408,1421,55694,79862,7631,18834
8600000US18837,2337,1149,1188,53444,59542,3736,18837
8600000US18840,8729,4058,4671,45880,67848,8322,18840
8600000US18842,222,116,106,49167,54196,10556,18842
8600000US18843,239,106,133,49833,69922,22114,18843
8600000US18844,1488,717,771,62031,78772,8015,18844
8600000US18845,218,110,108,54722,106583,48665,18845
8600000US18846,740,378,362,64063,84683,13960,18846
8600000US18847,4360,2255,2105,46548,57810,2999,18847
8600000US18848,6655,3309,3346,45205,61088,3643,18848
8600000US18850,1817,915,902,51297,73222,13025,18850
8600000US18851,582,298,284,57000,62298,5297,18851
8600000US18853,3139,1597,1542,64566,77804,5609,18853
8600000US18854,1172,564,608,49432,75381,15438,18854
8600000US18901,22711,11136,11575,98196,121617,5770,18901
8600000US18902,15758,7788,7970,138780,173737,10348,18902
8600000US18912,141,64,77,,,,18912
8600000US18913,57,40,17,,80898,73088,18913
8600000US18914,16080,7668,8412,108571,127962,6145,18914
8600000US18915,543,268,275,95982,96127,19056,18915
8600000US18917,1669,856,813,64716,77301,7756,18917
8600000US18920,328,182,146,81538,83433,24546,18920
8600000US18923,621,313,308,124432,219050,83576,18923
8600000US18925,4875,2431,2444,146875,172675,16867,18925
8600000US18929,7268,3407,3861,132205,159803,15620,18929
8600000US18930,2468,1252,1216,78889,96778,11136,18930
8600000US18932,273,148,125,90192,132811,74276,18932
8600000US18935,18,18,0,,,,18935
8600000US18936,0,0,0,,,,18936
8600000US18938,11554,5557,5997,112582,175934,14165,18938
8600000US18940,22875,11026,11849,124076,170929,8085,18940
8600000US18942,2732,1468,1264,88738,100716,11345,18942
8600000US18944,19744,9565,10179,87333,110309,7373,18944
8600000US18947,4991,2615,2376,95724,133442,19068,18947
8600000US18950,129,79,50,,176347,108733,18950
8600000US18951,27150,13128,14022,71690,89266,4782,18951
8600000US18954,7173,3580,3593,133370,161928,11949,18954
8600000US18955,1367,631,736,74063,99962,24598,18955
8600000US18960,9833,4682,5151,75069,91932,7145,18960
8600000US18962,283,152,131,80417,92978,21276,18962
8600000US18964,11113,5658,5455,74111,91337,5427,18964
8600000US18966,30387,14402,15985,95656,121215,4756,18966
8600000US18969,11877,5813,6064,77935,92604,5480,18969
8600000US18970,569,313,256,80357,92962,15118,18970
8600000US18972,2992,1469,1523,80305,99758,10618,18972
8600000US18974,33518,15875,17643,78117,96465,4435,18974
8600000US18976,16109,7678,8431,103338,130638,6826,18976
8600000US18977,3469,1794,1675,140847,205233,28293,18977
8600000US18980,482,256,226,94063,152002,48143,18980
8600000US19001,13284,6133,7151,89284,99550,4263,19001
8600000US19002,24979,11685,13294,105522,149703,7849,19002
8600000US19003,10694,4551,6143,90718,124017,10694,19003
8600000US19004,7381,3307,4074,114015,166073,10402,19004
8600000US19006,17437,8041,9396,101496,127957,6283,19006
8600000US19007,16276,7507,8769,51701,69478,4543,19007
8600000US19008,16622,8076,8546,99313,123757,8101,19008
8600000US19009,658,316,342,86786,107796,26214,19009
8600000US19010,16929,7269,9660,103791,178907,10912,19010
8600000US19012,5025,2530,2495,94551,108931,9874,19012
8600000US19013,26845,13045,13800,30694,41197,1879,19013
8600000US19014,16937,7797,9140,85000,98827,4825,19014
8600000US19015,12488,5753,6735,60972,75657,6451,19015
8600000US19017,242,123,119,63417,80016,35042,19017
8600000US19018,18999,8873,10126,57869,68682,3459,19018
8600000US19020,44432,21779,22653,63907,84007,2783,19020
8600000US19021,7566,3817,3749,54086,68326,5476,19021
8600000US19022,2658,1230,1428,40855,52688,6220,19022
8600000US19023,15507,6746,8761,47491,56213,3155,19023
8600000US19025,4274,2044,2230,140256,191112,22478,19025
8600000US19026,23834,11035,12799,70669,92617,4012,19026
8600000US19027,16156,7238,8918,74045,105923,6479,19027
8600000US19029,3217,1479,1738,52468,64280,9330,19029
8600000US19030,9523,4664,4859,71410,89809,6220,19030
8600000US19031,3560,1441,2119,105990,123444,11560,19031
8600000US19032,4968,2476,2492,59641,65928,5300,19032
8600000US19033,6786,3333,3453,81917,91935,6494,19033
8600000US19034,4537,2204,2333,121528,171763,19637,19034
8600000US19035,2988,1372,1616,195931,326062,50919,19035
8600000US19036,10344,4883,5461,56639,71599,4698,19036
8600000US19038,24503,11316,13187,93456,124166,9263,19038
8600000US19040,16185,7766,8419,81815,101641,5414,19040
8600000US19041,5455,2408,3047,144107,232021,27527,19041
8600000US19043,1833,818,1015,52574,87924,31551,19043
8600000US19044,12682,6222,6460,79186,100518,8453,19044
8600000US19046,13790,6356,7434,99815,140520,9947,19046
8600000US19047,28702,14155,14547,93629,118650,7824,19047
8600000US19050,22502,10026,12476,53591,69976,4535,19050
8600000US19053,20916,10331,10585,83095,98708,4054,19053
8600000US19054,13043,6259,6784,78540,89605,4821,19054
8600000US19055,10856,5344,5512,76001,79807,4415,19055
8600000US19056,12193,5632,6561,73992,93685,6047,19056
8600000US19057,13678,6337,7341,65549,77875,4916,19057
8600000US19060,8721,4149,4572,136971,157870,11710,19060
8600000US19061,15767,7004,8763,57848,73342,4572,19061
8600000US19063,29139,13561,15578,96755,132008,6745,19063
8600000US19064,19220,9270,9950,110810,124385,5459,19064
8600000US19066,4155,1959,2196,192344,254552,24780,19066
8600000US19067,40065,19770,20295,106495,139655,5087,19067
8600000US19070,5776,2816,2960,79250,95206,7361,19070
8600000US19072,7154,3245,3909,115985,206049,19271,19072
8600000US19073,15471,7241,8230,98487,160996,11165,19073
8600000US19074,4699,2220,2479,77034,84025,6174,19074
8600000US19075,5831,2777,3054,96801,110032,6473,19075
8600000US19076,4907,2324,2583,60135,75239,8901,19076
8600000US19078,8911,4280,4631,75757,85652,4706,19078
8600000US19079,7100,3001,4099,50450,67294,10668,19079
8600000US19081,7814,3591,4223,96397,140957,16652,19081
8600000US19082,30824,14880,15944,44600,58700,3317,19082
8600000US19083,27371,13485,13886,102285,120956,4316,19083
8600000US19085,7527,3697,3830,216364,322966,39744,19085
8600000US19086,8840,4193,4647,112253,139531,10288,19086
8600000US19087,25365,11957,13408,137943,188010,9352,19087
8600000US19090,14419,6805,7614,73237,87226,4765,19090
8600000US19094,3060,1593,1467,67091,76162,10636,19094
8600000US19095,5747,2552,3195,74018,97883,11018,19095
8600000US19096,10282,4732,5550,138922,204225,16118,19096
8600000US19102,4800,2421,2379,90750,142551,21677,19102
8600000US19103,22780,10204,12576,73611,123374,8162,19103
8600000US19104,46353,22291,24062,25865,43842,3106,19104
8600000US19106,11556,5889,5667,109393,151764,11902,19106
8600000US19107,12845,6110,6735,53534,86770,6867,19107
8600000US19109,0,0,0,,,,19109
8600000US19111,50955,23580,27375,48186,63069,2073,19111
8600000US19112,0,0,0,,,,19112
8600000US19113,78,38,40,39891,66520,31831,19113
8600000US19114,25694,12401,13293,56781,71208,3025,19114
8600000US19115,27410,12894,14516,52635,74614,4346,19115
8600000US19116,28044,12976,15068,55123,71737,3567,19116
8600000US19118,9025,4045,4980,85437,138904,10747,19118
8600000US19119,23714,10414,13300,61297,96034,5947,19119
8600000US19120,53532,24829,28703,37891,47676,2105,19120
8600000US19121,23623,10275,13348,19668,36436,3418,19121
8600000US19122,18032,9052,8980,35828,55359,5636,19122
8600000US19123,13580,6928,6652,73730,98166,7543,19123
8600000US19124,47170,21536,25634,33427,46870,2729,19124
8600000US19125,20948,10925,10023,65218,79506,5646,19125
8600000US19126,12406,5788,6618,41266,58851,7232,19126
8600000US19127,5745,3272,2473,73750,89063,10187,19127
8600000US19128,32141,15590,16551,72563,90345,3432,19128
8600000US19129,8908,3999,4909,63926,89801,8559,19129
8600000US19130,24249,11646,12603,82632,114019,7186,19130
8600000US19131,34857,14098,20759,34844,47086,2448,19131
8600000US19132,24654,10781,13873,20955,31880,2452,19132
8600000US19133,20044,9020,11024,19130,32496,3912,19133
8600000US19134,42007,19757,22250,28911,43714,2325,19134
8600000US19135,25268,12123,13145,44779,56129,4083,19135
8600000US19136,26915,14077,12838,48576,59546,3040,19136
8600000US19137,6425,3142,3283,54006,66242,6247,19137
8600000US19138,26037,11460,14577,39851,51316,4826,19138
8600000US19139,33010,14136,18874,28505,38352,1820,19139
8600000US19140,37701,17043,20658,21665,34159,3043,19140
8600000US19141,25927,11030,14897,31018,46177,3783,19141
8600000US19142,19784,8936,10848,30431,39360,2623,19142
8600000US19143,50945,22134,28811,33351,48615,2481,19143
8600000US19144,33522,14769,18753,33786,49886,2499,19144
8600000US19145,37233,17153,20080,42009,63142,4645,19145
8600000US19146,32711,15412,17299,63524,97697,5334,19146
8600000US19147,32848,15915,16933,77695,111468,4833,19147
8600000US19148,42227,20479,21748,52584,67585,3352,19148
8600000US19149,43470,20677,22793,45126,56674,2355,19149
8600000US19150,18623,7493,11130,46150,57626,3266,19150
8600000US19151,24939,10951,13988,48369,63244,3609,19151
8600000US19152,29365,14009,15356,52696,64566,3403,19152
8600000US19153,10649,4788,5861,42418,56532,5341,19153
8600000US19154,26720,12980,13740,65082,80612,2656,19154
8600000US19301,5009,2346,2663,97031,129313,10586,19301
8600000US19310,2245,1102,1143,61471,84539,11006,19310
8600000US19311,6492,3261,3231,103967,135465,12134,19311
8600000US19312,8733,4105,4628,134531,196797,14905,19312
8600000US19316,187,108,79,61786,78678,25997,19316
8600000US19317,7613,3689,3924,125093,170409,13490,19317
8600000US19319,684,491,193,238984,229693,70465,19319
8600000US19320,41925,20455,21470,72836,88994,3377,19320
8600000US19330,4155,2060,2095,83071,108037,9117,19330
8600000US19333,5028,2459,2569,106786,159319,16306,19333
8600000US19335,36735,18208,18527,107686,134777,6571,19335
8600000US19341,13367,6376,6991,101241,127730,7776,19341
8600000US19342,14834,7110,7724,107823,142838,11912,19342
8600000US19343,6066,3133,2933,125425,147881,11244,19343
8600000US19344,8799,4399,4400,65227,82443,5571,19344
8600000US19345,689,102,587,,,,19345
8600000US19348,18230,8926,9304,92107,137169,9513,19348
8600000US19350,9053,4717,4336,127531,166704,11676,19350
8600000US19352,8222,4071,4151,117857,137581,9122,19352
8600000US19355,19812,9589,10223,121600,174842,10004,19355
8600000US19358,536,216,320,37340,51394,7725,19358
8600000US19362,4394,2310,2084,70431,84883,11303,19362
8600000US19363,12205,5980,6225,73811,95030,4647,19363
8600000US19365,5438,2628,2810,72346,83947,5813,19365
8600000US19367,0,0,0,,,,19367
8600000US19372,1311,563,748,86917,144381,73607,19372
8600000US19373,4010,2602,1408,134931,189840,42405,19373
8600000US19374,836,468,368,27299,56775,18299,19374
8600000US19375,8,0,8,,,,19375
8600000US19380,41183,19958,21225,97383,124386,4674,19380
8600000US19382,44015,21429,22586,96998,131556,4240,19382
8600000US19383,3132,1306,1826,,,,19383
8600000US19390,10510,4957,5553,82858,105902,7946,19390
8600000US19401,32068,15497,16571,51090,70419,3695,19401
8600000US19403,37623,18364,19259,83970,105556,3628,19403
8600000US19405,4267,2246,2021,63357,77574,8257,19405
8600000US19406,19460,9738,9722,88239,110541,5332,19406
8600000US19422,14851,7143,7708,120517,166182,10362,19422
8600000US19425,10944,5230,5714,164792,213010,17308,19425
8600000US19426,31717,17266,14451,122290,154236,7038,19426
8600000US19428,14663,7440,7223,86573,113140,5808,19428
8600000US19435,93,41,52,,,,19435
8600000US19436,607,233,374,55583,150501,101633,19436
8600000US19437,778,405,373,,356481,170056,19437
8600000US19438,19028,8916,10112,98636,124600,6697,19438
8600000US19440,15403,7658,7745,72792,96301,6262,19440
8600000US19442,0,0,0,,,,19442
8600000US19444,8534,4011,4523,116127,151032,13678,19444
8600000US19446,44976,21081,23895,84390,112436,4056,19446
8600000US19453,1336,768,568,64896,81472,18665,19453
8600000US19454,23076,11161,11915,91801,123931,7293,19454
8600000US19456,532,242,290,106057,132520,42532,19456
8600000US19457,44,22,22,,,,19457
8600000US19460,32428,16493,15935,96997,124367,5702,19460
8600000US19462,11929,5590,6339,96188,120623,6857,19462
8600000US19464,35871,17198,18673,59812,77307,3036,19464
8600000US19465,13551,6375,7176,87563,113756,7358,19465
8600000US19468,20195,9502,10693,79651,99401,4071,19468
8600000US19472,12,6,6,,,,19472
8600000US19473,11914,5973,5941,100253,118862,6124,19473
8600000US19474,548,232,316,65136,88566,35455,19474
8600000US19475,8563,4323,4240,81563,101557,8741,19475
8600000US19477,127,59,68,,,,19477
8600000US19492,344,118,226,25946,41348,14276,19492
8600000US19501,884,451,433,70341,76405,9087,19501
8600000US19503,1018,496,522,63375,72803,8551,19503
8600000US19504,4271,2226,2045,83807,93572,7850,19504
8600000US19505,2836,1453,1383,75202,80646,8637,19505
8600000US19506,5687,2833,2854,79919,88563,4053,19506
8600000US19507,2255,1153,1102,63088,82495,20557,19507
8600000US19508,12083,6153,5930,68250,81917,4817,19508
8600000US19510,6921,3583,3338,78943,94536,15929,19510
8600000US19511,64,40,24,115156,95233,23115,19511
8600000US19512,13951,6796,7155,67625,79741,3946,19512
8600000US19518,12077,6038,6039,91713,99137,5126,19518
8600000US19519,0,0,0,,,,19519
8600000US19520,4565,2145,2420,85117,103696,7391,19520
8600000US19522,11230,5584,5646,75862,87490,4648,19522
8600000US19523,382,197,185,51019,47146,17247,19523
8600000US19525,11988,5713,6275,97285,112384,6385,19525
8600000US19526,9166,4351,4815,57433,75079,6565,19526
8600000US19529,2756,1419,1337,73295,92332,10709,19529
8600000US19530,13968,6468,7500,60142,80081,7369,19530
8600000US19533,6654,3648,3006,70842,88898,7075,19533
8600000US19534,1442,756,686,62862,72584,8607,19534
8600000US19535,10,5,5,,,,19535
8600000US19536,504,234,270,57750,60359,9401,19536
8600000US19538,22,15,7,,,,19538
8600000US19539,3742,1818,1924,62832,82228,12777,19539
8600000US19540,8972,4382,4590,82118,101260,7864,19540
8600000US19541,3451,1702,1749,66786,81172,7805,19541
8600000US19542,0,0,0,,,,19542
8600000US19543,4578,2298,2280,93523,105410,7921,19543
8600000US19544,105,75,30,36912,47794,9782,19544
8600000US19545,540,259,281,62288,65553,10539,19545
8600000US19547,3569,1807,1762,75781,85759,9104,19547
8600000US19549,213,124,89,52679,54379,10796,19549
8600000US19550,493,386,107,52375,75546,25592,19550
8600000US19551,4003,2106,1897,74634,87296,6012,19551
8600000US19554,337,174,163,51685,67839,17968,19554
8600000US19555,2745,1380,1365,64667,80108,8213,19555
8600000US19559,281,149,132,53750,92657,45012,19559
8600000US19560,6351,2895,3456,61688,71908,7461,19560
8600000US19562,2184,928,1256,55982,66919,5891,19562
8600000US19564,133,62,71,85786,73294,22484,19564
8600000US19565,7201,3626,3575,69511,92547,10073,19565
8600000US19567,4026,1853,2173,63392,77434,13467,19567
8600000US19601,23212,11226,11986,27081,38607,2094,19601
8600000US19602,12084,5989,6095,25298,34465,2082,19602
8600000US19604,19299,9371,9928,36897,47392,3119,19604
8600000US19605,15414,7465,7949,64416,76819,5624,19605
8600000US19606,26936,12943,13993,69723,86050,3539,19606
8600000US19607,18658,8049,10609,61922,79257,6288,19607
8600000US19608,17020,8346,8674,84133,110494,8484,19608
8600000US19609,8047,4065,3982,72951,89768,9468,19609
8600000US19610,12654,5772,6882,76038,116764,9356,19610
8600000US19611,7986,3661,4325,41640,52064,3838,19611
8600000US19701,31005,14861,16144,84591,105278,5485,19701
8600000US19702,41713,20179,21534,77164,93632,4130,19702
8600000US19703,11426,5280,6146,58304,71307,4261,19703
8600000US19706,1349,617,732,60707,65024,8318,19706
8600000US19707,12718,6211,6507,126987,153883,12728,19707
8600000US19709,29457,14151,15306,101320,118947,6980,19709
8600000US19710,0,0,0,,,,19710
8600000US19711,44146,20984,23162,71983,93756,3897,19711
8600000US19713,24063,11513,12550,55098,71882,3100,19713
8600000US19716,1130,416,714,,,,19716
8600000US19717,4012,1831,2181,,,,19717
8600000US19720,47006,21833,25173,60409,77524,3597,19720
8600000US19730,654,339,315,95955,94495,9025,19730
8600000US19731,182,70,112,40129,35836,9745,19731
8600000US19732,74,27,47,,,,19732
8600000US19733,142,69,73,104417,104571,13971,19733
8600000US19734,9466,4826,4640,94598,103981,7994,19734
8600000US19735,26,9,17,,,,19735
8600000US19736,69,0,69,,,,19736
8600000US19801,12514,6649,5865,27696,46985,3442,19801
8600000US19802,20070,9185,10885,42329,66445,7234,19802
8600000US19803,17443,8093,9350,103265,131626,7211,19803
8600000US19804,14162,6933,7229,58825,68398,3770,19804
8600000US19805,28803,13111,15692,46515,63270,3531,19805
8600000US19806,8714,3872,4842,69790,114548,11042,19806
8600000US19807,5683,2846,2837,120547,236665,29719,19807
8600000US19808,31865,15249,16616,76141,95716,4073,19808
8600000US19809,11339,5328,6011,70604,84162,6422,19809
8600000US19810,20283,9379,10904,88433,111531,5254,19810
8600000US19901,28592,13396,15196,49686,66909,3651,19901
8600000US19902,386,314,72,,,,19902
8600000US19904,27738,13232,14506,59672,73285,3503,19904
8600000US19930,2268,1067,1201,90625,127899,12669,19930
8600000US19931,222,109,113,65357,75941,18103,19931
8600000US19933,7747,3825,3922,50660,65086,5770,19933
8600000US19934,10978,5287,5691,71298,86672,5675,19934
8600000US19936,201,84,117,24600,36823,13649,19936
8600000US19938,6513,3113,3400,64229,74901,5743,19938
8600000US19939,6076,2784,3292,64678,91330,13310,19939
8600000US19940,4214,1963,2251,51699,67913,5203,19940
8600000US19941,1953,869,1084,52181,66808,13149,19941
8600000US19943,9067,4253,4814,57958,72456,5654,19943
8600000US19944,615,263,352,73929,124266,22203,19944
8600000US19945,5594,2882,2712,61657,80544,9486,19945
8600000US19946,3928,1727,2201,52375,68119,10385,19946
8600000US19947,15224,7875,7349,52590,72429,8909,19947
8600000US19950,5737,2701,3036,51430,63904,6877,19950
8600000US19951,1846,895,951,80938,111907,33962,19951
8600000US19952,7875,3722,4153,50674,62238,5005,19952
8600000US19953,3815,1944,1871,58800,79045,14329,19953
8600000US19954,1010,481,529,46518,60934,9500,19954
8600000US19955,29,11,18,,49236,55004,19955
8600000US19956,10771,4891,5880,51451,65362,5732,19956
8600000US19958,21905,10169,11736,72157,93686,5862,19958
8600000US19960,5023,2433,2590,55625,61805,4871,19960
8600000US19962,9098,4291,4807,72295,89187,9202,19962
8600000US19963,16119,7818,8301,57595,71767,4273,19963
8600000US19964,859,407,452,59205,85933,21517,19964
8600000US19966,22866,10600,12266,57045,68357,3473,19966
8600000US19967,1149,530,619,66602,82019,9374,19967
8600000US19968,9095,4378,4717,64436,86026,9943,19968
8600000US19970,7343,3512,3831,70330,96031,9493,19970
8600000US19971,12095,6019,6076,76663,122762,12450,19971
8600000US19973,19586,9433,10153,52813,71081,4212,19973
8600000US19975,8076,3970,4106,58546,84333,6286,19975
8600000US19977,20225,10958,9267,68013,84393,10759,19977
8600000US19979,717,348,369,74792,75982,10290,19979
8600000US20001,42342,20390,21952,109318,134700,4816,20001
8600000US20002,54121,25703,28418,84892,114221,3687,20002
8600000US20003,26709,13930,12779,126323,152189,5683,20003
8600000US20004,1833,929,904,147522,165986,14919,20004
8600000US20005,12173,6096,6077,94611,123979,8815,20005
8600000US20006,2717,1198,1519,46319,61567,11214,20006
8600000US20007,23720,10966,12754,130920,198244,11621,20007
8600000US20008,26119,11909,14210,117195,181259,12310,20008
8600000US20009,47031,24119,22912,107128,139940,4756,20009
8600000US20010,28908,14350,14558,88463,120012,5997,20010
8600000US20011,54602,25781,28821,71569,103901,3985,20011
8600000US20012,12725,6186,6539,91667,126417,7843,20012
8600000US20015,12215,5725,6490,158443,214842,15021,20015
8600000US20016,28182,12204,15978,150997,230283,15782,20016
8600000US20017,16794,7406,9388,77560,101411,6452,20017
8600000US20018,15920,7033,8887,64530,90570,5744,20018
8600000US20019,46163,19205,26958,36398,54670,2965,20019
8600000US20020,40456,17570,22886,36075,59465,3837,20020
8600000US20024,11974,5488,6486,83145,100480,7210,20024
8600000US20032,30500,13553,16947,37711,55167,3298,20032
8600000US20036,5595,2652,2943,88553,111633,13548,20036
8600000US20037,14202,6997,7205,89475,131600,16934,20037
8600000US20045,0,0,0,,,,20045
8600000US20052,751,403,348,,,,20052
8600000US20053,0,0,0,,,,20053
8600000US20057,3767,1799,1968,,,,20057
8600000US20064,2183,888,1295,,,,20064
8600000US20105,13996,6766,7230,153314,162836,9015,20105
8600000US20106,4091,2016,2075,82500,107077,11118,20106
8600000US20109,29499,14693,14806,70629,85857,4382,20109
8600000US20110,36041,18389,17652,81042,96745,3364,20110
8600000US20111,26293,13490,12803,88207,106714,4135,20111
8600000US20112,19853,10005,9848,149618,162127,6149,20112
8600000US20115,5255,2460,2795,107462,129538,15020,20115
8600000US20117,1975,880,1095,88200,123007,17117,20117
8600000US20118,5,2,3,,,,20118
8600000US20119,3499,1828,1671,89450,119425,16434,20119
8600000US20120,31272,15445,15827,122165,148235,5514,20120
8600000US20121,22713,11122,11591,98051,114616,4506,20121
8600000US20124,12249,6207,6042,177440,209242,11118,20124
8600000US20129,524,347,177,,254217,109302,20129
8600000US20130,204,115,89,59719,64878,17018,20130
8600000US20132,13083,6374,6709,138687,156822,7453,20132
8600000US20135,2613,1321,1292,82000,126983,27789,20135
8600000US20136,20297,9980,10317,138496,152809,5563,20136
8600000US20137,1257,617,640,133250,160187,27070,20137
8600000US20139,203,124,79,,93329,50013,20139
8600000US20141,4694,2358,2336,144971,160704,16188,20141
8600000US20143,845,405,440,122656,210337,73618,20143
8600000US20144,719,395,324,89457,122464,35904,20144
8600000US20147,46650,22309,24341,130507,155594,5336,20147
8600000US20148,31609,15417,16192,171343,187206,6534,20148
8600000US20151,17154,8381,8773,124258,151205,7601,20151
8600000US20152,23054,11061,11993,157615,177850,7226,20152
8600000US20155,25121,11940,13181,131184,146336,4749,20155
8600000US20158,3197,1628,1569,172708,187129,17617,20158
8600000US20164,31129,15877,15252,96442,114953,5486,20164
8600000US20165,24594,12310,12284,143085,163638,6105,20165
8600000US20166,8388,4243,4145,105248,126809,9227,20166
8600000US20169,17572,8733,8839,145332,165845,7315,20169
8600000US20170,32165,16135,16030,124859,145916,5272,20170
8600000US20171,36687,18180,18507,141559,169082,4391,20171
8600000US20175,24448,12029,12419,132594,174096,12733,20175
8600000US20176,37960,18609,19351,128167,162329,8416,20176
8600000US20180,5488,2633,2855,135212,150526,10468,20180
8600000US20181,7012,3380,3632,133902,153925,9074,20181
8600000US20184,544,228,316,72163,88357,16955,20184
8600000US20186,11611,5308,6303,84327,117736,11893,20186
8600000US20187,12965,6397,6568,126532,150446,8303,20187
8600000US20190,15876,7669,8207,106929,139164,10143,20190
8600000US20191,23485,11011,12474,116842,144155,6534,20191
8600000US20194,9884,4621,5263,128859,171863,7879,20194
8600000US20197,1422,722,700,149545,224234,50791,20197
8600000US20198,1750,809,941,84792,132598,39999,20198
8600000US20202,0,0,0,,,,20202
8600000US20204,0,0,0,,,,20204
8600000US20228,0,0,0,,,,20228
8600000US20230,0,0,0,,,,20230
8600000US20240,0,0,0,,,,20240
8600000US20245,0,0,0,,,,20245
8600000US20260,0,0,0,,,,20260
8600000US20307,108,76,32,,,,20307
8600000US20317,406,334,72,28077,27420,8730,20317
8600000US20319,42,42,0,,,,20319
8600000US20373,144,133,11,,,,20373
8600000US20390,359,340,19,,,,20390
8600000US20405,0,0,0,,,,20405
8600000US20418,0,0,0,,,,20418
8600000US20427,0,0,0,,,,20427
8600000US20506,0,0,0,,,,20506
8600000US20510,0,0,0,,,,20510
8600000US20520,0,0,0,,,,20520
8600000US20535,0,0,0,,,,20535
8600000US20540,0,0,0,,,,20540
8600000US20551,0,0,0,,,,20551
8600000US20553,0,0,0,,,,20553
8600000US20560,0,0,0,,,,20560
8600000US20565,0,0,0,,,,20565
8600000US20566,0,0,0,,,,20566
8600000US20593,0,0,0,,,,20593
8600000US20601,19390,9014,10376,101269,114757,4797,20601
8600000US20602,19241,8693,10548,78315,88319,5585,20602
8600000US20603,22985,10581,12404,113274,126225,6334,20603
8600000US20606,351,138,213,,81528,32467,20606
8600000US20607,8848,4057,4791,128134,143191,8739,20607
8600000US20608,646,342,304,66500,84526,17461,20608
8600000US20609,841,396,445,44896,67870,15196,20609
8600000US20611,1250,699,551,96944,127290,36497,20611
8600000US20612,358,177,181,,59283,26508,20612
8600000US20613,11060,5376,5684,119258,135035,8497,20613
8600000US20615,329,158,171,109375,130983,22851,20615
8600000US20616,4771,2344,2427,91496,100167,7643,20616
8600000US20617,585,260,325,92115,117383,25991,20617
8600000US20618,403,194,209,57036,84793,24986,20618
8600000US20619,9366,4583,4783,93011,104344,5665,20619
8600000US20620,1100,450,650,103016,88593,18507,20620
8600000US20621,811,435,376,69432,98941,26767,20621
8600000US20622,4598,2700,1898,105292,112412,10383,20622
8600000US20623,2259,1188,1071,144861,143053,11653,20623
8600000US20624,1082,511,571,94643,118743,26732,20624
8600000US20625,499,236,263,,71176,19904,20625
8600000US20626,329,129,200,94667,132797,51186,20626
8600000US20628,228,166,62,157778,214247,83213,20628
8600000US20629,249,115,134,,105319,60360,20629
8600000US20630,293,118,175,101912,97652,31749,20630
8600000US20632,308,173,135,80446,88957,16008,20632
8600000US20634,5498,2678,2820,92556,92817,7767,20634
8600000US20636,8481,4331,4150,107624,128557,10770,20636
8600000US20637,4520,2345,2175,117964,125276,11829,20637
8600000US20639,11159,5588,5571,133729,143521,7850,20639
8600000US20640,7508,3736,3772,67783,85127,5831,20640
8600000US20645,716,286,430,122250,149672,38481,20645
8600000US20646,16459,7756,8703,101484,121535,8174,20646
8600000US20650,10514,5261,5253,98443,127100,9374,20650
8600000US20653,18015,8864,9151,71543,87951,6546,20653
8600000US20657,14291,7029,7262,93053,107018,6414,20657
8600000US20658,652,288,364,69630,87089,17153,20658
8600000US20659,17916,8678,9238,94904,106946,7154,20659
8600000US20660,26,0,26,,,,20660
8600000US20662,2357,1132,1225,71979,81767,11515,20662
8600000US20664,2491,1187,1304,81875,88446,10440,20664
8600000US20667,506,253,253,42500,64456,19771,20667
8600000US20670,985,608,377,62841,70608,7479,20670
8600000US20674,739,376,363,119635,136319,58832,20674
8600000US20675,1790,937,853,103306,107113,22734,20675
8600000US20676,3146,1553,1593,115640,120635,12463,20676
8600000US20677,2121,1147,974,123235,136869,16058,20677
8600000US20678,9703,4674,5029,90885,105643,8997,20678
8600000US20680,521,278,243,80000,100179,24102,20680
8600000US20684,1173,551,622,94484,115266,28013,20684
8600000US20685,5439,2834,2605,98826,117244,10082,20685
8600000US20686,1440,790,650,,,,20686
8600000US20687,348,191,157,95000,111222,38674,20687
8600000US20688,1618,727,891,88661,151258,63026,20688
8600000US20689,1677,764,913,141250,160722,31299,20689
8600000US20690,685,376,309,70313,101361,36429,20690
8600000US20692,1101,622,479,131888,133004,23062,20692
8600000US20693,795,372,423,149583,136213,19132,20693
8600000US20695,6279,2798,3481,101536,112442,9641,20695
8600000US20701,0,0,0,,,,20701
8600000US20705,21073,9828,11245,86260,100251,6165,20705
8600000US20706,31909,15293,16616,77087,92634,3471,20706
8600000US20707,25062,11890,13172,79754,101751,4757,20707
8600000US20708,20043,9896,10147,74413,90677,4317,20708
8600000US20710,6838,2983,3855,43741,57889,5778,20710
8600000US20711,5302,2474,2828,79318,100355,11385,20711
8600000US20712,7398,3565,3833,54769,69571,5134,20712
8600000US20714,3653,1707,1946,90345,100265,11103,20714
8600000US20715,21423,9791,11632,114967,131419,5826,20715
8600000US20716,17282,7722,9560,99319,113775,5217,20716
8600000US20720,18029,8198,9831,135958,148952,8105,20720
8600000US20721,23721,11094,12627,127875,154443,7241,20721
8600000US20722,4607,2258,2349,77977,89512,6466,20722
8600000US20723,25352,12560,12792,113009,138294,6066,20723
8600000US20724,13422,6011,7411,103179,111795,7889,20724
8600000US20732,7243,3410,3833,100567,120912,14645,20732
8600000US20733,2154,1126,1028,104662,113135,12889,20733
8600000US20735,30680,14285,16395,108686,122622,4648,20735
8600000US20736,7170,3581,3589,140125,147807,9851,20736
8600000US20737,15311,7868,7443,63909,80267,4355,20737
8600000US20740,27873,14784,13089,67163,89964,4935,20740
8600000US20742,6555,3438,3117,,,,20742
8600000US20743,30480,13493,16987,63550,77093,2848,20743
8600000US20744,44454,21595,22859,102062,117515,3543,20744
8600000US20745,21845,9747,12098,59100,75556,4812,20745
8600000US20746,21455,9279,12176,67027,78809,4600,20746
8600000US20747,30597,12996,17601,63261,76966,3593,20747
8600000US20748,30155,13738,16417,68033,83945,3277,20748
8600000US20751,1843,961,882,93061,118426,15128,20751
8600000US20754,5476,2811,2665,103636,132333,10473,20754
8600000US20755,6861,3890,2971,77740,88925,6910,20755
8600000US20758,399,218,181,108056,134173,31514,20758
8600000US20759,3599,1678,1921,176023,238070,37064,20759
8600000US20762,1832,1042,790,76688,87872,7497,20762
8600000US20763,1701,758,943,71250,94256,18635,20763
8600000US20764,3206,1510,1696,95373,97722,10532,20764
8600000US20765,368,203,165,48281,87680,30926,20765
8600000US20769,5803,2827,2976,148802,155049,11973,20769
8600000US20770,18263,8436,9827,70561,84948,4157,20770
8600000US20772,35548,16841,18707,107838,121611,3696,20772
8600000US20774,37604,16823,20781,98366,115609,3580,20774
8600000US20776,2338,1080,1258,91707,116718,17381,20776
8600000US20777,2751,1369,1382,196667,263241,47424,20777
8600000US20778,1597,715,882,123984,158632,43495,20778
8600000US20779,787,306,481,111000,131383,30285,20779
8600000US20781,8610,4180,4430,77434,96827,5861,20781
8600000US20782,25133,12388,12745,69437,86990,4212,20782
8600000US20783,33594,18891,14703,63465,77131,3267,20783
8600000US20784,22191,11075,11116,67193,82550,3496,20784
8600000US20785,27961,12019,15942,69623,82212,3042,20785
8600000US20794,14590,9296,5294,93872,110486,11128,20794
8600000US20812,218,104,114,220313,247256,47232,20812
8600000US20814,23529,11151,12378,126077,177483,8137,20814
8600000US20815,24001,11315,12686,154734,248231,9385,20815
8600000US20816,11868,5518,6350,204432,276600,19510,20816
8600000US20817,27514,12735,14779,187731,261849,8500,20817
8600000US20818,1533,682,851,170363,244944,60351,20818
8600000US20832,20131,9889,10242,132292,152720,6980,20832
8600000US20833,6047,2715,3332,154886,189325,17265,20833
8600000US20837,4670,2304,2366,157333,178925,25933,20837
8600000US20838,213,109,104,120000,155635,32487,20838
8600000US20839,49,25,24,,,,20839
8600000US20841,7664,3978,3686,170682,185499,9748,20841
8600000US20842,1512,736,776,105721,156738,27998,20842
8600000US20850,40861,18699,22162,110102,140741,5728,20850
8600000US20851,11436,5644,5792,92581,108286,10323,20851
8600000US20852,37962,16917,21045,95572,131531,5026,20852
8600000US20853,24412,12153,12259,116391,141198,6340,20853
8600000US20854,37100,17601,19499,206040,266285,9931,20854
8600000US20855,11700,5697,6003,134776,161523,9062,20855
8600000US20860,1851,905,946,105074,156075,33056,20860
8600000US20861,1429,673,756,204167,232544,34688,20861
8600000US20862,275,140,135,150592,132424,21839,20862
8600000US20866,12113,5415,6698,98139,115712,8132,20866
8600000US20868,666,310,356,212422,178203,32541,20868
8600000US20871,13434,6529,6905,132277,156432,7666,20871
8600000US20872,9911,4754,5157,117541,128262,7303,20872
8600000US20874,44857,21287,23570,90273,113725,4747,20874
8600000US20876,21553,10102,11451,94891,121768,6861,20876
8600000US20877,29522,14579,14943,68896,87121,4834,20877
8600000US20878,48443,23659,24784,127653,159423,4100,20878
8600000US20879,20486,9703,10783,91393,103797,4307,20879
8600000US20880,370,173,197,110707,121724,17552,20880
8600000US20882,10563,5332,5231,147957,173359,8022,20882
8600000US20886,25709,12407,13302,79131,102054,4845,20886
8600000US20895,14733,7077,7656,144054,183423,9197,20895
8600000US20896,685,333,352,186528,214885,26936,20896
8600000US20899,248,109,139,35060,41820,14672,20899
8600000US20901,26896,13392,13504,108357,133373,6334,20901
8600000US20902,39153,19513,19640,90324,108985,3842,20902
8600000US20903,19006,9448,9558,66343,83491,4753,20903
8600000US20904,44986,20001,24985,85504,103844,3948,20904
8600000US20905,14325,6960,7365,124549,144273,9331,20905
8600000US20906,55011,24855,30156,74598,94885,3577,20906
8600000US20910,35489,16463,19026,84645,104950,4348,20910
8600000US20912,19900,9828,10072,73978,102931,4973,20912
8600000US21001,19057,9091,9966,62678,82863,4897,21001
8600000US21005,1866,1193,673,74120,92075,10311,21005
8600000US21009,22979,10982,11997,91091,103819,3870,21009
8600000US21010,186,129,57,75583,81400,26565,21010
8600000US21012,16035,7436,8599,124605,149903,8715,21012
8600000US21013,3752,1879,1873,143214,143309,12047,21013
8600000US21014,27858,13375,14483,88394,104496,3633,21014
8600000US21015,21940,10497,11443,107392,133972,7104,21015
8600000US21017,5165,2324,2841,79390,87138,6046,21017
8600000US21028,2447,1216,1231,107218,134866,12521,21028
8600000US21029,8065,3977,4088,192367,218337,13240,21029
8600000US21030,20283,9721,10562,69481,107958,6978,21030
8600000US21031,0,0,0,,,,21031
8600000US21032,6564,3243,3321,123996,182129,30133,21032
8600000US21034,2890,1476,1414,79947,94689,12505,21034
8600000US21035,6288,3140,3148,159688,225224,29201,21035
8600000US21036,1797,916,881,170735,204714,32081,21036
8600000US21037,16994,8726,8268,106447,133745,7124,21037
8600000US21040,17814,7964,9850,61268,76940,5788,21040
8600000US21042,30572,14494,16078,152787,181377,6322,21042
8600000US21043,35029,16685,18344,118263,141577,4954,21043
8600000US21044,35407,16617,18790,102896,130000,5327,21044
8600000US21045,30295,14707,15588,103130,115252,4318,21045
8600000US21046,12214,5817,6397,107081,124842,6924,21046
8600000US21047,9337,4646,4691,106549,125583,7789,21047
8600000US21048,7992,3827,4165,115991,143710,18864,21048
8600000US21050,14318,6987,7331,105581,119967,7275,21050
8600000US21051,275,128,147,157639,152083,45199,21051
8600000US21052,221,127,94,103542,114964,33701,21052
8600000US21053,2496,1224,1272,108705,171219,63608,21053
8600000US21054,8490,4156,4334,120054,138368,8316,21054
8600000US21056,146,63,83,,151510,79101,21056
8600000US21057,3456,1743,1713,122993,144195,14204,21057
8600000US21060,27299,13061,14238,72542,89818,4744,21060
8600000US21061,42403,19999,22404,67128,80028,2871,21061
8600000US21071,483,202,281,,185473,103571,21071
8600000US21074,11679,5642,6037,80991,107897,10122,21074
8600000US21075,23614,11470,12144,103312,116562,4859,21075
8600000US21076,13887,6957,6930,116098,125644,6719,21076
8600000US21077,236,109,127,126446,134224,19519,21077
8600000US21078,14771,7297,7474,75604,97732,5748,21078
8600000US21082,474,255,219,121250,171895,65742,21082
8600000US21084,6077,3006,3071,105136,114355,8638,21084
8600000US21085,12883,6325,6558,82885,90284,5326,21085
8600000US21087,4460,2193,2267,115133,146311,15552,21087
8600000US21090,8310,3970,4340,94494,109467,6388,21090
8600000US21093,30050,14172,15878,95643,134359,8327,21093
8600000US21102,8809,4343,4466,90585,104974,5701,21102
8600000US21104,4162,2005,2157,147826,168605,11945,21104
8600000US21105,0,0,0,,,,21105
8600000US21108,14131,6999,7132,125407,148265,10353,21108
8600000US21111,3739,1799,1940,135909,170059,21386,21111
8600000US21113,25478,11682,13796,98338,114438,6249,21113
8600000US21114,19647,9481,10166,119724,140618,5838,21114
8600000US21117,45771,20443,25328,83392,106539,4817,21117
8600000US21120,5579,2835,2744,104713,128771,10371,21120
8600000US21122,47053,22669,24384,97092,109636,3626,21122
8600000US21128,10819,5076,5743,100904,120091,8451,21128
8600000US21130,242,122,120,58866,59370,13255,21130
8600000US21131,5630,2780,2850,135551,192238,18507,21131
8600000US21132,2405,1096,1309,112426,118334,19706,21132
8600000US21133,25326,10967,14359,80855,91154,4008,21133
8600000US21136,26353,11667,14686,82565,115418,5422,21136
8600000US21140,2532,1319,1213,120690,145933,16347,21140
8600000US21144,25785,12415,13370,105717,118211,4433,21144
8600000US21146,20470,10085,10385,138797,166528,11238,21146
8600000US21152,4167,1906,2261,97500,145418,19250,21152
8600000US21153,217,92,125,,233485,214072,21153
8600000US21154,4783,2369,2414,91964,118069,14323,21154
8600000US21155,2170,1013,1157,111863,138841,22480,21155
8600000US21156,291,110,181,97656,114518,44733,21156
8600000US21157,29473,14265,15208,82134,95664,3924,21157
8600000US21158,16016,7752,8264,89565,103957,6241,21158
8600000US21160,2243,1167,1076,80500,88262,16682,21160
8600000US21161,4283,2054,2229,104871,115856,7683,21161
8600000US21162,3348,1693,1655,102500,106288,9303,21162
8600000US21163,5567,2761,2806,133934,163898,23361,21163
8600000US21201,14677,6538,8139,34559,56980,4837,21201
8600000US21202,18687,11325,7362,46660,68959,5799,21202
8600000US21204,18292,8892,9400,77412,123589,8858,21204
8600000US21205,10162,4566,5596,30699,41395,3700,21205
8600000US21206,39441,17345,22096,52262,67514,3385,21206
8600000US21207,38710,17409,21301,56719,68810,2738,21207
8600000US21208,29121,12506,16615,79800,110777,5682,21208
8600000US21209,21138,9429,11709,82555,112651,5256,21209
8600000US21210,13140,6005,7135,103359,161694,11265,21210
8600000US21211,14251,6805,7446,68425,88628,5931,21211
8600000US21212,25210,11307,13903,77699,120198,5775,21212
8600000US21213,23024,9395,13629,36136,48811,3533,21213
8600000US21214,16614,7460,9154,68554,83216,4585,21214
8600000US21215,45749,19849,25900,37517,56223,3073,21215
8600000US21216,24860,11450,13410,39846,53851,3293,21216
8600000US21217,26249,11861,14388,29121,50015,3147,21217
8600000US21218,41483,20447,21036,45613,70373,3706,21218
8600000US21219,7564,3762,3802,76882,90260,7129,21219
8600000US21220,30681,14533,16148,62681,77064,3392,21220
8600000US21221,33004,14918,18086,55115,68224,2709,21221
8600000US21222,42104,20291,21813,52339,66138,3395,21222
8600000US21223,17365,8081,9284,28683,44127,5304,21223
8600000US21224,39930,19851,20079,69615,92631,3854,21224
8600000US21225,25036,11473,13563,43172,59695,3685,21225
8600000US21226,4856,2055,2801,71250,90193,11640,21226
8600000US21227,25615,12468,13147,65395,77420,3849,21227
8600000US21228,39014,18753,20261,84257,102055,3106,21228
8600000US21229,36299,15978,20321,47131,62128,2964,21229
8600000US21230,28769,14020,14749,81446,108934,5061,21230
8600000US21231,13617,6443,7174,71719,103985,8570,21231
8600000US21234,55020,25141,29879,64510,82136,3022,21234
8600000US21236,30240,14329,15911,78659,92286,4739,21236
8600000US21237,23510,10879,12631,68034,84250,5095,21237
8600000US21239,24858,10473,14385,53689,65970,3406,21239
8600000US21240,0,0,0,,,,21240
8600000US21244,27372,12250,15122,68874,85203,4738,21244
8600000US21250,2388,1183,1205,,,,21250
8600000US21251,912,543,369,,,,21251
8600000US21252,2191,943,1248,,,,21252
8600000US21286,17185,7662,9523,86034,110794,6642,21286
8600000US21401,30691,14848,15843,100909,123193,5005,21401
8600000US21402,6081,4342,1739,77250,80772,8214,21402
8600000US21403,24677,12188,12489,94265,128707,7066,21403
8600000US21405,304,138,166,108750,141517,32631,21405
8600000US21409,15625,7747,7878,118539,152488,8094,21409
8600000US21502,34977,19215,15762,44375,60000,2607,21502
8600000US21520,1625,758,867,56953,66814,6892,21520
8600000US21521,968,493,475,38542,42984,5476,21521
8600000US21522,164,91,73,83750,92845,31162,21522
8600000US21523,174,93,81,38083,41335,10065,21523
8600000US21524,622,268,354,43821,58118,8591,21524
8600000US21529,380,199,181,49732,62285,10424,21529
8600000US21530,1567,815,752,43750,56412,11962,21530
8600000US21531,1567,896,671,45227,58823,10037,21531
8600000US21532,12524,5908,6616,44115,59025,3480,21532
8600000US21536,3158,1450,1708,51818,63647,6428,21536
8600000US21538,346,171,175,37083,46426,7220,21538
8600000US21539,2255,1086,1169,56067,63527,7535,21539
8600000US21540,78,42,36,31875,31459,6071,21540
8600000US21541,1164,583,581,45714,55810,10121,21541
8600000US21542,508,252,256,42625,54921,8357,21542
8600000US21543,164,91,73,42250,48503,14343,21543
8600000US21545,1487,731,756,45037,60072,10236,21545
8600000US21550,11642,5526,6116,46443,67670,5137,21550
8600000US21555,1303,666,637,52407,72205,19044,21555
8600000US21557,1323,707,616,43605,51140,9106,21557
8600000US21561,2065,1096,969,51984,68653,8053,21561
8600000US21562,2580,1287,1293,42411,48713,4144,21562
8600000US21601,18751,8753,9998,60988,91653,5811,21601
8600000US21607,590,302,288,113750,128628,39055,21607
8600000US21610,271,111,160,51818,63954,11144,21610
8600000US21612,321,154,167,81250,243467,204583,21612
8600000US21613,13556,6046,7510,44726,68761,5365,21613
8600000US21617,8239,4182,4057,106025,130207,11891,21617
8600000US21619,4916,2334,2582,88409,102192,10173,21619
8600000US21620,10995,4994,6001,58996,78355,7563,21620
8600000US21622,765,339,426,59943,63578,13948,21622
8600000US21623,1494,856,638,72614,93223,13063,21623
8600000US21624,160,81,79,71250,77014,31057,21624
8600000US21625,2051,958,1093,86063,98140,12852,21625
8600000US21626,78,43,35,54250,55911,16194,21626
8600000US21627,17,6,11,,,,21627
8600000US21628,426,213,213,38902,47585,11250,21628
8600000US21629,7542,3569,3973,62066,84989,8590,21629
8600000US21631,2040,931,1109,69076,81660,10349,21631
8600000US21632,4337,2005,2332,47089,65114,7977,21632
8600000US21634,200,101,99,63000,60199,18469,21634
8600000US21635,1571,751,820,78000,102697,13901,21635
8600000US21636,994,563,431,64167,79265,15662,21636
8600000US21638,3926,1964,1962,96731,117579,13728,21638
8600000US21639,3304,1482,1822,52066,62140,5944,21639
8600000US21640,1095,534,561,54635,60364,10600,21640
8600000US21641,79,34,45,65000,51195,12989,21641
8600000US21643,4644,2351,2293,60753,63657,5958,21643
8600000US21644,64,32,32,,66844,30197,21644
8600000US21645,1217,649,568,82167,116534,24711,21645
8600000US21647,196,83,113,80000,86598,32488,21647
8600000US21648,197,94,103,78036,75305,22471,21648
8600000US21649,1598,851,747,45234,71225,13974,21649
8600000US21650,233,159,74,64333,99697,33650,21650
8600000US21651,2256,1105,1151,58349,78681,14853,21651
8600000US21652,129,58,71,74886,107121,54961,21652
8600000US21653,108,48,60,104792,118219,48955,21653
8600000US21654,893,426,467,66875,150569,41031,21654
8600000US21655,3928,2037,1891,63106,77444,6193,21655
8600000US21657,686,330,356,112188,111889,27245,21657
8600000US21658,3099,1504,1595,110104,130026,15572,21658
8600000US21659,1149,551,598,74375,102321,22688,21659
8600000US21660,3063,1442,1621,55526,76526,6215,21660
8600000US21661,2013,1002,1011,41477,70913,11226,21661
8600000US21662,430,220,210,61094,123574,23604,21662
8600000US21663,2979,1364,1615,75927,121338,15662,21663
8600000US21664,341,159,182,46538,72191,32935,21664
8600000US21665,214,107,107,123036,262266,213881,21665
8600000US21666,9578,4611,4967,101031,117199,9602,21666
8600000US21667,215,121,94,,76473,27956,21667
8600000US21668,1456,754,702,67805,75876,9400,21668
8600000US21669,180,92,88,49000,64407,22715,21669
8600000US21671,684,342,342,44583,66586,13988,21671
8600000US21672,135,62,73,53875,54408,14049,21672
8600000US21673,2832,1280,1552,66905,161690,58890,21673
8600000US21675,90,54,36,41058,41293,11820,21675
8600000US21676,386,178,208,68750,105981,36345,21676
8600000US21677,307,141,166,76250,100331,22677,21677
8600000US21678,1479,631,848,49688,82079,19656,21678
8600000US21679,225,119,106,94722,116203,41203,21679
8600000US21701,30226,14235,15991,79196,98535,4226,21701
8600000US21702,31956,15592,16364,81638,100959,3725,21702
8600000US21703,27082,12474,14608,83142,93514,3692,21703
8600000US21704,11248,5654,5594,137162,145864,8674,21704
8600000US21705,0,0,0,,,,21705
8600000US21710,3816,1907,1909,114609,120023,7413,21710
8600000US21711,871,454,417,68672,75844,16597,21711
8600000US21713,8018,3948,4070,74954,96064,8541,21713
8600000US21714,120,48,72,,180825,142352,21714
8600000US21716,4086,2059,2027,75542,91446,9497,21716
8600000US21717,77,53,24,,,,21717
8600000US21718,115,51,64,76250,97962,23658,21718
8600000US21719,783,353,430,54327,64303,8753,21719
8600000US21722,4330,2117,2213,62377,75221,5694,21722
8600000US21723,715,365,350,171083,178363,41523,21723
8600000US21727,5638,2600,3038,70694,89199,11345,21727
8600000US21733,803,477,326,83333,125965,31746,21733
8600000US21734,625,305,320,37250,56193,15482,21734
8600000US21737,1666,818,848,195104,256733,39109,21737
8600000US21738,2523,1246,1277,186103,191678,21333,21738
8600000US21740,47798,24810,22988,48136,65164,3000,21740
8600000US21742,25515,11897,13618,65719,92288,6655,21742
8600000US21746,2953,2953,0,,,,21746
8600000US21750,2915,1420,1495,46796,63980,6335,21750
8600000US21754,4987,2556,2431,126008,154779,15444,21754
8600000US21755,4321,2175,2146,108194,134806,12544,21755
8600000US21756,2867,1411,1456,90170,93240,8819,21756
8600000US21757,2547,1324,1223,77917,89151,9704,21757
8600000US21758,3716,1876,1840,73207,90938,8797,21758
8600000US21762,167,65,102,,117262,46652,21762
8600000US21766,456,207,249,35694,51379,12041,21766
8600000US21767,756,331,425,54333,65292,20017,21767
8600000US21769,8509,4089,4420,123247,143185,12579,21769
8600000US21770,4341,2334,2007,134130,149222,11550,21770
8600000US21771,22430,10990,11440,124676,133918,5233,21771
8600000US21773,4369,2287,2082,100132,115486,6598,21773
8600000US21774,8993,4466,4527,129552,139044,6942,21774
8600000US21776,4351,2159,2192,87424,95351,8020,21776
8600000US21777,1327,656,671,110486,131005,13235,21777
8600000US21778,797,426,371,69722,114666,55373,21778
8600000US21779,745,376,369,112045,107953,18864,21779
8600000US21780,1332,721,611,66875,113496,55357,21780
8600000US21781,112,63,49,,,,21781
8600000US21782,3184,1556,1628,71833,90651,10899,21782
8600000US21783,6740,3249,3491,78356,89501,5236,21783
8600000US21784,29658,14692,14966,109734,127014,4391,21784
8600000US21787,8065,4226,3839,73899,91411,9611,21787
8600000US21788,9171,4693,4478,73194,91115,6847,21788
8600000US21790,55,35,20,110000,115064,54930,21790
8600000US21791,4336,2172,2164,84848,100285,11311,21791
8600000US21793,7705,3560,4145,84740,100796,7235,21793
8600000US21794,1737,890,847,158864,186150,31746,21794
8600000US21795,7378,3456,3922,60430,75479,5377,21795
8600000US21797,6601,3329,3272,133962,163784,18159,21797
8600000US21798,1500,759,741,77250,108678,16543,21798
8600000US21801,22891,10651,12240,56089,76847,5708,21801
8600000US21802,89,37,52,,,,21802
8600000US21804,31819,14585,17234,53421,69430,2860,21804
8600000US21810,720,309,411,149290,121476,48665,21810
8600000US21811,19444,9202,10242,67395,86498,5933,21811
8600000US21813,2031,1069,962,91467,116553,34889,21813
8600000US21814,418,256,162,58531,60502,24492,21814
8600000US21817,3664,1621,2043,38301,51602,4689,21817
8600000US21821,801,382,419,43214,61111,16374,21821
8600000US21822,1563,850,713,51731,77975,11692,21822
8600000US21824,82,37,45,,57784,24353,21824
8600000US21826,4169,1803,2366,56389,62943,6649,21826
8600000US21829,434,223,211,74375,80455,19440,21829
8600000US21830,2903,1359,1544,70568,88700,11565,21830
8600000US21835,224,120,104,,64776,24369,21835
8600000US21837,2588,1276,1312,64583,77182,8834,21837
8600000US21838,1449,643,806,70391,82761,18427,21838
8600000US21840,349,171,178,92596,108713,33010,21840
8600000US21841,947,410,537,81815,78690,11035,21841
8600000US21842,9603,4914,4689,55177,81558,7021,21842
8600000US21849,2512,1222,1290,49880,65772,10567,21849
8600000US21850,2380,1185,1195,66500,68266,6783,21850
8600000US21851,5305,2346,2959,41171,57851,6487,21851
8600000US21853,9717,4736,4981,35625,51542,5184,21853
8600000US21856,773,483,290,45500,53114,12804,21856
8600000US21861,621,258,363,62159,84068,28856,21861
8600000US21862,39,27,12,,,,21862
8600000US21863,3824,1845,1979,53438,78368,14778,21863
8600000US21864,508,235,273,63125,65193,15346,21864
8600000US21865,452,234,218,133892,130081,25983,21865
8600000US21866,60,31,29,,69278,30612,21866
8600000US21867,10,0,10,,,,21867
8600000US21869,908,436,472,50568,101120,47580,21869
8600000US21871,1608,807,801,58604,65571,9257,21871
8600000US21872,516,234,282,,63854,29349,21872
8600000US21874,1479,718,761,47841,53190,6030,21874
8600000US21875,5048,2332,2716,60100,67498,6129,21875
8600000US21890,2799,2799,0,,,,21890
8600000US21901,13745,6600,7145,74737,90429,7085,21901
8600000US21902,212,209,3,,,,21902
8600000US21903,4630,2287,2343,64760,80419,6641,21903
8600000US21904,5486,2773,2713,78944,92745,9667,21904
8600000US21911,7988,3987,4001,75461,90645,6582,21911
8600000US21912,908,477,431,63542,82744,25799,21912
8600000US21913,715,341,374,34596,51650,12854,21913
8600000US21914,595,313,282,80962,85614,17058,21914
8600000US21915,2186,965,1221,76653,98640,16726,21915
8600000US21916,38,38,0,,,,21916
8600000US21917,1904,908,996,77917,91107,12104,21917
8600000US21918,3172,1634,1538,76429,88668,9682,21918
8600000US21919,2332,1223,1109,79292,115673,26631,21919
8600000US21920,316,143,173,40781,59656,25281,21920
8600000US21921,34526,16902,17624,68935,84126,3496,21921
8600000US21930,180,63,117,,76228,46403,21930
8600000US22003,46230,22964,23266,101850,124853,3948,22003
8600000US22015,34431,16615,17816,133286,149292,5323,22015
8600000US22025,13397,6433,6964,117600,137805,6655,22025
8600000US22026,10744,5072,5672,89886,101541,7686,22026
8600000US22027,1552,734,818,,247864,38454,22027
8600000US22030,47383,23658,23725,119624,143018,4823,22030
8600000US22031,26177,13415,12762,108632,131912,5690,22031
8600000US22032,24149,11835,12314,144628,158962,5647,22032
8600000US22033,30701,14805,15896,113188,138891,5255,22033
8600000US22035,0,0,0,,,,22035
8600000US22039,13561,6705,6856,210000,245220,12710,22039
8600000US22041,21687,10602,11085,69959,94106,4262,22041
8600000US22042,27678,14209,13469,106429,131264,5318,22042
8600000US22043,19449,9802,9647,117182,148415,7778,22043
8600000US22044,10464,5242,5222,81491,119488,9133,22044
8600000US22046,13589,6557,7032,137913,180160,11026,22046
8600000US22060,5836,3042,2794,83047,103582,8573,22060
8600000US22066,13896,6680,7216,223434,302028,23645,22066
8600000US22079,26198,12427,13771,113097,138446,5893,22079
8600000US22101,21526,10564,10962,195631,290305,16782,22101
8600000US22102,19747,9487,10260,115099,190298,13266,22102
8600000US22124,13877,6563,7314,161333,210682,12926,22124
8600000US22125,735,329,406,125833,141289,18127,22125
8600000US22134,5960,4483,1477,63190,77041,8533,22134
8600000US22150,21930,10807,11123,99566,112808,4345,22150
8600000US22151,13957,6685,7272,122933,135682,9355,22151
8600000US22152,22455,10855,11600,127198,141158,5867,22152
8600000US22153,23351,11143,12208,139757,153287,3619,22153
8600000US22172,7395,3604,3791,70822,96797,10113,22172
8600000US22180,18226,9128,9098,147324,188761,9372,22180
8600000US22181,11172,5456,5716,167887,208065,15757,22181
8600000US22182,20198,9881,10317,188918,224806,11030,22182
8600000US22185,0,0,0,,,,22185
8600000US22191,51664,25141,26523,84344,103605,5009,22191
8600000US22192,43332,20449,22883,100585,119593,3537,22192
8600000US22193,59695,30040,29655,96661,113723,3401,22193
8600000US22201,33213,16391,16822,125363,158511,5909,22201
8600000US22202,22779,11778,11001,110817,130847,5279,22202
8600000US22203,20480,10274,10206,103654,127032,5150,22203
8600000US22204,43811,22069,21742,84525,107091,4088,22204
8600000US22205,14091,6920,7171,180781,196396,10070,22205
8600000US22206,16862,7484,9378,107096,122286,5940,22206
8600000US22207,24723,11871,12852,183761,247322,12553,22207
8600000US22209,11579,5876,5703,115292,153176,12226,22209
8600000US22211,1156,1056,100,114375,104543,22505,22211
8600000US22213,2757,1434,1323,170795,223469,24870,22213
8600000US22214,0,0,0,,,,22214
8600000US22301,10597,5066,5531,157145,181521,8093,22301
8600000US22302,14632,6633,7999,105968,145964,8167,22302
8600000US22303,12275,6206,6069,94227,112968,6601,22303
8600000US22304,39371,18093,21278,80676,104337,4213,22304
8600000US22305,13484,6574,6910,91345,119650,6446,22305
8600000US22306,25750,12707,13043,76610,101231,5286,22306
8600000US22307,7986,3531,4455,113936,168115,15342,22307
8600000US22308,9351,4579,4772,183929,203520,12002,22308
8600000US22309,26439,13039,13400,85292,116550,5063,22309
8600000US22310,25215,11927,13288,123791,144622,6873,22310
8600000US22311,14998,7677,7321,68488,86288,5648,22311
8600000US22312,26858,13539,13319,79834,111141,6994,22312
8600000US22314,29635,13981,15654,125404,159510,5707,22314
8600000US22315,22650,11022,11628,130116,144644,4978,22315
8600000US22401,22517,10073,12444,63274,86820,5088,22401
8600000US22405,22691,10956,11735,93389,109450,3831,22405
8600000US22406,19597,9266,10331,98427,112475,5119,22406
8600000US22407,43725,21064,22661,84829,100899,3183,22407
8600000US22408,22159,10703,11456,89078,104475,3972,22408
8600000US22427,4293,2902,1391,53240,66780,6968,22427
8600000US22432,203,121,82,,48676,36416,22432
8600000US22433,295,93,202,83558,76455,31308,22433
8600000US22435,1934,962,972,47521,60529,10571,22435
8600000US22436,398,136,262,56250,62872,27253,22436
8600000US22437,818,374,444,56541,68945,14876,22437
8600000US22438,296,158,138,56324,114837,106730,22438
8600000US22443,6759,3137,3622,55938,71694,7191,22443
8600000US22448,455,235,220,68304,81567,11905,22448
8600000US22454,1312,600,712,68588,73661,11924,22454
8600000US22460,1212,574,638,54740,53188,7122,22460
8600000US22469,1238,595,643,53125,58080,12077,22469
8600000US22473,4393,2037,2356,59272,68014,8369,22473
8600000US22476,323,170,153,98875,75158,19058,22476
8600000US22480,649,274,375,74231,119505,36587,22480
8600000US22482,2598,1222,1376,50399,77065,13267,22482
8600000US22485,18839,9440,9399,88690,104262,5838,22485
8600000US22488,841,405,436,43750,57592,15326,22488
8600000US22503,3190,1466,1724,45982,70642,11360,22503
8600000US22504,320,169,151,81148,79441,12223,22504
8600000US22508,11006,5183,5823,83159,91233,5755,22508
8600000US22509,40,40,0,,,,22509
8600000US22511,827,376,451,60688,76930,16940,22511
8600000US22514,1783,827,956,66917,82323,15808,22514
8600000US22520,4997,2397,2600,58400,83502,9447,22520
8600000US22529,155,81,74,,51848,32240,22529
8600000US22530,35,27,8,,,,22530
8600000US22534,2421,1253,1168,61429,83743,9648,22534
8600000US22535,393,219,174,41146,72430,21631,22535
8600000US22538,67,18,49,,,,22538
8600000US22539,2102,1049,1053,72833,83147,11503,22539
8600000US22542,1721,906,815,69381,88113,18645,22542
8600000US22546,11842,5352,6490,71934,88678,12904,22546
8600000US22548,172,98,74,15735,17451,3011,22548
8600000US22551,15041,7561,7480,82906,109149,7941,22551
8600000US22553,10810,5105,5705,91944,111097,5962,22553
8600000US22554,40574,20518,20056,116357,133789,4937,22554
8600000US22556,21251,10692,10559,108147,126365,5751,22556
8600000US22560,5152,2258,2894,47500,55609,3948,22560
8600000US22567,2435,1240,1195,44115,64252,10776,22567
8600000US22572,6073,3638,2435,49588,72164,15115,22572
8600000US22576,1682,796,886,42325,67918,12535,22576
8600000US22578,2054,996,1058,68940,96375,17223,22578
8600000US22579,66,33,33,,,,22579
8600000US22580,4109,1780,2329,54872,75014,9677,22580
8600000US22601,22197,10655,11542,54119,75199,4081,22601
8600000US22602,22682,11072,11610,78916,98581,4946,22602
8600000US22603,12572,6309,6263,67195,88552,7937,22603
8600000US22610,1479,742,737,59350,71335,10362,22610
8600000US22611,6893,3293,3600,73245,94776,9414,22611
8600000US22620,2022,993,1029,104609,110585,13556,22620
8600000US22623,553,256,297,74583,96752,24227,22623
8600000US22624,2289,1218,1071,66866,81309,9731,22624
8600000US22625,2500,1176,1324,78235,95570,11559,22625
8600000US22627,602,268,334,42500,70432,24959,22627
8600000US22630,25069,12360,12709,64421,79674,3558,22630
8600000US22637,1802,909,893,83438,76183,9659,22637
8600000US22639,452,224,228,102969,102802,27451,22639
8600000US22640,519,242,277,65375,116821,44660,22640
8600000US22641,340,178,162,54188,65028,22428,22641
8600000US22642,3794,1957,1837,79688,92843,9489,22642
8600000US22643,222,111,111,,91238,47172,22643
8600000US22644,1994,990,1004,62024,77908,14810,22644
8600000US22645,3436,1756,1680,77992,92765,8840,22645
8600000US22646,116,35,81,,176034,99928,22646
8600000US22650,518,225,293,57014,81237,15957,22650
8600000US22652,1060,556,504,62875,73825,10517,22652
8600000US22654,845,426,419,67586,66039,13095,22654
8600000US22655,15608,7631,7977,74958,85600,3633,22655
8600000US22656,2499,1196,1303,84438,89128,10690,22656
8600000US22657,7986,3884,4102,57188,67056,5009,22657
8600000US22660,1543,614,929,53030,61530,10194,22660
8600000US22663,1276,752,524,67813,90425,20112,22663
8600000US22664,6907,3347,3560,51693,66905,9477,22664
8600000US22701,25895,12752,13143,69685,82732,3305,22701
8600000US22709,1004,471,533,56020,66703,14891,22709
8600000US22711,23,11,12,,,,22711
8600000US22712,6911,3510,3401,86288,97519,8011,22712
8600000US22713,1307,647,660,86471,110536,33417,22713
8600000US22714,685,341,344,92917,159294,85517,22714
8600000US22715,883,395,488,58640,84648,35395,22715
8600000US22716,562,288,274,46908,62545,14331,22716
8600000US22718,612,345,267,72917,86595,16573,22718
8600000US22719,231,144,87,53500,40934,12247,22719
8600000US22720,554,304,250,124375,124631,17666,22720
8600000US22722,197,99,98,48199,41941,9890,22722
8600000US22723,109,30,79,,61229,42952,22723
8600000US22724,1949,893,1056,106576,139946,21806,22724
8600000US22726,606,261,345,49167,69273,12606,22726
8600000US22727,4286,2121,2165,54006,75888,15457,22727
8600000US22728,2487,1345,1142,91304,105635,12025,22728
8600000US22729,1176,1083,93,73333,82389,18178,22729
8600000US22730,101,44,57,,,,22730
8600000US22731,10,3,7,,,,22731
8600000US22732,156,79,77,,74136,43674,22732
8600000US22733,873,425,448,88393,85868,14945,22733
8600000US22734,2198,975,1223,71359,81961,8571,22734
8600000US22735,2332,1141,1191,78548,104299,19846,22735
8600000US22736,527,267,260,88594,85645,16089,22736
8600000US22737,2198,1109,1089,61875,75613,10100,22737
8600000US22738,1182,488,694,67984,67987,17718,22738
8600000US22740,1001,487,514,51250,60304,11235,22740
8600000US22741,92,22,70,67679,49743,21910,22741
8600000US22742,1452,715,737,93679,112032,16744,22742
8600000US22743,291,127,164,,147020,77223,22743
8600000US22747,783,354,429,72042,100960,20332,22747
8600000US22749,213,134,79,78750,109785,64967,22749
8600000US22801,33645,16591,17054,48767,68297,3854,22801
8600000US22802,23069,10935,12134,47684,69972,6588,22802
8600000US22807,3187,1160,2027,,,,22807
8600000US22810,723,320,403,91298,92802,18410,22810
8600000US22811,537,296,241,60909,73764,17131,22811
8600000US22812,7419,3429,3990,60966,75225,8328,22812
8600000US22815,7087,3508,3579,57487,69623,6715,22815
8600000US22820,189,109,80,37366,43962,17406,22820
8600000US22821,3847,1908,1939,60613,86450,14253,22821
8600000US22824,5077,2608,2469,60272,69365,4930,22824
8600000US22827,7976,3656,4320,51766,63585,5023,22827
8600000US22830,1372,709,663,49306,65512,16385,22830
8600000US22831,913,387,526,67984,82797,13596,22831
8600000US22832,885,446,439,60938,86361,15876,22832
8600000US22834,887,423,464,72328,89064,18895,22834
8600000US22835,9275,4535,4740,51813,63901,4826,22835
8600000US22840,3310,1645,1665,74209,79844,7263,22840
8600000US22841,2340,1171,1169,67273,93873,16000,22841
8600000US22842,4121,1993,2128,51012,69426,10647,22842
8600000US22843,1961,989,972,67635,89226,17453,22843
8600000US22844,4093,1840,2253,50811,64792,7634,22844
8600000US22845,9,9,0,,,,22845
8600000US22846,2035,939,1096,88821,100534,12293,22846
8600000US22847,676,354,322,51750,60226,11060,22847
8600000US22849,4099,1991,2108,45063,61142,17216,22849
8600000US22850,803,354,449,61369,84528,25807,22850
8600000US22851,4803,2400,2403,43229,53254,5031,22851
8600000US22853,3205,1579,1626,48551,57036,6123,22853
8600000US22901,27879,12500,15379,70071,103757,7460,22901
8600000US22902,19944,9775,10169,64560,87861,5421,22902
8600000US22903,34280,16839,17441,63339,97655,6013,22903
8600000US22904,5055,2382,2673,,13185,11099,22904
8600000US22911,13678,6118,7560,78239,105384,8691,22911
8600000US22920,2957,1414,1543,78490,93279,12800,22920
8600000US22922,1521,719,802,58765,67135,13292,22922
8600000US22923,4165,1980,2185,72500,86473,7734,22923
8600000US22931,243,130,113,64688,84323,24345,22931
8600000US22932,5672,2680,2992,75297,106191,17335,22932
8600000US22935,789,399,390,68269,99327,33307,22935
8600000US22936,3782,1863,1919,115642,143049,15510,22936
8600000US22937,1641,774,867,51618,67794,12910,22937
8600000US22938,1115,420,695,81250,85468,19643,22938
8600000US22939,4812,2221,2591,77847,92644,10352,22939
8600000US22940,1120,557,563,54300,68026,14846,22940
8600000US22942,6827,3201,3626,53765,73758,6792,22942
8600000US22943,249,119,130,92969,94421,26924,22943
8600000US22946,161,74,87,,140769,99480,22946
8600000US22947,3208,1478,1730,95294,154137,34985,22947
8600000US22948,154,84,70,39537,51422,18113,22948
8600000US22949,1139,563,576,40513,58361,20494,22949
8600000US22952,1602,755,847,56898,65994,10882,22952
8600000US22958,2087,1120,967,85128,138390,45126,22958
8600000US22959,1263,580,683,59844,90260,15535,22959
8600000US22960,7864,3905,3959,53630,70646,7498,22960
8600000US22963,12782,5812,6970,75974,109451,29111,22963
8600000US22964,237,107,130,52396,61464,23164,22964
8600000US22967,1413,728,685,66091,80042,25933,22967
8600000US22968,8122,3899,4223,75317,87422,8179,22968
8600000US22969,1071,512,559,62813,65709,10792,22969
8600000US22971,1232,695,537,45909,57529,13694,22971
8600000US22972,377,127,250,,129468,53889,22972
8600000US22973,4565,2146,2419,48952,81730,24453,22973
8600000US22974,4504,1779,2725,85313,98040,11964,22974
8600000US22976,571,271,300,58491,68119,18120,22976
8600000US22980,24593,11589,13004,51033,63576,4008,22980
8600000US22989,15,0,15,,,,22989
8600000US23002,7946,3914,4032,54930,73474,9176,23002
8600000US23004,773,420,353,40781,46772,10712,23004
8600000US23005,13581,6498,7083,72252,93389,5947,23005
8600000US23009,4805,2300,2505,81875,95754,12230,23009
8600000US23011,1221,782,439,80169,82658,20534,23011
8600000US23015,3064,1549,1515,81436,91369,9128,23015
8600000US23021,158,87,71,42652,53587,27058,23021
8600000US23022,989,473,516,60588,68816,23137,23022
8600000US23023,442,268,174,41184,56392,22836,23023
8600000US23024,6557,3173,3384,64627,93396,19584,23024
8600000US23025,235,82,153,75031,69303,28530,23025
8600000US23027,911,449,462,33083,52914,19222,23027
8600000US23030,4006,1972,2034,58630,99707,22397,23030
8600000US23032,262,143,119,,64660,28004,23032
8600000US23035,1075,556,519,65139,94503,30754,23035
8600000US23038,1303,552,751,70268,73891,14593,23038
8600000US23039,874,503,371,63966,102537,24381,23039
8600000US23040,3466,1639,1827,47946,56635,7014,23040
8600000US23043,1690,928,762,52773,63207,10202,23043
8600000US23045,129,72,57,18785,23974,11762,23045
8600000US23047,1737,799,938,67895,101890,16759,23047
8600000US23050,673,325,348,58261,86190,29325,23050
8600000US23055,750,357,393,68792,95187,21513,23055
8600000US23056,337,135,202,90451,110748,60441,23056
8600000US23059,25532,11863,13669,109288,149097,7271,23059
8600000US23060,28589,13393,15196,84349,107686,5222,23060
8600000US23061,17387,8666,8721,75194,86889,4758,23061
8600000US23062,2039,812,1227,52765,72281,13547,23062
8600000US23063,3872,1621,2251,67083,95234,18142,23063
8600000US23064,258,113,145,,76050,69354,23064
8600000US23065,1430,712,718,59882,72307,14124,23065
8600000US23066,133,89,44,,60789,27364,23066
8600000US23068,153,97,56,,136165,48989,23068
8600000US23069,2403,1304,1099,69318,88874,14561,23069
8600000US23070,347,158,189,58125,76835,25396,23070
8600000US23071,1459,694,765,66393,86529,17640,23071
8600000US23072,9136,4701,4435,62010,78074,5195,23072
8600000US23075,7345,2861,4484,45279,54562,5640,23075
8600000US23076,627,258,369,,101057,56791,23076
8600000US23079,192,77,115,52083,105346,72480,23079
8600000US23083,1723,805,918,72260,72854,17836,23083
8600000US23084,1136,486,650,82500,88015,19993,23084
8600000US23085,552,364,188,,69444,18723,23085
8600000US23086,2744,1348,1396,65625,84743,13232,23086
8600000US23089,4132,2199,1933,66852,82174,8550,23089
8600000US23091,103,31,72,,207402,224388,23091
8600000US23092,612,273,339,46964,52753,17517,23092
8600000US23093,10985,5211,5774,59193,72251,6783,23093
8600000US23102,2425,1276,1149,84725,102025,15123,23102
8600000US23103,4500,2062,2438,109071,156088,23442,23103
8600000US23106,811,417,394,51250,60793,12709,23106
8600000US23108,174,97,77,106053,99240,18967,23108
8600000US23109,1950,906,1044,64283,80837,22989,23109
8600000US23110,495,213,282,56250,74393,14958,23110
8600000US23111,28514,13477,15037,81481,95471,3540,23111
8600000US23112,39784,19135,20649,95056,107912,3515,23112
8600000US23113,19031,9108,9923,109940,159071,9490,23113
8600000US23114,13684,6271,7413,104987,114687,5850,23114
8600000US23115,127,77,50,45888,46736,11709,23115
8600000US23116,22883,11126,11757,105295,119067,3758,23116
8600000US23117,8029,3914,4115,69368,91910,10652,23117
8600000US23119,338,131,207,84729,139296,80031,23119
8600000US23120,6586,3337,3249,137179,164579,19955,23120
8600000US23123,1599,714,885,42544,46287,8907,23123
8600000US23124,3544,1610,1934,81496,96610,11374,23124
8600000US23125,226,105,121,108673,85457,40473,23125
8600000US23126,173,67,106,63750,59376,16911,23126
8600000US23128,670,266,404,85369,98977,36930,23128
8600000US23129,405,183,222,167633,146826,25428,23129
8600000US23130,196,155,41,,67703,42044,23130
8600000US23138,475,263,212,,59410,27690,23138
8600000US23139,19509,9441,10068,82366,96702,4618,23139
8600000US23140,5208,2599,2609,76518,90548,7466,23140
8600000US23141,5234,2490,2744,77602,100303,11218,23141
8600000US23146,2429,1276,1153,108281,111954,10192,23146
8600000US23148,1498,647,851,44577,55370,9905,23148
8600000US23149,2399,1146,1253,56366,62224,8382,23149
8600000US23150,9657,4529,5128,58565,71316,5600,23150
8600000US23153,935,458,477,93906,96474,14683,23153
8600000US23156,1331,690,641,48553,53077,8005,23156
8600000US23160,2658,2632,26,,,,23160
8600000US23161,140,67,73,44712,50961,10181,23161
8600000US23163,81,31,50,,98707,80892,23163
8600000US23168,5470,2435,3035,78674,88535,7736,23168
8600000US23169,860,421,439,35739,45387,9351,23169
8600000US23173,2201,999,1202,,,,23173
8600000US23175,1590,716,874,49034,60011,9170,23175
8600000US23176,304,121,183,46979,81077,50099,23176
8600000US23177,472,218,254,68452,85870,23307,23177
8600000US23180,496,228,268,66184,83884,24099,23180
8600000US23181,4301,1955,2346,66023,79405,7148,23181
8600000US23185,39432,18520,20912,81743,117050,6452,23185
8600000US23187,239,88,151,,,,23187
8600000US23188,35316,16906,18410,79505,97763,5032,23188
8600000US23192,5400,2605,2795,92055,127664,16437,23192
8600000US23219,4319,2295,2024,32912,48640,7615,23219
8600000US23220,31577,14802,16775,42110,72928,5772,23220
8600000US23221,13205,5923,7282,74096,115916,5803,23221
8600000US23222,20509,9261,11248,38649,54720,5294,23222
8600000US23223,40190,18284,21906,40507,57837,4132,23223
8600000US23224,29982,13966,16016,36097,45932,3325,23224
8600000US23225,34589,16245,18344,48397,65615,2987,23225
8600000US23226,12860,5802,7058,93188,146747,7532,23226
8600000US23227,21038,9214,11824,50991,75025,6667,23227
8600000US23228,28676,13501,15175,53290,65992,2936,23228
8600000US23229,26551,12927,13624,79490,122352,5867,23229
8600000US23230,5691,2619,3072,61069,73488,5923,23230
8600000US23231,28421,13467,14954,57066,71641,4290,23231
8600000US23233,23714,11465,12249,102779,127545,6395,23233
8600000US23234,34367,15878,18489,47770,61951,3596,23234
8600000US23235,25463,11555,13908,77249,93918,4596,23235
8600000US23236,20022,9389,10633,77297,92697,5793,23236
8600000US23237,17620,8505,9115,57262,70187,2761,23237
8600000US23238,20801,9384,11417,77399,108944,7106,23238
8600000US23250,0,0,0,,,,23250
8600000US23294,14278,6826,7452,56527,68677,4108,23294
8600000US23301,1050,555,495,39330,65268,15361,23301
8600000US23302,164,69,95,,85980,68658,23302
8600000US23303,841,381,460,65637,60320,14164,23303
8600000US23304,40,20,20,,,,23304
8600000US23306,606,333,273,69125,71593,11088,23306
8600000US23307,406,176,230,41094,42762,12992,23307
8600000US23308,1582,841,741,38565,54156,11323,23308
8600000US23310,3611,1726,1885,41611,65269,7584,23310
8600000US23313,75,57,18,32321,32752,13016,23313
8600000US23314,6548,3022,3526,78644,91848,6936,23314
8600000US23315,1112,542,570,62500,76310,11808,23315
8600000US23316,374,177,197,44524,59240,18681,23316
8600000US23320,44462,20861,23601,73321,89029,4066,23320
8600000US23321,26323,11961,14362,75177,91198,4437,23321
8600000US23322,49831,26393,23438,101165,117869,4193,23322
8600000US23323,29430,13960,15470,79270,94363,5190,23323
8600000US23324,17401,7605,9796,42027,57369,3591,23324
8600000US23325,12663,6111,6552,63092,72441,4330,23325
8600000US23336,2569,1121,1448,48639,67608,10701,23336
8600000US23337,441,192,249,40313,45307,11898,23337
8600000US23347,501,263,238,42014,76947,37895,23347
8600000US23350,2779,1261,1518,39255,49725,4426,23350
8600000US23354,131,68,63,,94074,36218,23354
8600000US23356,1163,649,514,64583,69558,10177,23356
8600000US23357,573,240,333,45547,48829,16324,23357
8600000US23358,85,42,43,56607,56695,1823,23358
8600000US23359,788,307,481,39386,60851,18481,23359
8600000US23389,147,86,61,,,,23389
8600000US23395,351,115,236,36134,29900,10215,23395
8600000US23398,26,6,20,53333,53850,7196,23398
8600000US23401,186,62,124,,28947,20331,23401
8600000US23405,766,364,402,63533,83563,19407,23405
8600000US23407,620,187,433,,50634,27051,23407
8600000US23408,53,0,53,24570,32887,11709,23408
8600000US23409,166,92,74,,88690,47166,23409
8600000US23410,1284,597,687,54018,66417,11511,23410
8600000US23413,833,375,458,41838,62993,20078,23413
8600000US23414,175,139,36,75667,68488,15560,23414
8600000US23415,1125,516,609,28828,37207,7460,23415
8600000US23416,223,47,176,,31324,16328,23416
8600000US23417,2755,1191,1564,50170,63300,9232,23417
8600000US23418,851,363,488,54313,59686,10819,23418
8600000US23420,2787,1492,1295,41310,55467,9596,23420
8600000US23421,2827,1460,1367,36490,53492,13478,23421
8600000US23422,153,98,55,32411,46107,17830,23422
8600000US23423,281,141,140,58906,57790,13382,23423
8600000US23426,65,25,40,,39298,26894,23426
8600000US23427,193,95,98,43333,57328,15321,23427
8600000US23430,13844,6789,7055,74930,94948,6941,23430
8600000US23432,1244,603,641,78958,86031,7739,23432
8600000US23433,1013,503,510,82383,117521,16921,23433
8600000US23434,37381,17269,20112,60589,72928,2496,23434
8600000US23435,22179,10765,11414,87545,108461,6328,23435
8600000US23436,757,365,392,103594,138841,24337,23436
8600000US23437,3293,1663,1630,65962,76626,8080,23437
8600000US23438,1322,708,614,65395,77482,16842,23438
8600000US23440,435,208,227,40417,58157,13649,23440
8600000US23441,98,25,73,,24825,18057,23441
8600000US23442,686,337,349,40797,49712,10423,23442
8600000US23451,34269,16289,17980,71119,103574,4716,23451
8600000US23452,46641,22536,24105,69203,88535,2883,23452
8600000US23453,26721,12500,14221,67133,77726,2706,23453
8600000US23454,46232,22486,23746,76080,100676,5552,23454
8600000US23455,40079,20865,19214,74100,97144,5670,23455
8600000US23456,40483,20198,20285,104280,120823,4504,23456
8600000US23457,3280,1644,1636,82471,105559,12405,23457
8600000US23459,829,459,370,59000,61466,7511,23459
8600000US23460,2029,1615,414,,,,23460
8600000US23461,430,315,115,,,,23461
8600000US23462,49447,22550,26897,64491,72956,2445,23462
8600000US23464,58586,28048,30538,78175,90824,2994,23464
8600000US23480,291,172,119,32039,40415,7622,23480
8600000US23486,30,16,14,,,,23486
8600000US23487,4701,2357,2344,61683,76731,6915,23487
8600000US23488,300,147,153,44019,42185,10424,23488
8600000US23502,17377,8519,8858,54322,75981,10052,23502
8600000US23503,25883,14174,11709,52907,65204,3975,23503
8600000US23504,17149,7433,9716,30122,46204,3489,23504
8600000US23505,22562,11383,11179,46602,70645,5094,23505
8600000US23507,5663,2771,2892,71884,105269,9792,23507
8600000US23508,19250,10475,8775,55661,81328,3848,23508
8600000US23509,10808,5131,5677,49711,73082,4763,23509
8600000US23510,7084,4055,3029,56972,78567,8621,23510
8600000US23511,13628,10899,2729,46883,63780,18660,23511
8600000US23513,23884,11645,12239,46324,62552,7903,23513
8600000US23517,3988,2324,1664,51583,75851,10086,23517
8600000US23518,23563,11826,11737,54614,74961,3436,23518
8600000US23523,5074,2202,2872,27010,37523,4986,23523
8600000US23551,880,659,221,,,,23551
8600000US23601,20227,9238,10989,56803,70497,4212,23601
8600000US23602,30481,14202,16279,62640,74599,2660,23602
8600000US23603,2900,1766,1134,48018,56124,8373,23603
8600000US23604,5333,4176,1157,52872,61447,5058,23604
8600000US23605,10905,5175,5730,42810,53006,3958,23605
8600000US23606,23301,10972,12329,56390,78061,3989,23606
8600000US23607,17177,8049,9128,32069,43773,3185,23607
8600000US23608,30729,13817,16912,53260,64380,2352,23608
8600000US23651,359,177,182,87500,105030,15621,23651
8600000US23661,10333,5108,5225,46123,61987,5456,23661
8600000US23662,9329,4555,4774,97146,103993,4502,23662
8600000US23663,10323,4754,5569,48353,60479,5476,23663
8600000US23664,7817,3987,3830,67857,83085,7316,23664
8600000US23665,4014,2283,1731,63235,71624,6381,23665
8600000US23666,41373,19228,22145,55962,67773,2640,23666
8600000US23669,32266,14943,17323,53574,70904,3483,23669
8600000US23690,2998,1652,1346,49509,68908,8037,23690
8600000US23691,68,31,37,,68697,22563,23691
8600000US23692,14264,6782,7482,86289,99909,5962,23692
8600000US23693,18712,9055,9657,103333,121207,5120,23693
8600000US23696,3063,1449,1614,92333,111546,11964,23696
8600000US23701,19491,9346,10145,51687,59724,3099,23701
8600000US23702,7764,3530,4234,39896,48286,3810,23702
8600000US23703,20133,9764,10369,66614,79774,4484,23703
8600000US23704,13536,6328,7208,35538,48189,2726,23704
8600000US23707,10812,4697,6115,45049,57551,3826,23707
8600000US23708,476,366,110,,,,23708
8600000US23709,689,512,177,,,,23709
8600000US23801,3209,1803,1406,62864,71701,6341,23801
8600000US23803,30104,14078,16026,40956,54734,2608,23803
8600000US23805,15757,7236,8521,51748,68714,5230,23805
8600000US23806,1692,740,952,,,,23806
8600000US23821,1544,702,842,48176,61725,18382,23821
8600000US23824,5092,2430,2662,40944,75295,31916,23824
8600000US23827,1332,640,692,50769,66548,8671,23827
8600000US23828,236,132,104,66607,70571,18216,23828
8600000US23829,2189,1646,543,81250,89094,28430,23829
8600000US23830,948,410,538,88167,94956,19055,23830
8600000US23831,27671,12659,15012,75520,86405,3939,23831
8600000US23832,27844,13294,14550,87141,96595,3879,23832
8600000US23833,1826,864,962,46167,62595,14647,23833
8600000US23834,19230,9020,10210,57253,69857,3642,23834
8600000US23836,10429,4976,5453,83407,99355,6180,23836
8600000US23837,3755,1846,1909,50556,62993,6185,23837
8600000US23838,12680,6405,6275,114284,130654,7313,23838
8600000US23839,688,311,377,61711,73344,11376,23839
8600000US23840,2267,1263,1004,63113,79737,22167,23840
8600000US23841,2706,1238,1468,69891,96509,31398,23841
8600000US23842,5460,2895,2565,80764,89204,8239,23842
8600000US23843,476,282,194,36053,51419,14264,23843
8600000US23844,420,206,214,33106,47669,14459,23844
8600000US23845,444,216,228,41371,48353,13741,23845
8600000US23846,917,484,433,62857,60473,9357,23846
8600000US23847,12474,7417,5057,33591,46768,3495,23847
8600000US23850,1031,401,630,70852,66879,14125,23850
8600000US23851,10083,4532,5551,46049,60628,4173,23851
8600000US23856,863,475,388,46910,47665,7064,23856
8600000US23857,442,242,200,59122,69135,25280,23857
8600000US23860,24039,12547,11492,42935,59612,3477,23860
8600000US23866,1557,736,821,56071,61477,7341,23866
8600000US23867,1619,740,879,46386,57787,8844,23867
8600000US23868,6065,3624,2441,29109,45765,5877,23868
8600000US23872,2261,929,1332,58382,70081,11417,23872
8600000US23874,718,334,384,49750,67366,11818,23874
8600000US23875,9301,4542,4759,61270,74330,4556,23875
8600000US23876,221,127,94,80714,76636,26567,23876
8600000US23878,829,420,409,63052,62204,12065,23878
8600000US23879,480,226,254,42361,55914,13842,23879
8600000US23881,1607,797,810,52595,62615,10911,23881
8600000US23882,1292,568,724,47589,54486,10114,23882
8600000US23883,1660,832,828,54609,78399,14192,23883
8600000US23884,33,23,10,,,,23884
8600000US23885,2144,971,1173,64099,77330,11087,23885
8600000US23887,260,89,171,54476,70753,20704,23887
8600000US23888,1668,695,973,37596,49336,6291,23888
8600000US23889,496,240,256,49393,60183,13812,23889
8600000US23890,2943,1136,1807,46265,59332,5393,23890
8600000US23891,3393,3393,0,,,,23891
8600000US23893,206,93,113,60699,62163,9907,23893
8600000US23894,366,224,142,84063,80009,16346,23894
8600000US23897,316,137,179,30917,46603,19558,23897
8600000US23898,1758,786,972,69292,80122,9987,23898
8600000US23899,287,150,137,37500,47848,7970,23899
8600000US23901,15503,7877,7626,46121,67400,6545,23901
8600000US23909,448,212,236,,,,23909
8600000US23915,1077,680,397,51359,75052,24804,23915
8600000US23917,2403,1274,1129,44056,59905,7361,23917
8600000US23919,2011,998,1013,52179,62398,8573,23919
8600000US23920,2731,1284,1447,46827,55630,8534,23920
8600000US23921,1324,675,649,39297,46114,9108,23921
8600000US23922,3608,2637,971,50154,48749,6329,23922
8600000US23923,2131,1134,997,41250,53467,7634,23923
8600000US23924,4937,2236,2701,36220,52840,5985,23924
8600000US23927,3384,1565,1819,48860,75085,18575,23927
8600000US23930,4184,1955,2229,41176,56529,7276,23930
8600000US23934,221,96,125,,51142,28641,23934
8600000US23936,6848,4183,2665,47518,57234,5448,23936
8600000US23937,1471,663,808,27458,42041,6208,23937
8600000US23938,341,219,122,52115,59618,15224,23938
8600000US23942,1109,526,583,31025,47798,18979,23942
8600000US23943,84,53,31,,,,23943
8600000US23944,2632,1195,1437,39548,52563,8901,23944
8600000US23947,3218,1397,1821,44158,50194,7906,23947
8600000US23950,2764,1363,1401,37784,54216,9443,23950
8600000US23952,215,94,121,26887,49500,26069,23952
8600000US23954,1314,623,691,43625,52454,11105,23954
8600000US23958,2683,1254,1429,53421,65251,8967,23958
8600000US23959,1179,643,536,40167,45590,6609,23959
8600000US23960,1100,479,621,44250,56553,11947,23960
8600000US23962,448,205,243,20365,46941,18263,23962
8600000US23963,112,40,72,71026,94119,62687,23963
8600000US23964,948,557,391,39659,48880,9030,23964
8600000US23966,1908,1031,877,52955,72354,16992,23966
8600000US23967,806,321,485,49000,61282,17429,23967
8600000US23968,548,217,331,35455,49651,14507,23968
8600000US23970,6285,2862,3423,38766,50633,6516,23970
8600000US23974,4466,2612,1854,41377,48764,3760,23974
8600000US23976,53,22,31,,21896,17914,23976
8600000US24011,437,240,197,61042,88302,40730,24011
8600000US24012,23380,10952,12428,45000,55886,3559,24012
8600000US24013,6344,3051,3293,34925,41494,4251,24013
8600000US24014,13835,6399,7436,56792,84876,7476,24014
8600000US24015,12026,5779,6247,52970,67720,4388,24015
8600000US24016,6953,3622,3331,27411,42675,4298,24016
8600000US24017,18389,8326,10063,35000,49292,5161,24017
8600000US24018,29752,14115,15637,67797,94853,5033,24018
8600000US24019,21433,10099,11334,69639,80393,2919,24019
8600000US24020,550,36,514,,,,24020
8600000US24053,2226,1164,1062,29511,45234,9927,24053
8600000US24054,5225,2469,2756,35181,49376,5995,24054
8600000US24055,10714,5132,5582,33788,45393,3382,24055
8600000US24058,109,30,79,21500,27443,22179,24058
8600000US24059,679,379,300,72563,70273,18701,24059
8600000US24060,49135,26055,23080,46430,74275,4159,24060
8600000US24064,4254,2128,2126,73702,87431,7576,24064
8600000US24065,5576,2752,2824,67671,76146,8795,24065
8600000US24066,4137,2086,2051,55375,66110,6016,24066
8600000US24067,1785,832,953,54833,60604,9362,24067
8600000US24069,1689,841,848,36013,53731,12644,24069
8600000US24070,1424,746,678,66901,75622,10749,24070
8600000US24072,955,486,469,75434,78291,13711,24072
8600000US24073,24292,12311,11981,58913,78553,5198,24073
8600000US24076,1086,586,500,43906,48214,10096,24076
8600000US24077,594,260,334,40000,51358,12228,24077
8600000US24078,5459,2485,2974,36306,43861,4163,24078
8600000US24079,1479,774,705,42369,63810,10657,24079
8600000US24082,492,195,297,62500,67148,24800,24082
8600000US24083,2607,1215,1392,71853,94296,15572,24083
8600000US24084,8927,4603,4324,51553,65539,5741,24084
8600000US24085,1801,982,819,40109,52057,7583,24085
8600000US24086,140,65,75,28507,35880,10618,24086
8600000US24087,3091,1698,1393,51687,81019,40409,24087
8600000US24088,4206,2116,2090,45439,55532,7764,24088
8600000US24089,2081,1061,1020,38883,77407,45876,24089
8600000US24090,3818,1860,1958,73728,90925,9519,24090
8600000US24091,6024,2883,3141,48546,62141,5863,24091
8600000US24092,1995,858,1137,43511,60407,14317,24092
8600000US24093,116,67,49,60333,59380,19607,24093
8600000US24095,3890,1972,1918,60058,81999,19796,24095
8600000US24101,5284,2652,2632,66000,75073,7010,24101
8600000US24102,1260,625,635,34914,42848,7274,24102
8600000US24104,2616,1279,1337,68171,98525,26792,24104
8600000US24105,260,128,132,51765,53694,22174,24105
8600000US24112,23734,10879,12855,35997,51352,2844,24112
8600000US24120,1138,562,576,39000,43138,6900,24120
8600000US24121,8969,4187,4782,60787,76748,5791,24121
8600000US24122,1316,663,653,53201,79192,24010,24122
8600000US24124,3855,1761,2094,49312,54166,5717,24124
8600000US24127,3145,1350,1795,46926,60185,8450,24127
8600000US24128,1634,878,756,61838,77904,9416,24128
8600000US24130,19,10,9,,,,24130
8600000US24131,46,43,3,,,,24131
8600000US24132,325,163,162,,21601,13631,24132
8600000US24133,1839,972,867,44364,55887,10861,24133
8600000US24134,3816,1831,1985,55461,65742,8800,24134
8600000US24136,2606,1400,1206,53565,63790,7011,24136
8600000US24137,2349,1213,1136,55652,107006,47390,24137
8600000US24138,1603,782,821,77091,75403,10403,24138
8600000US24139,423,221,202,,62744,20518,24139
8600000US24141,19300,9233,10067,48411,62177,4993,24141
8600000US24142,2859,1310,1549,,,,24142
8600000US24147,937,439,498,52533,66314,16592,24147
8600000US24148,6224,3003,3221,42016,50925,3418,24148
8600000US24149,2661,1290,1371,59621,74313,10890,24149
8600000US24150,736,343,393,52143,61418,17119,24150
8600000US24151,15673,7506,8167,42615,59047,5152,24151
8600000US24153,30845,14464,16381,61511,77926,4046,24153
8600000US24161,370,230,140,46346,56478,12060,24161
8600000US24162,1916,813,1103,56250,56307,6685,24162
8600000US24165,1052,456,596,39038,46701,6682,24165
8600000US24167,229,121,108,53083,52105,13606,24167
8600000US24168,231,87,144,30200,31532,15341,24168
8600000US24171,7199,3521,3678,40833,53413,4443,24171
8600000US24174,2171,1101,1070,44602,51827,9959,24174
8600000US24175,6444,3124,3320,71940,88870,8194,24175
8600000US24176,1233,559,674,81597,114557,25996,24176
8600000US24179,14646,7060,7586,53108,65849,4010,24179
8600000US24184,3384,1749,1635,55265,73676,12991,24184
8600000US24185,511,237,274,60484,64084,15494,24185
8600000US24201,12854,5985,6869,37882,51799,4127,24201
8600000US24202,9168,4803,4365,44356,58863,5103,24202
8600000US24210,14046,6839,7207,42162,56263,4189,24210
8600000US24211,7707,3638,4069,61193,82850,7593,24211
8600000US24216,2048,1042,1006,27830,45559,11636,24216
8600000US24217,217,73,144,18796,26031,13153,24217
8600000US24219,9395,5177,4218,44703,62630,9331,24219
8600000US24220,707,412,295,40074,47123,12118,24220
8600000US24221,455,170,285,27250,31928,10492,24221
8600000US24224,4813,2386,2427,34393,41151,3895,24224
8600000US24225,1618,974,644,26875,40306,7164,24225
8600000US24226,984,427,557,30284,95677,94572,24226
8600000US24228,5085,2556,2529,29803,49190,9346,24228
8600000US24230,6707,3546,3161,36385,49754,6487,24230
8600000US24236,2402,1097,1305,34615,49077,7027,24236
8600000US24237,709,309,400,28173,34215,7818,24237
8600000US24239,164,56,108,,23668,20242,24239
8600000US24243,1402,698,704,47333,77310,37040,24243
8600000US24244,4803,2529,2274,36711,46483,4677,24244
8600000US24245,570,294,276,30764,41273,7677,24245
8600000US24246,366,199,167,23972,31130,10820,24246
8600000US24248,1983,1015,968,32923,50563,13077,24248
8600000US24250,1183,549,634,39590,43490,6788,24250
8600000US24251,6748,3297,3451,41744,53211,3463,24251
8600000US24256,2903,1516,1387,25647,45621,14577,24256
8600000US24258,1355,604,751,41490,59772,8682,24258
8600000US24260,4318,2114,2204,30786,40411,4675,24260
8600000US24263,4759,2363,2396,38353,45607,7549,24263
8600000US24265,602,229,373,18750,34151,10892,24265
8600000US24266,7446,3386,4060,44412,61824,9130,24266
8600000US24269,300,113,187,,49793,20745,24269
8600000US24270,551,303,248,39625,41301,5164,24270
8600000US24271,2032,1040,992,33088,43877,6358,24271
8600000US24272,582,314,268,19787,42692,19344,24272
8600000US24273,5013,2198,2815,31240,46247,5867,24273
8600000US24277,5817,3512,2305,24882,41801,5679,24277
8600000US24279,4272,2577,1695,41736,47067,5429,24279
8600000US24280,663,322,341,44318,60632,21318,24280
8600000US24281,2055,991,1064,24944,48364,9870,24281
8600000US24282,704,299,405,24509,42500,14931,24282
8600000US24283,1747,805,942,32634,44358,5726,24283
8600000US24290,1643,782,861,32564,47790,8321,24290
8600000US24292,327,176,151,23654,34309,6681,24292
8600000US24293,7427,3702,3725,41201,58490,7980,24293
8600000US24301,11695,5735,5960,47844,55921,2414,24301
8600000US24311,1368,658,710,27444,37578,6200,24311
8600000US24312,1394,669,725,36277,43316,6062,24312
8600000US24313,538,262,276,30341,33870,12868,24313
8600000US24314,1264,537,727,56250,62163,11089,24314
8600000US24315,2924,1827,1097,47283,60422,7691,24315
8600000US24316,0,0,0,,,,24316
8600000US24317,3115,1636,1479,41977,60286,14953,24317
8600000US24318,480,264,216,61023,54870,8573,24318
8600000US24319,5852,2820,3032,49792,58745,3795,24319
8600000US24322,104,53,51,44917,54420,18764,24322
8600000US24323,729,298,431,67692,64648,11112,24323
8600000US24324,1336,637,699,64886,76244,12643,24324
8600000US24325,786,405,381,35759,49354,16296,24325
8600000US24326,1088,539,549,37917,48372,7663,24326
8600000US24328,1389,693,696,43914,78844,53189,24328
8600000US24330,2537,1228,1309,32083,41159,4579,24330
8600000US24333,14030,6773,7257,36227,52820,5203,24333
8600000US24340,4647,2215,2432,50067,59412,5158,24340
8600000US24343,7817,3921,3896,43528,53760,5328,24343
8600000US24347,1387,730,657,52321,59229,8702,24347
8600000US24348,3720,2035,1685,34282,44771,5068,24348
8600000US24350,1150,569,581,43717,61179,27440,24350
8600000US24351,477,254,223,17014,30302,9669,24351
8600000US24352,1034,314,720,42770,50754,14955,24352
8600000US24354,11686,5719,5967,40124,53512,5231,24354
8600000US24360,4818,2411,2407,51985,70678,15709,24360
8600000US24361,5027,2422,2605,53688,61561,5414,24361
8600000US24363,1135,582,553,31141,62372,29684,24363
8600000US24366,540,279,261,47250,64046,25369,24366
8600000US24368,4207,2120,2087,47019,61464,7217,24368
8600000US24370,5082,2491,2591,31405,47172,6722,24370
8600000US24374,593,277,316,40119,49607,11147,24374
8600000US24375,1272,619,653,46307,50547,7481,24375
8600000US24377,277,137,140,51324,49018,10353,24377
8600000US24378,939,458,481,26833,33945,4414,24378
8600000US24380,2077,1046,1031,45264,52889,10320,24380
8600000US24381,3094,1512,1582,55682,75391,19579,24381
8600000US24382,10936,5173,5763,45911,62179,6935,24382
8600000US24401,28914,13109,15805,49926,70199,4600,24401
8600000US24411,70,36,34,,,,24411
8600000US24412,25,11,14,,,,24412
8600000US24413,161,70,91,47266,63586,19817,24413
8600000US24415,32,16,16,,,,24415
8600000US24416,7162,3277,3885,40220,56699,5759,24416
8600000US24421,3207,1655,1552,69629,76951,7346,24421
8600000US24422,4729,2249,2480,40392,51311,3764,24422
8600000US24426,11012,5275,5737,48821,63742,4413,24426
8600000US24430,3382,2717,665,31957,43858,7269,24430
8600000US24431,1858,744,1114,50208,63268,13393,24431
8600000US24432,260,129,131,57778,76570,22891,24432
8600000US24433,73,36,37,47000,45212,9032,24433
8600000US24435,1824,897,927,57431,85159,21818,24435
8600000US24437,462,233,229,,58318,18597,24437
8600000US24439,933,497,436,36528,62827,24303,24439
8600000US24440,2705,1422,1283,65333,59424,6928,24440
8600000US24441,5026,2377,2649,56563,65302,6152,24441
8600000US24442,86,34,52,25625,35270,15350,24442
8600000US24445,2321,1166,1155,46574,58935,11586,24445
8600000US24448,210,111,99,31563,43978,7635,24448
8600000US24450,13886,7456,6430,53773,76490,7643,24450
8600000US24457,236,165,71,17000,28817,14340,24457
8600000US24458,328,185,143,37279,54869,18862,24458
8600000US24459,433,308,125,73285,67037,15300,24459
8600000US24460,1170,581,589,36636,53279,14244,24460
8600000US24464,126,56,70,55804,78106,43300,24464
8600000US24465,1203,592,611,48173,67199,10736,24465
8600000US24467,1775,857,918,90147,101002,15004,24467
8600000US24471,1352,690,662,61458,77070,18170,24471
8600000US24472,1563,776,787,30795,48473,10638,24472
8600000US24473,947,495,452,32255,59768,19561,24473
8600000US24474,360,194,166,49531,50150,12492,24474
8600000US24476,127,42,85,69643,78540,24917,24476
8600000US24477,8623,4194,4429,60013,67429,4555,24477
8600000US24479,1189,630,559,54519,77795,18965,24479
8600000US24482,4441,2370,2071,54600,73400,15260,24482
8600000US24483,447,247,200,55583,73897,41268,24483
8600000US24484,468,235,233,45000,110164,93845,24484
8600000US24485,209,110,99,41250,43177,11324,24485
8600000US24486,2677,1181,1496,60478,66688,7225,24486
8600000US24487,288,133,155,60293,60079,18548,24487
8600000US24501,21275,9377,11898,33969,44629,3789,24501
8600000US24502,37871,17747,20124,49864,61643,2504,24502
8600000US24503,15403,7194,8209,71810,95158,7018,24503
8600000US24504,8062,3890,4172,40429,56263,6805,24504
8600000US24517,4200,1902,2298,39962,57491,8114,24517
8600000US24520,1817,838,979,55385,61199,10419,24520
8600000US24521,8253,4042,4211,54012,64306,5226,24521
8600000US24522,7259,3364,3895,52292,63575,4479,24522
8600000US24523,16157,7629,8528,51255,60701,3524,24523
8600000US24526,1119,530,589,68482,78675,12084,24526
8600000US24527,2671,1358,1313,56111,64300,9982,24527
8600000US24528,2669,1169,1500,43074,48471,4991,24528
8600000US24529,1753,905,848,36546,50647,9071,24529
8600000US24530,970,457,513,44981,49454,8374,24530
8600000US24531,7105,3934,3171,48109,66014,8964,24531
8600000US24534,1160,568,592,40714,45064,6793,24534
8600000US24536,128,56,72,74643,86278,20818,24536
8600000US24538,4089,2149,1940,61461,83242,24333,24538
8600000US24539,121,57,64,,39635,15969,24539
8600000US24540,24329,10970,13359,39847,53349,3800,24540
8600000US24541,21562,9992,11570,38424,55031,2411,24541
8600000US24549,3113,1611,1502,51360,56794,5687,24549
8600000US24550,6124,2986,3138,57067,81470,10577,24550
8600000US24551,19131,9303,9828,78355,95083,6285,24551
8600000US24553,1138,632,506,43306,49417,8148,24553
8600000US24554,3077,1505,1572,44115,59042,11509,24554
8600000US24555,1913,946,967,42315,58582,8870,24555
8600000US24556,2463,1156,1307,60417,81558,13938,24556
8600000US24557,6053,2772,3281,38506,47608,3296,24557
8600000US24558,5012,2425,2587,37542,55251,5923,24558
8600000US24562,352,151,201,51719,47816,14110,24562
8600000US24563,4478,2129,2349,43333,53272,4465,24563
8600000US24565,773,353,420,34813,44980,11528,24565
8600000US24566,981,400,581,60452,57528,10228,24566
8600000US24569,751,386,365,43864,77951,42371,24569
8600000US24570,6,0,6,,,,24570
8600000US24571,1598,780,818,56351,75899,15843,24571
8600000US24572,13000,5903,7097,45077,58840,3453,24572
8600000US24574,3294,1781,1513,54922,69819,9170,24574
8600000US24577,3493,1730,1763,31691,48405,8418,24577
8600000US24578,806,350,456,51532,66910,25265,24578
8600000US24579,1158,534,624,48125,56614,9656,24579
8600000US24580,382,202,180,63718,65500,12741,24580
8600000US24581,44,0,44,,,,24581
8600000US24586,4612,2042,2570,45592,54786,6496,24586
8600000US24588,7885,4028,3857,45389,59888,5663,24588
8600000US24589,2329,1166,1163,48977,61512,8337,24589
8600000US24590,5945,2927,3018,59508,74377,7905,24590
8600000US24592,10817,4785,6032,42676,51522,4603,24592
8600000US24593,1670,872,798,65855,84814,25892,24593
8600000US24594,1164,536,628,36150,47331,8657,24594
8600000US24595,612,59,553,103750,108930,47433,24595
8600000US24597,864,385,479,61140,67255,12547,24597
8600000US24598,1426,771,655,56167,60061,9227,24598
8600000US24599,829,461,368,67674,63954,13665,24599
8600000US24601,25,14,11,,,,24601
8600000US24602,525,235,290,35804,51386,25004,24602
8600000US24603,605,326,279,24232,34469,10240,24603
8600000US24604,192,74,118,17500,16640,3056,24604
8600000US24605,7252,3447,3805,42021,63964,10925,24605
8600000US24606,135,64,71,,42873,31399,24606
8600000US24607,253,106,147,36250,42453,9570,24607
8600000US24609,5722,2685,3037,43211,57464,4785,24609
8600000US24612,180,86,94,,22084,8782,24612
8600000US24613,541,226,315,45188,39539,10014,24613
8600000US24614,6080,2840,3240,35201,47042,5266,24614
8600000US24620,2148,1032,1116,20564,31989,4684,24620
8600000US24622,739,404,335,29028,49656,20153,24622
8600000US24628,287,168,119,,43128,33883,24628
8600000US24630,5681,2833,2848,43313,59629,9606,24630
8600000US24631,2151,1315,836,39205,51547,8992,24631
8600000US24634,390,150,240,37604,44896,13348,24634
8600000US24635,1365,1152,213,24018,36293,7943,24635
8600000US24637,2900,1483,1417,52946,68477,12695,24637
8600000US24639,2537,1116,1421,32092,45299,8229,24639
8600000US24641,4321,2019,2302,31119,44866,4983,24641
8600000US24646,710,386,324,25625,37184,8634,24646
8600000US24649,2351,1199,1152,41318,52823,11981,24649
8600000US24651,4316,2141,2175,47820,61069,8435,24651
8600000US24656,2356,1251,1105,34668,50691,8851,24656
8600000US24657,268,126,142,38203,39230,11148,24657
8600000US24701,15665,7194,8471,33332,44440,3333,24701
8600000US24712,1910,988,922,34293,52760,11982,24712
8600000US24714,218,108,110,38333,35243,8785,24714
8600000US24715,381,207,174,27375,39166,7895,24715
8600000US24716,363,143,220,58606,59783,24495,24716
8600000US24719,25,13,12,,,,24719
8600000US24724,100,64,36,53846,52215,10493,24724
8600000US24726,464,242,222,23073,52651,25923,24726
8600000US24729,133,75,58,26813,39579,23766,24729
8600000US24731,212,105,107,43667,39834,15096,24731
8600000US24733,469,236,233,47656,47528,11713,24733
8600000US24736,434,229,205,32563,37973,8113,24736
8600000US24737,89,55,34,,33516,32822,24737
8600000US24738,202,105,97,72688,60150,15001,24738
8600000US24740,24401,11314,13087,43245,55911,3247,24740
8600000US24747,2290,1043,1247,31132,45475,9656,24747
8600000US24801,3861,2455,1406,29219,43054,5780,24801
8600000US24808,451,169,282,37500,44108,10092,24808
8600000US24811,500,258,242,30990,68665,52510,24811
8600000US24813,163,46,117,23778,24909,11893,24813
8600000US24815,550,259,291,26053,33546,9047,24815
8600000US24816,148,74,74,39429,43400,14635,24816
8600000US24817,643,306,337,20260,44102,25252,24817
8600000US24818,697,343,354,24143,39532,10286,24818
8600000US24822,600,293,307,37404,46542,14040,24822
8600000US24823,339,168,171,36184,38419,11989,24823
8600000US24826,80,41,39,,16885,8106,24826
8600000US24827,1016,507,509,50885,46555,7198,24827
8600000US24828,594,271,323,20089,28691,6065,24828
8600000US24830,111,49,62,,27268,18401,24830
8600000US24831,96,59,37,31250,35509,11721,24831
8600000US24834,303,175,128,,37883,16409,24834
8600000US24836,497,207,290,39375,48265,8980,24836
8600000US24839,1385,703,682,50596,57802,12314,24839
8600000US24843,56,30,26,,,,24843
8600000US24844,1088,529,559,17357,31396,8323,24844
8600000US24845,170,58,112,,58108,46159,24845
8600000US24846,55,23,32,,,,24846
8600000US24847,271,158,113,,54253,38564,24847
8600000US24848,121,65,56,24167,37122,13248,24848
8600000US24849,156,76,80,43587,49583,20502,24849
8600000US24850,433,216,217,23482,28868,9280,24850
8600000US24851,425,213,212,31250,33770,7018,24851
8600000US24853,364,182,182,40278,49118,13848,24853
8600000US24854,144,85,59,,165618,106280,24854
8600000US24857,753,388,365,43304,52476,17364,24857
8600000US24860,247,115,132,24964,34388,14164,24860
8600000US24861,104,62,42,,27255,15202,24861
8600000US24862,493,215,278,13606,18378,7535,24862
8600000US24866,201,93,108,40139,49878,17780,24866
8600000US24867,392,143,249,23417,32628,15108,24867
8600000US24868,855,428,427,23589,32720,6241,24868
8600000US24869,312,111,201,21042,29233,12897,24869
8600000US24870,2072,1098,974,37892,46144,7432,24870
8600000US24871,185,126,59,31250,35946,12509,24871
8600000US24872,402,250,152,23025,22345,5899,24872
8600000US24873,460,190,270,41979,52466,18662,24873
8600000US24874,2668,1259,1409,50953,64711,8697,24874
8600000US24878,423,191,232,26210,23987,5883,24878
8600000US24879,588,254,334,19968,27387,6903,24879
8600000US24880,120,36,84,,35540,18947,24880
8600000US24881,268,150,118,32350,29357,5648,24881
8600000US24882,273,183,90,28869,27359,10343,24882
8600000US24884,193,58,135,39688,32443,9286,24884
8600000US24887,26,16,10,,,,24887
8600000US24888,63,27,36,24375,30028,19966,24888
8600000US24892,987,403,584,30595,39567,9551,24892
8600000US24894,292,132,160,24254,26599,7023,24894
8600000US24898,58,27,31,,,,24898
8600000US24901,7930,3812,4118,41044,61813,8898,24901
8600000US24910,4305,1574,2731,35959,49064,7630,24910
8600000US24915,418,213,205,32457,51387,13630,24915
8600000US24916,602,222,380,53333,55554,12996,24916
8600000US24918,1553,867,686,49205,52075,8656,24918
8600000US24920,194,105,89,,38398,22447,24920
8600000US24924,401,227,174,37760,42321,11643,24924
8600000US24925,554,332,222,,53154,20020,24925
8600000US24927,141,85,56,30893,38679,14114,24927
8600000US24931,996,501,495,27059,48461,15415,24931
8600000US24934,293,182,111,28403,40556,13616,24934
8600000US24935,364,188,176,36364,47672,14381,24935
8600000US24938,1169,488,681,67780,67908,12965,24938
8600000US24941,840,457,383,37115,52213,9594,24941
8600000US24944,350,152,198,34271,43553,9496,24944
8600000US24945,289,167,122,31250,69264,51390,24945
8600000US24946,1286,744,542,43659,59627,16678,24946
8600000US24951,1322,657,665,48611,58221,13148,24951
8600000US24954,3196,1510,1686,37234,57253,11395,24954
8600000US24957,198,105,93,107857,114865,41973,24957
8600000US24962,53,16,37,,,,24962
8600000US24963,2956,1375,1581,43480,54502,8326,24963
8600000US24966,1337,632,705,32061,40526,6025,24966
8600000US24970,3515,1940,1575,38731,60013,19035,24970
8600000US24974,307,178,129,37381,80674,62344,24974
8600000US24976,1002,402,600,37450,51175,11993,24976
8600000US24977,472,249,223,48920,56350,18400,24977
8600000US24981,386,204,182,36020,41628,10509,24981
8600000US24983,2060,1057,1003,31008,43550,7918,24983
8600000US24984,154,94,60,,24885,15258,24984
8600000US24986,4292,1852,2440,37353,42909,4183,24986
8600000US24991,564,289,275,49504,65333,24054,24991
8600000US25002,0,0,0,,,,25002
8600000US25003,2038,898,1140,37224,54607,10715,25003
8600000US25005,141,66,75,62273,56159,23255,25005
8600000US25007,512,277,235,48553,55789,16068,25007
8600000US25008,123,60,63,35655,40712,17981,25008
8600000US25009,1030,581,449,28704,46773,9055,25009
8600000US25011,528,266,262,39435,53431,10689,25011
8600000US25015,3585,1649,1936,48125,58915,6967,25015
8600000US25019,531,262,269,32581,34329,8215,25019
8600000US25021,188,93,95,34500,36587,17147,25021
8600000US25022,306,122,184,29613,33603,12828,25022
8600000US25024,269,116,153,35750,40076,15333,25024
8600000US25025,122,60,62,,,,25025
8600000US25028,302,133,169,19167,26332,11191,25028
8600000US25030,267,162,105,50714,45864,11101,25030
8600000US25031,438,241,197,32250,48586,15319,25031
8600000US25033,1526,793,733,48149,56491,8731,25033
8600000US25035,983,557,426,19932,26384,6329,25035
8600000US25036,156,64,92,58000,47109,14465,25036
8600000US25039,638,287,351,45125,47819,11665,25039
8600000US25040,393,179,214,46917,52735,12594,25040
8600000US25043,1018,511,507,47857,46779,7769,25043
8600000US25044,239,107,132,39327,36076,9716,25044
8600000US25045,3909,1934,1975,40179,51391,7058,25045
8600000US25047,91,23,68,,32402,20903,25047
8600000US25048,44,33,11,,14706,7179,25048
8600000US25049,381,172,209,,60127,15003,25049
8600000US25051,223,110,113,,64518,22631,25051
8600000US25053,3527,1684,1843,36471,55659,10105,25053
8600000US25054,425,178,247,,55683,32845,25054
8600000US25057,342,186,156,48902,50939,9918,25057
8600000US25059,419,243,176,27986,54630,20714,25059
8600000US25060,335,140,195,34297,39246,12230,25060
8600000US25061,624,225,399,62716,51701,15020,25061
8600000US25062,120,45,75,28250,37653,13684,25062
8600000US25063,1335,634,701,33848,44677,7517,25063
8600000US25064,7870,3594,4276,42885,52704,3170,25064
8600000US25067,1006,528,478,48125,52963,9965,25067
8600000US25070,1145,494,651,51786,56805,8607,25070
8600000US25071,9058,4625,4433,43776,61962,6865,25071
8600000US25075,623,260,363,37628,40822,12282,25075
8600000US25076,312,130,182,,33315,12278,25076
8600000US25081,839,378,461,57379,105677,44331,25081
8600000US25082,1192,611,581,44595,68977,16818,25082
8600000US25083,551,295,256,43250,44653,10795,25083
8600000US25085,720,345,375,39375,38121,5815,25085
8600000US25086,599,259,340,44091,59957,13382,25086
8600000US25088,130,69,61,,19603,6689,25088
8600000US25090,151,80,71,,51217,31587,25090
8600000US25093,190,85,105,18750,23072,8837,25093
8600000US25102,151,54,97,34250,48760,13621,25102
8600000US25103,149,67,82,,44400,24960,25103
8600000US25106,449,230,219,19926,33053,8954,25106
8600000US25107,430,185,245,51591,53835,16230,25107
8600000US25108,354,141,213,23672,35958,18088,25108
8600000US25109,492,208,284,,83082,45202,25109
8600000US25110,312,99,213,32019,45019,17608,25110
8600000US25111,526,302,224,21573,42108,17174,25111
8600000US25112,105,47,58,,,,25112
8600000US25113,620,337,283,35729,53110,19768,25113
8600000US25114,334,184,150,,31269,15560,25114
8600000US25115,81,47,34,29485,31768,2981,25115
8600000US25118,624,349,275,45368,53427,13927,25118
8600000US25119,136,68,68,48472,41662,11361,25119
8600000US25121,613,338,275,28295,45128,14122,25121
8600000US25123,2739,1401,1338,38553,52337,7819,25123
8600000US25124,1194,643,551,67661,70144,15069,25124
8600000US25125,816,420,396,39609,47374,10467,25125
8600000US25126,25,12,13,,,,25126
8600000US25130,2599,1328,1271,40945,55865,7777,25130
8600000US25132,80,35,45,,57178,26453,25132
8600000US25133,640,256,384,23036,32224,9035,25133
8600000US25134,274,149,125,,68202,28742,25134
8600000US25136,1570,816,754,24357,40888,6117,25136
8600000US25139,265,124,141,,75118,35435,25139
8600000US25140,1038,543,495,23547,30566,6591,25140
8600000US25141,120,44,76,,21925,7532,25141
8600000US25142,297,141,156,41111,38725,15807,25142
8600000US25143,6399,2889,3510,43665,66591,13148,25143
8600000US25148,462,288,174,44688,42869,12253,25148
8600000US25149,230,109,121,38661,42908,13606,25149
8600000US25152,231,127,104,27222,44870,25579,25152
8600000US25154,438,195,243,24306,37007,11060,25154
8600000US25156,171,84,87,26806,25454,9463,25156
8600000US25159,3972,1806,2166,55036,63875,8309,25159
8600000US25160,90,44,46,,18468,11625,25160
8600000US25161,344,194,150,59722,51359,11024,25161
8600000US25162,329,147,182,55313,76327,13836,25162
8600000US25164,997,477,520,42756,49758,10518,25164
8600000US25165,530,266,264,77361,68754,14930,25165
8600000US25168,1862,862,1000,49524,60152,8656,25168
8600000US25169,347,197,150,44115,52324,15429,25169
8600000US25173,335,146,189,24297,30713,12091,25173
8600000US25174,407,248,159,52375,65301,22471,25174
8600000US25177,18315,8557,9758,43415,58017,4007,25177
8600000US25180,82,18,64,,50986,28661,25180
8600000US25181,944,507,437,40625,56387,17785,25181
8600000US25183,44,25,19,,,,25183
8600000US25185,870,870,0,,,,25185
8600000US25186,826,363,463,36563,46723,10874,25186
8600000US25187,514,223,291,,45696,17864,25187
8600000US25193,425,197,228,38929,44891,8392,25193
8600000US25201,17,0,17,,,,25201
8600000US25202,964,396,568,45208,65498,18677,25202
8600000US25203,37,27,10,,,,25203
8600000US25204,121,32,89,,40805,17060,25204
8600000US25205,413,213,200,26667,32044,6539,25205
8600000US25206,349,145,204,62813,59845,18440,25206
8600000US25208,666,371,295,39598,52646,12581,25208
8600000US25209,1013,484,529,36125,59475,16852,25209
8600000US25211,184,113,71,,26039,12624,25211
8600000US25213,4739,2341,2398,72092,98853,19066,25213
8600000US25214,349,145,204,53750,56440,15509,25214
8600000US25234,924,399,525,37702,47973,12015,25234
8600000US25235,915,505,410,18355,40907,17219,25235
8600000US25239,1649,852,797,41068,52234,9186,25239
8600000US25241,1472,814,658,85451,86601,12295,25241
8600000US25243,452,224,228,28881,41717,18216,25243
8600000US25244,501,292,209,46953,46606,13921,25244
8600000US25245,481,206,275,46964,50286,15034,25245
8600000US25247,483,239,244,40313,43749,7250,25247
8600000US25248,2455,1122,1333,61250,82640,16012,25248
8600000US25251,184,114,70,36429,59216,24870,25251
8600000US25252,1078,512,566,67454,72566,16050,25252
8600000US25253,1673,872,801,51574,62251,7972,25253
8600000US25259,537,281,256,47500,56560,14386,25259
8600000US25260,1133,489,644,29766,40285,7497,25260
8600000US25261,195,83,112,19479,29429,10521,25261
8600000US25262,682,300,382,47827,51232,12279,25262
8600000US25264,239,128,111,30750,37407,11733,25264
8600000US25265,1284,684,600,38179,51154,9343,25265
8600000US25266,455,232,223,38309,48620,13312,25266
8600000US25267,495,294,201,32794,36638,7234,25267
8600000US25268,664,336,328,,44479,10762,25268
8600000US25270,678,370,308,36544,63913,19893,25270
8600000US25271,7398,3586,3812,39716,59769,7308,25271
8600000US25275,1815,944,871,45972,53285,7417,25275
8600000US25276,6122,3007,3115,32392,48740,4858,25276
8600000US25285,380,145,235,47423,61289,11728,25285
8600000US25286,1129,630,499,32625,47067,10849,25286
8600000US25287,1133,365,768,31771,44866,16810,25287
8600000US25301,2277,1130,1147,22632,49560,8992,25301
8600000US25302,11532,5635,5897,40145,57033,3982,25302
8600000US25303,5365,2486,2879,52500,66516,6666,25303
8600000US25304,6984,3171,3813,54187,95621,11493,25304
8600000US25305,0,0,0,,,,25305
8600000US25306,5643,2872,2771,47931,57241,5730,25306
8600000US25309,10757,4932,5825,51391,74134,8310,25309
8600000US25311,8679,4204,4475,40670,62290,8374,25311
8600000US25312,11635,5753,5882,38311,51362,5463,25312
8600000US25313,9321,4719,4602,53234,71670,8414,25313
8600000US25314,10669,4995,5674,77862,114393,10281,25314
8600000US25315,2723,1194,1529,38319,45547,4372,25315
8600000US25320,5339,2589,2750,47171,59206,8231,25320
8600000US25401,10821,4597,6224,41449,50860,4364,25401
8600000US25403,9560,4861,4699,73024,81511,5211,25403
8600000US25404,16315,7889,8426,54641,68373,4486,25404
8600000US25405,10596,5087,5509,72636,83923,8527,25405
8600000US25411,10623,5249,5374,51426,68129,9750,25411
8600000US25413,6672,3362,3310,63000,73939,5559,25413
8600000US25414,13650,6554,7096,81619,93576,4119,25414
8600000US25419,8761,4387,4374,67630,78705,5770,25419
8600000US25420,3220,1706,1514,69801,87724,13796,25420
8600000US25422,1446,730,716,34250,55779,13299,25422
8600000US25425,10455,5242,5213,81148,93732,4172,25425
8600000US25427,11126,5471,5655,61076,73719,5066,25427
8600000US25428,9730,5094,4636,64639,71235,5027,25428
8600000US25430,6323,3061,3262,72197,90329,8840,25430
8600000US25431,183,96,87,,56950,30606,25431
8600000US25432,121,44,77,36042,40415,10210,25432
8600000US25434,2248,1167,1081,44196,59595,11183,25434
8600000US25437,285,153,132,,53246,25272,25437
8600000US25438,5168,2445,2723,58429,73289,7829,25438
8600000US25442,1397,690,707,60238,83588,15104,25442
8600000US25443,6559,3287,3272,95117,107844,8603,25443
8600000US25444,182,90,92,,81004,51524,25444
8600000US25446,1032,475,557,120833,118680,24640,25446
8600000US25501,970,475,495,48622,56029,14101,25501
8600000US25502,980,379,601,54180,52692,14810,25502
8600000US25503,1184,532,652,51971,52832,15015,25503
8600000US25504,10503,5276,5227,48908,67744,6879,25504
8600000US25505,344,164,180,45658,44350,15543,25505
8600000US25506,3709,1970,1739,29144,43314,6212,25506
8600000US25507,680,282,398,38214,51892,13621,25507
8600000US25508,7117,3509,3608,42273,57756,7856,25508
8600000US25510,3708,1826,1882,56738,64508,8350,25510
8600000US25511,801,300,501,,38742,9227,25511
8600000US25512,756,384,372,29335,32217,7455,25512
8600000US25514,2664,1229,1435,31393,41188,5632,25514
8600000US25515,1667,844,823,39508,49736,7232,25515
8600000US25517,1307,681,626,21938,37035,9998,25517
8600000US25520,1250,589,661,51722,56599,13800,25520
8600000US25521,587,323,264,45938,49711,14081,25521
8600000US25523,2537,1194,1343,29125,39577,5135,25523
8600000US25524,2570,1284,1286,42731,52118,9901,25524
8600000US25526,17316,8246,9070,62735,83848,4866,25526
8600000US25529,656,275,381,,36558,9038,25529
8600000US25530,4598,2192,2406,39087,50448,6052,25530
8600000US25534,212,133,79,,25733,15835,25534
8600000US25535,2287,1234,1053,62708,91444,24341,25535
8600000US25537,1195,514,681,41891,46294,7940,25537
8600000US25540,105,35,70,14188,15773,3736,25540
8600000US25541,7897,3871,4026,43768,62148,6406,25541
8600000US25545,3633,1800,1833,62898,78516,9040,25545
8600000US25547,727,357,370,,42952,26006,25547
8600000US25550,6644,3043,3601,47136,55829,6035,25550
8600000US25555,1484,776,708,31500,52332,10580,25555
8600000US25557,1348,601,747,29250,36862,6972,25557
8600000US25559,1520,687,833,46639,57831,8163,25559
8600000US25560,6635,3341,3294,80019,89316,8107,25560
8600000US25564,1014,536,478,61151,57309,15766,25564
8600000US25565,387,215,172,36094,38643,8304,25565
8600000US25567,615,218,397,39896,106709,97337,25567
8600000US25570,4700,2276,2424,26534,40687,8825,25570
8600000US25571,1591,751,840,41458,54740,10678,25571
8600000US25573,824,343,481,,30719,9879,25573
8600000US25601,4270,2043,2227,47950,59216,5440,25601
8600000US25606,1061,449,612,38065,65284,21643,25606
8600000US25607,924,519,405,28494,42939,9568,25607
8600000US25608,859,467,392,36603,45789,7723,25608
8600000US25611,802,438,364,46573,53835,15794,25611
8600000US25617,522,193,329,38073,52728,13142,25617
8600000US25621,1457,685,772,24948,42766,6938,25621
8600000US25624,158,73,85,,56849,42046,25624
8600000US25625,1171,819,352,45550,54184,16099,25625
8600000US25628,179,72,107,22455,32616,15063,25628
8600000US25630,496,261,235,38250,61698,34782,25630
8600000US25632,271,131,140,18468,52755,50312,25632
8600000US25634,277,146,131,34015,41713,13627,25634
8600000US25635,1152,579,573,51379,64959,20595,25635
8600000US25637,658,342,316,26683,34845,8612,25637
8600000US25638,781,329,452,56637,54396,10658,25638
8600000US25639,298,158,140,22500,42029,29303,25639
8600000US25644,386,188,198,26645,41682,25911,25644
8600000US25646,781,352,429,30181,40393,11414,25646
8600000US25647,642,237,405,33056,35964,14666,25647
8600000US25649,1219,571,648,50709,50362,8618,25649
8600000US25650,285,134,151,28869,42140,11193,25650
8600000US25651,647,331,316,22679,30817,8976,25651
8600000US25652,1122,541,581,41289,51867,14168,25652
8600000US25653,296,156,140,41397,46248,11822,25653
8600000US25654,225,123,102,,48325,16739,25654
8600000US25661,4681,2072,2609,30144,48893,8552,25661
8600000US25666,468,224,244,,38479,13234,25666
8600000US25669,910,509,401,26550,34510,8247,25669
8600000US25670,4233,2047,2186,38024,49210,5380,25670
8600000US25671,986,465,521,36528,45967,10494,25671
8600000US25672,311,149,162,20132,26648,9415,25672
8600000US25674,2178,1017,1161,27273,36639,4746,25674
8600000US25676,948,408,540,32401,56629,23596,25676
8600000US25678,1171,559,612,25143,37987,9033,25678
8600000US25688,262,131,131,50795,47054,16096,25688
8600000US25690,229,120,109,36172,52634,24410,25690
8600000US25692,855,483,372,14913,29272,6874,25692
8600000US25696,145,53,92,41196,34885,10204,25696
8600000US25699,78,18,60,,28505,22065,25699
8600000US25701,17546,8715,8831,36022,58639,4307,25701
8600000US25702,5821,2993,2828,25720,39224,3687,25702
8600000US25703,6434,2933,3501,16884,24497,3052,25703
8600000US25704,12881,5951,6930,37411,54423,4520,25704
8600000US25705,16887,7987,8900,39867,59206,4703,25705
8600000US25801,25708,12039,13669,43066,59158,4835,25801
8600000US25810,208,117,91,38781,33458,10951,25810
8600000US25811,41,10,31,,,,25811
8600000US25812,1374,761,613,36458,43757,5441,25812
8600000US25813,6592,3997,2595,45339,59723,6432,25813
8600000US25817,787,487,300,53698,54591,11852,25817
8600000US25818,400,131,269,,35372,16536,25818
8600000US25820,366,177,189,36292,42973,10167,25820
8600000US25823,1881,800,1081,33045,38712,7762,25823
8600000US25825,1877,980,897,66111,84403,29425,25825
8600000US25826,330,147,183,,55055,38034,25826
8600000US25827,1614,774,840,43686,45588,7096,25827
8600000US25831,1520,728,792,51801,59763,7891,25831
8600000US25832,3213,1565,1648,70758,111281,18025,25832
8600000US25836,466,312,154,25437,22473,6866,25836
8600000US25837,237,124,113,42109,51935,21732,25837
8600000US25839,474,149,325,,38818,14568,25839
8600000US25840,6336,2996,3340,44414,56700,6846,25840
8600000US25841,276,142,134,34494,50924,15231,25841
8600000US25843,682,337,345,,58589,21677,25843
8600000US25844,993,518,475,41371,54666,11942,25844
8600000US25845,464,199,265,42813,41605,10649,25845
8600000US25846,305,130,175,,39250,14256,25846
8600000US25848,203,96,107,50526,41016,14886,25848
8600000US25849,238,129,109,33636,33520,8142,25849
8600000US25853,13,13,0,,,,25853
8600000US25854,809,395,414,51019,78343,30654,25854
8600000US25855,168,106,62,,,,25855
8600000US25857,43,29,14,,,,25857
8600000US25862,81,56,25,,140550,146041,25862
8600000US25864,235,148,87,37574,39128,15472,25864
8600000US25865,1065,529,536,46890,58613,11717,25865
8600000US25868,347,150,197,52031,60772,11744,25868
8600000US25870,47,14,33,,,,25870
8600000US25871,487,247,240,28472,36614,8941,25871
8600000US25873,414,231,183,39458,58140,21540,25873
8600000US25875,503,266,237,41536,51964,27875,25875
8600000US25876,79,40,39,,156820,125528,25876
8600000US25878,535,320,215,39196,40435,9748,25878
8600000US25879,232,109,123,41743,44239,16080,25879
8600000US25880,4971,2223,2748,35534,44632,4477,25880
8600000US25882,1608,745,863,44167,51394,5114,25882
8600000US25901,8860,4227,4633,36260,48549,4033,25901
8600000US25902,73,22,51,35625,30602,13423,25902
8600000US25904,365,200,165,,56253,29458,25904
8600000US25906,378,187,191,37833,63278,25463,25906
8600000US25907,42,21,21,,,,25907
8600000US25908,102,51,51,53289,60314,12842,25908
8600000US25911,60,39,21,,,,25911
8600000US25913,190,99,91,40729,44764,29189,25913
8600000US25915,138,68,70,,26641,15449,25915
8600000US25916,194,110,84,,15176,12515,25916
8600000US25917,1415,661,754,26935,33221,5436,25917
8600000US25918,3613,1902,1711,53254,63310,7581,25918
8600000US25920,237,133,104,75329,70158,16740,25920
8600000US25921,1662,734,928,27257,39397,7343,25921
8600000US25922,188,105,83,51964,55145,10126,25922
8600000US25928,350,155,195,29188,41870,14691,25928
8600000US25932,261,142,119,75966,66579,21489,25932
8600000US25936,48,45,3,85714,80670,14269,25936
8600000US25938,1062,521,541,72863,79341,15682,25938
8600000US25942,193,140,53,45556,48659,18762,25942
8600000US25951,4814,2379,2435,35065,47691,4682,25951
8600000US25958,566,359,207,32303,42838,12589,25958
8600000US25962,2814,1367,1447,35816,42866,4967,25962
8600000US25969,871,468,403,37969,52848,13494,25969
8600000US25971,740,357,383,75300,69057,17905,25971
8600000US25972,171,97,74,31250,27410,13985,25972
8600000US25976,2212,994,1218,43229,50190,7592,25976
8600000US25977,171,74,97,,44871,33286,25977
8600000US25978,428,192,236,41927,53953,20806,25978
8600000US25979,625,286,339,32342,40746,8976,25979
8600000US25981,380,187,193,27927,33160,9969,25981
8600000US25984,1061,561,500,36726,41427,5613,25984
8600000US25985,428,157,271,33542,42260,12425,25985
8600000US25989,205,103,102,,110924,45866,25989
8600000US26003,33275,15905,17370,48810,70337,3493,26003
8600000US26030,443,204,239,49375,54232,7735,26030
8600000US26031,1378,697,681,35714,45767,5348,26031
8600000US26032,1101,591,510,65250,70701,10920,26032
8600000US26033,1886,839,1047,34129,49266,9398,26033
8600000US26034,3542,1550,1992,45214,48153,4678,26034
8600000US26035,1709,728,981,53833,57997,8542,26035
8600000US26036,442,255,187,135294,134685,38859,26036
8600000US26037,5171,2588,2583,52404,58595,4470,26037
8600000US26038,2532,1259,1273,57411,84483,20842,26038
8600000US26039,693,310,383,58750,76789,26248,26039
8600000US26040,1601,854,747,37273,59522,14873,26040
8600000US26041,12687,6153,6534,40374,51010,3697,26041
8600000US26047,5151,2603,2548,49755,63969,4810,26047
8600000US26050,1210,564,646,26023,33388,7853,26050
8600000US26055,1089,555,534,48750,69492,21575,26055
8600000US26056,99,44,55,74211,77991,12845,26056
8600000US26059,2052,978,1074,63466,81504,11347,26059
8600000US26060,1569,858,711,60000,67313,9841,26060
8600000US26062,17014,8228,8786,49088,61311,2928,26062
8600000US26070,6779,3212,3567,46905,56558,4136,26070
8600000US26074,1172,552,620,51705,52295,8923,26074
8600000US26075,249,123,126,41429,54345,13921,26075
8600000US26101,23024,10945,12079,34259,49617,3785,26101
8600000US26104,12869,6107,6762,45363,61442,4075,26104
8600000US26105,9376,4406,4970,53609,76198,6158,26105
8600000US26133,1193,567,626,46489,61111,10422,26133
8600000US26134,829,422,407,38500,53131,6857,26134
8600000US26136,611,359,252,,51234,15214,26136
8600000US26137,486,236,250,58438,57980,17277,26137
8600000US26138,95,31,64,,26629,17288,26138
8600000US26141,286,132,154,,45995,16108,26141
8600000US26142,1889,1002,887,53919,79270,32567,26142
8600000US26143,3712,1880,1832,41066,52289,5472,26143
8600000US26146,785,374,411,,75612,35436,26146
8600000US26147,1489,724,765,45948,57688,11564,26147
8600000US26148,234,93,141,,34571,16727,26148
8600000US26149,1566,795,771,37826,53892,10261,26149
8600000US26150,4567,2093,2474,60313,76597,7093,26150
8600000US26151,661,346,315,38388,55367,23937,26151
8600000US26152,109,68,41,,,,26152
8600000US26155,6114,2924,3190,42944,59442,4734,26155
8600000US26159,2656,1295,1361,47125,54118,5741,26159
8600000US26160,577,259,318,36731,44737,8211,26160
8600000US26161,348,193,155,54297,54099,8991,26161
8600000US26164,5867,2721,3146,35000,49903,5028,26164
8600000US26167,860,405,455,34141,56011,13570,26167
8600000US26169,517,272,245,52333,82323,35277,26169
8600000US26170,4861,2714,2147,47108,71143,9674,26170
8600000US26175,3015,1474,1541,40844,65189,15615,26175
8600000US26178,310,159,151,52841,55428,13968,26178
8600000US26180,1906,1025,881,45685,57948,13772,26180
8600000US26181,5236,2543,2693,62446,72841,5985,26181
8600000US26184,1976,878,1098,41779,59475,10340,26184
8600000US26187,5127,2419,2708,67102,82021,6588,26187
8600000US26201,16189,8028,8161,41981,56146,3614,26201
8600000US26202,443,200,243,33299,40959,10846,26202
8600000US26203,89,34,55,,61351,39107,26203
8600000US26205,2651,1267,1384,37928,53533,11345,26205
8600000US26206,2320,1161,1159,22138,35460,6471,26206
8600000US26208,759,426,333,48550,51665,9205,26208
8600000US26209,209,128,81,46750,67114,17554,26209
8600000US26215,36,19,17,,,,26215
8600000US26217,233,108,125,,37964,32834,26217
8600000US26218,2002,956,1046,41117,49032,10624,26218
8600000US26222,461,191,270,,68633,58276,26222
8600000US26224,201,115,86,72000,65661,16683,26224
8600000US26228,18,0,18,,,,26228
8600000US26230,74,38,36,,43895,13909,26230
8600000US26234,1104,518,586,37482,50066,10856,26234
8600000US26236,126,69,57,,,,26236
8600000US26237,405,172,233,36406,42292,10822,26237
8600000US26238,705,366,339,41838,44969,8191,26238
8600000US26241,11134,5192,5942,40828,61382,7486,26241
8600000US26250,4225,2079,2146,39486,54401,6625,26250
8600000US26253,3161,1641,1520,45047,74511,24018,26253
8600000US26254,206,111,95,28542,35505,8635,26254
8600000US26257,1015,535,480,47333,69474,21594,26257
8600000US26259,53,43,10,,,,26259
8600000US26260,1294,652,642,50685,54356,5474,26260
8600000US26261,2120,1054,1066,29317,37884,3866,26261
8600000US26263,287,172,115,,76373,30540,26263
8600000US26264,435,236,199,51500,52396,7816,26264
8600000US26266,124,67,57,,35945,22926,26266
8600000US26267,204,107,97,56923,69819,26593,26267
8600000US26268,36,10,26,,,,26268
8600000US26269,848,430,418,41719,51158,6499,26269
8600000US26270,445,238,207,25625,34682,9383,26270
8600000US26271,305,134,171,42361,56096,14444,26271
8600000US26273,1623,1301,322,42431,56605,16093,26273
8600000US26275,395,161,234,26042,37903,13701,26275
8600000US26276,204,93,111,,56276,17151,26276
8600000US26278,528,267,261,53945,51589,8460,26278
8600000US26280,1372,648,724,33000,37909,3857,26280
8600000US26282,14,14,0,,,,26282
8600000US26283,1312,673,639,47121,54244,9225,26283
8600000US26285,441,263,178,34821,50898,17100,26285
8600000US26287,2498,1212,1286,42273,49735,4112,26287
8600000US26288,2713,1312,1401,38728,49563,6572,26288
8600000US26291,128,53,75,97411,109630,17841,26291
8600000US26292,594,293,301,40000,53516,10298,26292
8600000US26293,456,242,214,48438,50775,13695,26293
8600000US26294,811,380,431,41845,48740,11541,26294
8600000US26296,75,45,30,,,,26296
8600000US26298,83,44,39,28393,30716,11591,26298
8600000US26301,22538,10693,11845,43140,58023,3615,26301
8600000US26320,522,270,252,48889,52440,7923,26320
8600000US26321,202,156,46,26827,35744,9663,26321
8600000US26323,341,171,170,42375,50451,9217,26323
8600000US26325,228,66,162,15083,29977,15330,26325
8600000US26327,37,16,21,,,,26327
8600000US26330,11821,5494,6327,77523,97421,6727,26330
8600000US26335,1251,610,641,52143,53306,9186,26335
8600000US26337,996,477,519,45625,60490,19876,26337
8600000US26338,635,330,305,57019,58625,12941,26338
8600000US26339,195,99,96,,65665,31434,26339
8600000US26342,178,94,84,43026,47788,26052,26342
8600000US26343,197,105,92,26875,34608,13847,26343
8600000US26346,821,398,423,48587,56634,7344,26346
8600000US26347,1668,763,905,51553,63411,9894,26347
8600000US26348,63,30,33,27250,39228,25574,26348
8600000US26349,58,39,19,,,,26349
8600000US26351,4199,2506,1693,32125,45289,4910,26351
8600000US26354,8656,4355,4301,41218,51225,3422,26354
8600000US26361,237,93,144,,44379,22410,26361
8600000US26362,2693,1338,1355,39350,59836,9521,26362
8600000US26366,33,33,0,,,,26366
8600000US26369,597,277,320,41738,79943,40339,26369
8600000US26372,513,275,238,50192,75716,30304,26372
8600000US26374,978,453,525,53173,60387,11153,26374
8600000US26376,443,250,193,24444,30413,9772,26376
8600000US26377,375,200,175,23359,41374,14041,26377
8600000US26378,3296,1675,1621,48478,64352,8066,26378
8600000US26384,573,334,239,31080,45032,12214,26384
8600000US26385,3035,1538,1497,65930,73180,6880,26385
8600000US26386,1796,902,894,43750,55089,7323,26386
8600000US26404,373,160,213,42882,55205,38975,26404
8600000US26405,1032,467,565,55815,62667,15022,26405
8600000US26408,2228,1057,1171,60865,75746,8260,26408
8600000US26410,880,462,418,46779,57252,9628,26410
8600000US26411,743,398,345,64423,73455,25566,26411
8600000US26412,567,268,299,52292,50214,12266,26412
8600000US26415,3123,1806,1317,46788,64812,10820,26415
8600000US26416,6616,3261,3355,34453,55770,6872,26416
8600000US26419,1021,530,491,41976,54262,8329,26419
8600000US26421,115,67,48,19091,30950,19086,26421
8600000US26422,317,156,161,,50880,20182,26422
8600000US26424,138,70,68,51875,50622,18346,26424
8600000US26425,969,470,499,40403,47438,7671,26425
8600000US26426,6304,3269,3035,44430,60608,4656,26426
8600000US26430,372,237,135,53214,54270,11927,26430
8600000US26431,4488,2193,2295,45328,54990,4905,26431
8600000US26435,103,63,40,23056,25161,10813,26435
8600000US26436,186,100,86,34179,40252,8776,26436
8600000US26437,416,219,197,34432,34636,7694,26437
8600000US26438,141,36,105,,42992,29467,26438
8600000US26440,1022,502,520,50625,53111,7031,26440
8600000US26443,240,125,115,,55800,24130,26443
8600000US26444,2951,1372,1579,51477,69704,10749,26444
8600000US26447,1174,611,563,39265,46005,8014,26447
8600000US26448,1260,729,531,48875,61409,8874,26448
8600000US26451,590,285,305,63036,67352,12525,26451
8600000US26452,7162,3403,3759,36483,51437,5356,26452
8600000US26456,2874,1450,1424,50250,60684,7351,26456
8600000US26501,18282,9385,8897,48889,71278,6030,26501
8600000US26505,35710,19147,16563,38396,60506,4600,26505
8600000US26508,26401,13143,13258,69393,100850,5713,26508
8600000US26519,1623,745,878,47049,53921,11179,26519
8600000US26520,1053,427,626,72792,83066,13355,26520
8600000US26521,161,72,89,48750,85063,29791,26521
8600000US26525,6423,3974,2449,55755,73232,7393,26525
8600000US26534,1868,847,1021,39091,47083,9602,26534
8600000US26537,3982,1920,2062,46333,56748,5721,26537
8600000US26541,2071,1043,1028,59786,78273,15916,26541
8600000US26542,1929,1032,897,52656,62558,7928,26542
8600000US26543,211,117,94,,,,26543
8600000US26547,1930,987,943,45724,57683,7333,26547
8600000US26554,33720,16608,17112,49892,65962,2624,26554
8600000US26559,1004,424,580,59107,63699,7731,26559
8600000US26560,195,54,141,76369,64763,19941,26560
8600000US26562,437,205,232,46000,57820,17117,26562
8600000US26563,482,247,235,32898,48825,20543,26563
8600000US26568,506,235,271,32554,65479,33351,26568
8600000US26570,3059,1502,1557,49881,59868,6550,26570
8600000US26571,1678,825,853,62571,61014,9607,26571
8600000US26572,151,93,58,,39777,30929,26572
8600000US26574,560,240,320,44167,54343,14768,26574
8600000US26575,594,269,325,32875,46649,11472,26575
8600000US26576,431,156,275,42917,65953,35762,26576
8600000US26581,636,309,327,36548,44874,12629,26581
8600000US26582,3609,1723,1886,40511,59380,7114,26582
8600000US26585,396,220,176,47228,63136,18124,26585
8600000US26586,178,71,107,37159,33993,10099,26586
8600000US26587,263,121,142,,54457,22678,26587
8600000US26588,2105,997,1108,47115,56628,7838,26588
8600000US26590,449,240,209,58125,57180,18280,26590
8600000US26591,987,486,501,50188,57124,11293,26591
8600000US26601,3981,2136,1845,42396,58578,6988,26601
8600000US26610,832,386,446,33125,42930,13518,26610
8600000US26611,117,45,72,33208,46213,28653,26611
8600000US26615,137,58,79,54315,77263,48660,26615
8600000US26617,125,65,60,63831,60571,8789,26617
8600000US26619,312,159,153,,43114,26855,26619
8600000US26621,575,320,255,58500,54281,14700,26621
8600000US26623,979,487,492,54265,59301,17682,26623
8600000US26624,2134,1058,1076,45708,54497,7515,26624
8600000US26627,343,110,233,,51580,35870,26627
8600000US26629,344,162,182,46926,46586,9470,26629
8600000US26631,231,122,109,,41257,33403,26631
8600000US26636,531,273,258,38571,42276,18635,26636
8600000US26638,58,20,38,17143,20939,11313,26638
8600000US26651,7456,3510,3946,38875,55543,5459,26651
8600000US26656,273,146,127,23841,31941,10111,26656
8600000US26660,362,188,174,47216,48649,12366,26660
8600000US26662,922,460,462,53494,69792,19228,26662
8600000US26676,359,183,176,57550,47666,8274,26676
8600000US26678,869,449,420,44087,64720,16744,26678
8600000US26679,1460,736,724,41224,54375,12816,26679
8600000US26680,225,101,124,,39503,15851,26680
8600000US26681,1185,630,555,36500,44021,11220,26681
8600000US26684,134,55,79,36250,42053,20695,26684
8600000US26690,476,198,278,,57031,20433,26690
8600000US26691,383,160,223,49522,56252,22456,26691
8600000US26704,4170,2147,2023,39245,50016,6690,26704
8600000US26705,564,304,260,41923,77983,39146,26705
8600000US26707,224,120,104,42692,43794,8279,26707
8600000US26710,1637,845,792,55714,56566,5975,26710
8600000US26711,2180,1063,1117,50417,59885,8962,26711
8600000US26714,375,224,151,25991,27073,9536,26714
8600000US26716,613,324,289,41827,53685,11325,26716
8600000US26717,691,359,332,30865,56328,17823,26717
8600000US26719,2506,1302,1204,59031,65811,11966,26719
8600000US26720,110,65,45,42344,37769,22000,26720
8600000US26722,584,328,256,37417,40798,6801,26722
8600000US26726,10618,5325,5293,44109,51550,3866,26726
8600000US26731,301,167,134,50417,53183,19405,26731
8600000US26739,735,399,336,47563,53213,12067,26739
8600000US26743,915,447,468,41875,60762,11445,26743
8600000US26750,550,260,290,27917,48273,12781,26750
8600000US26753,4431,2144,2287,50980,59063,4933,26753
8600000US26755,610,322,288,46000,53556,19531,26755
8600000US26757,5287,2452,2835,35868,52479,7599,26757
8600000US26761,493,313,180,31786,44621,15331,26761
8600000US26763,1377,706,671,53633,55638,9705,26763
8600000US26764,3242,1522,1720,43125,49676,4453,26764
8600000US26767,534,186,348,36136,49118,12681,26767
8600000US26801,816,463,353,72143,70661,19571,26801
8600000US26802,867,453,414,39440,48969,7742,26802
8600000US26804,661,389,272,36071,74366,41567,26804
8600000US26807,2191,1087,1104,42596,54862,6768,26807
8600000US26808,713,308,405,66250,60367,13126,26808
8600000US26810,559,239,320,85505,98626,64065,26810
8600000US26812,1208,581,627,53667,77252,20588,26812
8600000US26814,312,141,171,45250,56446,12720,26814
8600000US26815,611,318,293,39769,66258,24154,26815
8600000US26817,236,117,119,58649,65769,31411,26817
8600000US26818,706,345,361,44583,52982,9500,26818
8600000US26823,168,51,117,24915,56008,46765,26823
8600000US26833,1674,823,851,48971,59031,7209,26833
8600000US26836,5428,2765,2663,44123,64722,13999,26836
8600000US26845,589,321,268,64853,62319,12442,26845
8600000US26847,5471,2647,2824,34550,50144,4654,26847
8600000US26851,1410,712,698,54353,61916,8832,26851
8600000US26852,694,367,327,60256,53894,10505,26852
8600000US26855,490,240,250,50417,64021,22344,26855
8600000US26865,257,193,64,46293,50511,17468,26865
8600000US26866,522,258,264,40953,43232,10142,26866
8600000US26884,578,274,304,45500,55256,12813,26884
8600000US27006,11578,5440,6138,78095,101292,10333,27006
8600000US27007,1830,898,932,51179,72707,17072,27007
8600000US27009,1998,1079,919,89200,95463,16515,27009
8600000US27011,4255,2050,2205,37167,52805,5941,27011
8600000US27012,21020,9632,11388,80045,97252,4787,27012
8600000US27013,4696,2268,2428,51372,62395,6359,27013
8600000US27014,595,277,318,37143,51176,10856,27014
8600000US27016,1136,608,528,50263,56060,8016,27016
8600000US27017,6768,3407,3361,41201,53531,4928,27017
8600000US27018,6221,3087,3134,45714,60158,5698,27018
8600000US27019,3411,1841,1570,57075,74449,16460,27019
8600000US27020,4343,2281,2062,39012,49926,7076,27020
8600000US27021,13979,6670,7309,50123,61353,6226,27021
8600000US27022,905,475,430,41078,58947,11791,27022
8600000US27023,10061,4767,5294,75208,112235,14585,27023
8600000US27024,2484,1075,1409,41161,79629,31822,27024
8600000US27025,9189,4478,4711,47147,59152,7362,27025
8600000US27027,3453,1578,1875,32183,44923,3963,27027
8600000US27028,20479,9935,10544,48167,62270,4594,27028
8600000US27030,28625,13612,15013,36859,52644,3130,27030
8600000US27040,9105,4313,4792,73442,98173,8478,27040
8600000US27041,6240,3131,3109,41771,62218,6347,27041
8600000US27042,554,248,306,55156,58266,15816,27042
8600000US27043,5250,2494,2756,51510,75521,16518,27043
8600000US27045,7455,3519,3936,53932,61214,3325,27045
8600000US27046,1692,794,898,38589,48814,9259,27046
8600000US27047,910,464,446,54583,54817,8758,27047
8600000US27048,6414,3129,3285,53154,64859,5051,27048
8600000US27050,3209,1649,1560,54167,69045,6883,27050
8600000US27051,5806,2774,3032,47940,56789,4813,27051
8600000US27052,8078,3553,4525,39460,50950,3965,27052
8600000US27053,2593,1393,1200,44967,53052,6889,27053
8600000US27054,2026,975,1051,70101,72031,10322,27054
8600000US27055,11085,5080,6005,44574,58881,4366,27055
8600000US27101,15758,8056,7702,31805,53522,4383,27101
8600000US27103,27800,12485,15315,49623,67219,4265,27103
8600000US27104,22475,10235,12240,64579,108618,5268,27104
8600000US27105,29917,14202,15715,33937,43531,2461,27105
8600000US27106,37182,16846,20336,49947,87657,4616,27106
8600000US27107,33776,15394,18382,42787,59186,2992,27107
8600000US27109,2542,1185,1357,,,,27109
8600000US27110,2587,1215,1372,,,,27110
8600000US27127,29906,13352,16554,48262,63912,7261,27127
8600000US27201,65,27,38,80769,63825,20915,27201
8600000US27203,16265,7813,8452,34131,42951,2256,27203
8600000US27205,26350,12657,13693,47008,61550,3009,27205
8600000US27207,2644,1168,1476,55625,62523,7683,27207
8600000US27208,1454,734,720,42128,61162,12243,27208
8600000US27209,3040,1466,1574,42376,73677,25251,27209
8600000US27212,1791,1200,591,46125,63641,15307,27212
8600000US27214,8141,4274,3867,67895,87779,11279,27214
8600000US27215,32919,15255,17664,47420,70467,4851,27215
8600000US27217,28329,13239,15090,40114,50499,2516,27217
8600000US27229,2297,994,1303,38604,42156,5808,27229
8600000US27231,1641,818,823,65054,76312,6078,27231
8600000US27233,3031,1551,1480,67278,87645,16089,27233
8600000US27235,3637,1785,1852,89214,103258,13223,27235
8600000US27239,7362,3694,3668,48091,61706,6554,27239
8600000US27242,1701,950,751,30569,43495,9079,27242
8600000US27243,3630,1643,1987,66975,91664,14227,27243
8600000US27244,13261,5755,7506,57511,74278,6571,27244
8600000US27248,3394,1564,1830,44832,54694,6031,27248
8600000US27249,9539,4529,5010,54516,69228,5880,27249
8600000US27252,1879,1016,863,51854,61010,14254,27252
8600000US27253,23222,11011,12211,44902,64750,3954,27253
8600000US27258,5173,2464,2709,47336,65153,6765,27258
8600000US27260,18273,7807,10466,27361,37246,3717,27260
8600000US27262,18617,8708,9909,39276,68227,5631,27262
8600000US27263,17221,8139,9082,44454,58878,3407,27263
8600000US27265,38776,18108,20668,60518,80192,3515,27265
8600000US27278,20020,9515,10505,71657,108678,15472,27278
8600000US27281,2525,1134,1391,54605,68253,10327,27281
8600000US27282,13974,6527,7447,68967,88848,5714,27282
8600000US27283,2480,1277,1203,57880,72665,7997,27283
8600000US27284,42395,20053,22342,61071,76601,2679,27284
8600000US27288,18788,8764,10024,37384,48572,3044,27288
8600000US27291,1374,704,670,68690,71290,16040,27291
8600000US27292,31015,15128,15887,41315,53276,2577,27292
8600000US27295,29952,14564,15388,49195,62484,2714,27295
8600000US27298,7953,3922,4031,45095,55645,4193,27298
8600000US27299,4423,2174,2249,47854,51929,5109,27299
8600000US27301,6920,3336,3584,62490,72909,5613,27301
8600000US27302,23255,10689,12566,56230,71665,3919,27302
8600000US27305,1415,567,848,52551,61283,11213,27305
8600000US27306,5104,2509,2595,46475,54239,5350,27306
8600000US27310,5099,2555,2544,117039,136119,14658,27310
8600000US27311,2997,1514,1483,40769,54652,11126,27311
8600000US27312,16818,7580,9238,72315,96893,5635,27312
8600000US27313,5650,2659,2991,61914,75692,6160,27313
8600000US27314,992,429,563,49417,57697,9599,27314
8600000US27315,1464,761,703,44722,55234,6838,27315
8600000US27316,5401,2680,2721,39570,54277,7017,27316
8600000US27317,12534,6328,6206,43754,67942,18139,27317
8600000US27320,30853,14882,15971,41771,54965,2696,27320
8600000US27325,5238,2692,2546,43333,51878,6659,27325
8600000US27326,2431,1218,1213,49053,52940,6946,27326
8600000US27330,29597,14333,15264,48744,65114,3474,27330
8600000US27332,23161,11102,12059,57649,67232,2916,27332
8600000US27340,41,10,31,,,,27340
8600000US27341,4286,2209,2077,44789,52615,4339,27341
8600000US27343,1290,672,618,64244,88171,17446,27343
8600000US27344,14080,6793,7287,42680,60241,5386,27344
8600000US27349,4200,2032,2168,52547,59651,5665,27349
8600000US27350,4740,2248,2492,44147,57996,6671,27350
8600000US27355,2017,1065,952,55812,97698,57633,27355
8600000US27356,2186,1113,1073,44485,58196,13712,27356
8600000US27357,6311,3113,3198,61101,99667,22525,27357
8600000US27358,11507,5795,5712,90909,126972,11103,27358
8600000US27360,34635,16755,17880,43661,57277,2678,27360
8600000US27370,12025,5684,6341,51748,67855,5477,27370
8600000US27371,7077,3514,3563,44085,54726,5393,27371
8600000US27376,7214,3481,3733,63278,88437,15078,27376
8600000US27377,6456,2939,3517,67332,76672,6993,27377
8600000US27379,4208,1932,2276,35086,47086,5772,27379
8600000US27401,18777,8775,10002,35153,51662,3228,27401
8600000US27403,19587,9006,10581,45566,65527,4245,27403
8600000US27405,35768,16482,19286,36462,48033,2443,27405
8600000US27406,46986,20491,26495,41097,56358,2472,27406
8600000US27407,38407,18323,20084,48127,62395,3130,27407
8600000US27408,14500,6704,7796,63965,113928,7437,27408
8600000US27409,13795,6467,7328,41455,54958,5130,27409
8600000US27410,45544,20405,25139,65755,88669,3106,27410
8600000US27455,22727,10879,11848,73263,110425,8273,27455
8600000US27501,15500,7556,7944,56338,67026,3823,27501
8600000US27502,28096,13569,14527,110513,126029,5782,27502
8600000US27503,5795,4612,1183,81016,107226,16155,27503
8600000US27504,11846,5821,6025,46944,60914,5150,27504
8600000US27505,4622,2302,2320,47696,61700,6513,27505
8600000US27507,1587,789,798,42602,56316,12330,27507
8600000US27508,1175,780,395,42981,50618,8497,27508
8600000US27509,4999,2965,2034,41467,54188,4999,27509
8600000US27510,12894,6347,6547,53155,68668,5468,27510
8600000US27511,27141,13344,13797,74339,96048,4458,27511
8600000US27513,34776,16719,18057,92858,114692,4381,27513
8600000US27514,27474,12099,15375,70849,118339,6660,27514
8600000US27516,32952,15727,17225,85615,125797,7754,27516
8600000US27517,19446,9007,10439,84940,136028,10206,27517
8600000US27518,16188,7712,8476,106833,137329,8394,27518
8600000US27519,38316,17983,20333,130337,146400,4943,27519
8600000US27520,30435,14336,16099,65190,75837,3423,27520
8600000US27521,4556,2265,2291,44231,53141,3610,27521
8600000US27522,8806,4204,4602,65589,74885,6283,27522
8600000US27523,8682,4315,4367,102368,119940,8522,27523
8600000US27524,9941,4857,5084,48052,64538,6128,27524
8600000US27525,10846,5294,5552,51570,64681,5522,27525
8600000US27526,34679,16664,18015,76880,92565,3670,27526
8600000US27527,16139,8206,7933,87313,99063,7274,27527
8600000US27529,36263,17086,19177,60801,78210,4735,27529
8600000US27530,29697,14070,15627,36283,55763,4146,27530
8600000US27531,779,658,121,,,,27531
8600000US27534,25416,12373,13043,48270,63269,3819,27534
8600000US27536,11979,4951,7028,29021,54699,16064,27536
8600000US27537,19159,9195,9964,42363,58433,7334,27537
8600000US27539,16665,8166,8499,105526,122781,8449,27539
8600000US27540,25636,12440,13196,102268,115834,4340,27540
8600000US27541,2724,1328,1396,64038,83199,10284,27541
8600000US27542,7306,3620,3686,46332,59852,6273,27542
8600000US27544,3906,2013,1893,56382,58943,7420,27544
8600000US27545,20031,9395,10636,63683,77010,4861,27545
8600000US27546,16942,8815,8127,48737,59364,3563,27546
8600000US27549,20257,9834,10423,47667,57693,3706,27549
8600000US27551,1433,632,801,46652,62600,10617,27551
8600000US27553,2084,1328,756,35625,51302,17217,27553
8600000US27555,469,186,283,30833,40286,7548,27555
8600000US27556,119,53,66,17679,26258,10328,27556
8600000US27557,5373,2448,2925,43098,47284,4808,27557
8600000US27559,1779,941,838,68264,87077,22350,27559
8600000US27560,24258,11990,12268,93440,111825,5326,27560
8600000US27562,1289,652,637,54693,82078,16047,27562
8600000US27563,3903,1869,2034,33934,46235,5355,27563
8600000US27565,20305,9714,10591,47056,62425,3930,27565
8600000US27568,476,198,278,45263,55415,10150,27568
8600000US27569,6111,2866,3245,43958,55551,5131,27569
8600000US27571,4343,2147,2196,112425,113056,11422,27571
8600000US27572,5859,2827,3032,72155,81908,7568,27572
8600000US27573,8208,3603,4605,32726,46540,6206,27573
8600000US27574,11667,5856,5811,50483,64515,6473,27574
8600000US27576,12816,5818,6998,38676,51578,3226,27576
8600000US27577,19863,9874,9989,46508,57560,3373,27577
8600000US27581,4158,2646,1512,63667,77385,9325,27581
8600000US27582,339,130,209,,51238,34426,27582
8600000US27583,5615,2692,2923,58274,67973,6401,27583
8600000US27587,47343,22504,24839,92878,116012,5204,27587
8600000US27589,6302,2995,3307,33585,48136,7674,27589
8600000US27591,15533,7115,8418,62651,73803,5328,27591
8600000US27592,11733,5607,6126,67820,77440,4835,27592
8600000US27596,13759,6732,7027,70535,86620,6278,27596
8600000US27597,17771,8919,8852,58514,74912,4167,27597
8600000US27601,8787,4696,4091,36781,67375,8823,27601
8600000US27603,43078,22710,20368,64087,80942,3264,27603
8600000US27604,36854,17657,19197,58626,71624,3196,27604
8600000US27605,4933,2287,2646,62479,98374,12000,27605
8600000US27606,39839,21158,18681,51959,77327,3813,27606
8600000US27607,25736,12380,13356,77092,114379,7594,27607
8600000US27608,8730,4389,4341,107875,163713,14223,27608
8600000US27609,26113,11846,14267,58983,91596,4313,27609
8600000US27610,56389,24905,31484,50092,60277,2260,27610
8600000US27612,31604,14847,16757,76765,102303,3214,27612
8600000US27613,32854,16110,16744,96185,119807,4816,27613
8600000US27614,25075,11406,13669,106469,147278,8554,27614
8600000US27615,34636,16264,18372,82214,119372,5268,27615
8600000US27616,38705,17807,20898,68084,78140,3150,27616
8600000US27617,15201,6775,8426,83309,132951,20122,27617
8600000US27701,17698,8628,9070,36606,61999,3568,27701
8600000US27703,38544,17786,20758,60438,76827,4828,27703
8600000US27704,28007,12561,15446,46720,56883,2934,27704
8600000US27705,41432,19404,22028,52256,84409,4819,27705
8600000US27707,40532,19008,21524,51851,81142,4115,27707
8600000US27709,714,394,320,127125,206626,144610,27709
8600000US27712,16670,7471,9199,83418,102156,6475,27712
8600000US27713,42143,19030,23113,74077,93949,4148,27713
8600000US27801,15001,6424,8577,32346,43854,4371,27801
8600000US27803,15193,6843,8350,47843,69284,6116,27803
8600000US27804,22749,10356,12393,51385,69498,4801,27804
8600000US27805,2941,1392,1549,38583,46810,5191,27805
8600000US27806,2158,982,1176,37582,56095,13037,27806
8600000US27807,4706,2350,2356,45422,56680,7219,27807
8600000US27808,1689,802,887,48079,79632,20223,27808
8600000US27809,4016,2127,1889,47940,75360,18674,27809
8600000US27810,3363,1622,1741,40125,50349,6481,27810
8600000US27812,2251,979,1272,38944,51220,7066,27812
8600000US27813,562,254,308,35625,49466,9377,27813
8600000US27814,1716,733,983,51250,56203,6990,27814
8600000US27816,1988,1082,906,44787,64142,11988,27816
8600000US27817,6118,2938,3180,50526,63659,7063,27817
8600000US27818,1037,472,565,32667,40123,12030,27818
8600000US27819,247,109,138,30865,40899,9983,27819
8600000US27820,1792,791,1001,39839,49179,7845,27820
8600000US27821,233,141,92,14375,22817,11010,27821
8600000US27822,6506,3177,3329,47181,63197,6529,27822
8600000US27823,6509,3056,3453,31951,39855,3360,27823
8600000US27824,1332,652,680,62577,58400,14700,27824
8600000US27825,41,22,19,,29341,20729,27825
8600000US27826,908,696,212,32297,54079,25817,27826
8600000US27827,42,20,22,,28232,13480,27827
8600000US27828,6981,3248,3733,37305,57123,5384,27828
8600000US27829,1273,618,655,39130,51227,6504,27829
8600000US27830,3899,1816,2083,44366,55868,4667,27830
8600000US27831,2638,1372,1266,31062,41048,6377,27831
8600000US27832,2530,1023,1507,36089,45626,5302,27832
8600000US27834,42122,18598,23524,36360,49882,2395,27834
8600000US27837,4845,2463,2382,70453,84803,12259,27837
8600000US27839,3066,1884,1182,31051,39716,5019,27839
8600000US27840,357,161,196,30573,41185,15154,27840
8600000US27841,24,10,14,,60617,41569,27841
8600000US27842,1291,619,672,61806,71291,10987,27842
8600000US27843,871,447,424,29904,33293,5727,27843
8600000US27844,2240,1054,1186,28170,51456,12191,27844
8600000US27845,2327,1342,985,33750,47240,8649,27845
8600000US27846,2435,1226,1209,43984,57824,8087,27846
8600000US27847,509,241,268,19632,37800,15525,27847
8600000US27849,1297,682,615,36125,46443,9874,27849
8600000US27850,6136,3052,3084,42176,61011,6116,27850
8600000US27851,4187,2146,2041,48547,60624,7843,27851
8600000US27852,2372,1267,1105,43906,62675,14820,27852
8600000US27853,447,218,229,,56313,25610,27853
8600000US27855,5211,2312,2899,29971,43975,5871,27855
8600000US27856,13417,6595,6822,52729,72122,8178,27856
8600000US27857,867,428,439,35588,42959,5829,27857
8600000US27858,50902,23467,27435,44751,68155,4011,27858
8600000US27860,1393,719,674,38750,65016,29005,27860
8600000US27861,44,24,20,27188,34788,13616,27861
8600000US27862,586,283,303,37500,46746,9098,27862
8600000US27863,9429,4605,4824,56724,79945,18054,27863
8600000US27864,3792,1772,2020,40455,53898,5277,27864
8600000US27865,1768,810,958,63917,82176,15122,27865
8600000US27866,793,420,373,54000,55736,16127,27866
8600000US27869,1654,746,908,29646,37697,6485,27869
8600000US27870,19408,8685,10723,36287,53382,4620,27870
8600000US27871,3411,1606,1805,36286,46061,5616,27871
8600000US27872,396,224,172,19236,27773,9047,27872
8600000US27873,379,208,171,,45684,14770,27873
8600000US27874,3218,1487,1731,36023,65669,15950,27874
8600000US27875,331,124,207,,44172,22341,27875
8600000US27876,1039,461,578,35807,49522,11589,27876
8600000US27878,1460,604,856,24595,40691,10995,27878
8600000US27879,286,135,151,54000,68704,13790,27879
8600000US27880,2542,1289,1253,65768,85112,21698,27880
8600000US27881,73,24,49,,37154,19159,27881
8600000US27882,5775,2765,3010,42587,58628,7006,27882
8600000US27883,2362,1093,1269,44561,50810,5761,27883
8600000US27884,1026,534,492,60147,68589,17378,27884
8600000US27885,884,381,503,41442,56245,14526,27885
8600000US27886,16237,7249,8988,35959,51811,4801,27886
8600000US27888,1672,886,786,40156,52381,11088,27888
8600000US27889,20966,9755,11211,40740,60630,4916,27889
8600000US27890,1872,804,1068,28264,37624,4946,27890
8600000US27891,4376,2045,2331,42656,55064,8167,27891
8600000US27892,11334,5106,6228,40243,60364,7189,27892
8600000US27893,29554,12972,16582,34210,46797,2982,27893
8600000US27896,15899,7408,8491,63792,81739,6564,27896
8600000US27897,1332,595,737,47125,47629,8034,27897
8600000US27909,30740,14865,15875,48277,60882,2823,27909
8600000US27910,9391,4424,4967,39126,50778,2815,27910
8600000US27915,567,329,238,33125,42210,13839,27915
8600000US27916,693,366,327,52100,66631,13626,27916
8600000US27917,564,206,358,29684,35254,10067,27917
8600000US27919,832,391,441,,47425,14602,27919
8600000US27920,961,498,463,48796,53612,11888,27920
8600000US27921,3786,1944,1842,63563,75248,9648,27921
8600000US27922,730,342,388,40536,44976,12454,27922
8600000US27923,513,280,233,51330,71025,24605,27923
8600000US27924,2993,1181,1812,32647,48100,10971,27924
8600000US27925,3468,2020,1448,37674,45490,4796,27925
8600000US27926,1119,470,649,51343,76107,19543,27926
8600000US27927,850,456,394,65795,94676,25391,27927
8600000US27928,1523,744,779,27188,38042,6426,27928
8600000US27929,1338,625,713,80185,93993,16151,27929
8600000US27932,9784,4424,5360,42052,54319,4501,27932
8600000US27935,1384,671,713,51250,58518,7253,27935
8600000US27936,818,358,460,37917,51102,10406,27936
8600000US27937,3554,1784,1770,56523,63962,7449,27937
8600000US27938,1075,519,556,47273,59384,11041,27938
8600000US27939,1913,812,1101,56910,64108,7928,27939
8600000US27941,469,232,237,72569,90686,39285,27941
8600000US27942,815,382,433,40708,44388,8182,27942
8600000US27943,484,249,235,73400,69029,12419,27943
8600000US27944,9635,4608,5027,46240,60525,4890,27944
8600000US27946,868,416,452,52679,67578,13697,27946
8600000US27947,1107,586,521,50417,61309,10448,27947
8600000US27948,8979,4455,4524,57445,73112,7049,27948
8600000US27949,6183,2969,3214,78191,107255,9444,27949
8600000US27950,1709,962,747,58821,65252,7006,27950
8600000US27953,794,404,390,46321,60139,10878,27953
8600000US27954,5852,2937,2915,52626,71292,9415,27954
8600000US27956,342,185,157,,88246,21617,27956
8600000US27957,1211,647,564,41500,83582,36129,27957
8600000US27958,8222,3876,4346,84575,90253,6119,27958
8600000US27959,2430,1073,1357,58803,78441,11276,27959
8600000US27960,406,184,222,,45854,18129,27960
8600000US27962,5947,2737,3210,36155,46889,7544,27962
8600000US27964,538,277,261,51321,61724,16834,27964
8600000US27965,606,344,262,41250,51504,13377,27965
8600000US27966,521,321,200,37837,46576,18653,27966
8600000US27967,252,119,133,32500,67544,38576,27967
8600000US27968,125,77,48,57554,61312,19637,27968
8600000US27970,2205,946,1259,35188,40237,4654,27970
8600000US27972,70,36,34,126250,103877,46473,27972
8600000US27973,909,471,438,41736,59077,10358,27973
8600000US27974,960,479,481,50865,70006,16530,27974
8600000US27976,2934,1395,1539,71532,71727,8808,27976
8600000US27978,171,86,85,,56825,22368,27978
8600000US27979,1310,679,631,59688,70050,16368,27979
8600000US27980,1439,789,650,47946,57226,8459,27980
8600000US27981,1344,655,689,49954,62068,9938,27981
8600000US27982,54,41,13,,,,27982
8600000US27983,7145,3846,3299,31382,47292,6901,27983
8600000US27985,249,134,115,28750,31693,9607,27985
8600000US27986,2041,1527,514,35446,47265,6603,27986
8600000US28001,20512,9589,10923,45121,57831,2687,28001
8600000US28006,879,410,469,50893,58936,10971,28006
8600000US28007,604,270,334,36522,51539,13396,28007
8600000US28009,976,381,595,33261,44420,7755,28009
8600000US28012,17816,8468,9348,66910,86851,4867,28012
8600000US28016,10160,4850,5310,44313,58594,5935,28016
8600000US28017,721,239,482,,,,28017
8600000US28018,3953,1846,2107,36108,48005,5555,28018
8600000US28019,0,0,0,,,,28019
8600000US28020,1705,868,837,42700,49913,7824,28020
8600000US28021,10810,5217,5593,45606,59940,4133,28021
8600000US28023,12009,6125,5884,54626,78316,9089,28023
8600000US28025,41029,19980,21049,54774,69856,3149,28025
8600000US28027,47505,22354,25151,71067,90945,3615,28027
8600000US28031,21070,9813,11257,89823,123102,8937,28031
8600000US28032,2455,1099,1356,59071,79510,11901,28032
8600000US28033,2606,1440,1166,43674,57548,7876,28033
8600000US28034,13415,6585,6830,46423,58068,3517,28034
8600000US28036,13185,6580,6605,117685,155218,10167,28036
8600000US28037,15784,7657,8127,75516,106383,6136,28037
8600000US28039,68,33,35,20536,23071,9125,28039
8600000US28040,6200,3163,3037,38957,50119,7207,28040
8600000US28043,15996,7387,8609,35484,48582,3715,28043
8600000US28052,26201,12654,13547,36243,49850,3036,28052
8600000US28054,28834,13195,15639,43422,58787,3086,28054
8600000US28056,26603,12362,14241,63563,84462,6934,28056
8600000US28071,2190,1253,937,43551,56008,7725,28071
8600000US28072,962,486,476,53750,66992,9697,28072
8600000US28073,4304,2246,2058,39971,52329,5822,28073
8600000US28075,13672,6415,7257,99075,112890,7497,28075
8600000US28076,279,96,183,27074,29665,9946,28076
8600000US28077,366,132,234,24063,37969,10365,28077
8600000US28078,43137,20653,22484,95874,114445,4159,28078
8600000US28079,26836,13030,13806,78407,92494,4771,28079
8600000US28080,6075,3040,3035,53811,69387,9575,28080
8600000US28081,19903,9354,10549,49743,73298,7399,28081
8600000US28083,18954,9112,9842,48103,59436,4454,28083
8600000US28086,19491,9401,10090,42571,53208,3459,28086
8600000US28088,2091,802,1289,53949,63270,10237,28088
8600000US28089,199,39,160,,32658,19475,28089
8600000US28090,6799,3502,3297,33151,47028,4002,28090
8600000US28091,1512,806,706,46000,54784,8809,28091
8600000US28092,31367,15325,16042,47971,58157,2575,28092
8600000US28097,4835,2379,2456,57782,66629,4355,28097
8600000US28098,2937,1399,1538,51206,67686,15348,28098
8600000US28101,666,291,375,60294,87178,18390,28101
8600000US28102,66,30,36,37321,51171,15570,28102
8600000US28103,8807,4414,4393,55116,64732,4480,28103
8600000US28104,22512,10809,11703,104745,130331,6442,28104
8600000US28105,35093,16150,18943,75329,98272,4298,28105
8600000US28107,5767,2848,2919,70086,86602,10121,28107
8600000US28108,81,35,46,54583,62689,11383,28108
8600000US28109,340,171,169,,84880,34069,28109
8600000US28110,38863,18710,20153,57969,71674,2180,28110
8600000US28112,20683,10141,10542,52745,69501,5009,28112
8600000US28114,5564,2629,2935,38944,51540,6459,28114
8600000US28115,27401,13574,13827,62252,79605,3364,28115
8600000US28117,29987,14739,15248,85591,128261,8023,28117
8600000US28119,1926,1105,821,31464,38606,4754,28119
8600000US28120,16672,7935,8737,56234,74228,4209,28120
8600000US28124,4793,2342,2451,59167,76458,10111,28124
8600000US28125,1817,864,953,63603,73950,9750,28125
8600000US28127,6483,3535,2948,54657,75865,7104,28127
8600000US28128,5562,2829,2733,45689,59581,6985,28128
8600000US28129,4219,2065,2154,50609,60354,5552,28129
8600000US28133,1816,854,962,53009,65667,12822,28133
8600000US28134,8478,3704,4774,57047,76482,6718,28134
8600000US28135,5068,3382,1686,41116,49761,6102,28135
8600000US28137,2595,1382,1213,52167,63536,6664,28137
8600000US28138,8059,4245,3814,50331,59210,4453,28138
8600000US28139,16614,7836,8778,45053,59922,4209,28139
8600000US28144,19945,9596,10349,43136,62692,4428,28144
8600000US28146,21178,10001,11177,51806,65269,3189,28146
8600000US28147,18927,9336,9591,49048,62190,3413,28147
8600000US28150,21373,9790,11583,38328,57067,5479,28150
8600000US28152,19588,9208,10380,41492,54760,4478,28152
8600000US28159,2172,1099,1073,38125,54328,16084,28159
8600000US28160,2837,1366,1471,36199,45589,7136,28160
8600000US28163,4127,2106,2021,64559,80125,10454,28163
8600000US28164,11619,5565,6054,56762,73934,4440,28164
8600000US28166,7476,3624,3852,61406,82781,8645,28166
8600000US28167,2177,1062,1115,41651,52129,12031,28167
8600000US28168,7886,3558,4328,47888,55988,3562,28168
8600000US28169,121,63,58,,36045,13101,28169
8600000US28170,9459,4433,5026,37356,51391,4921,28170
8600000US28173,38542,18890,19652,116043,155610,6294,28173
8600000US28174,7076,3263,3813,48936,60240,6445,28174
8600000US28202,11791,6810,4981,90972,126981,14460,28202
8600000US28203,13365,6464,6901,81094,119784,7703,28203
8600000US28204,5701,2775,2926,61700,94301,9663,28204
8600000US28205,38806,19675,19131,49378,73177,3532,28205
8600000US28206,9083,4016,5067,31617,41499,2935,28206
8600000US28207,7686,3648,4038,129886,255466,29644,28207
8600000US28208,28586,12991,15595,34925,50033,3220,28208
8600000US28209,18300,8683,9617,72535,122824,10283,28209
8600000US28210,37612,17196,20416,68692,99497,3913,28210
8600000US28211,23341,10410,12931,84366,163070,11752,28211
8600000US28212,33130,15966,17164,39439,50123,2526,28212
8600000US28213,31386,14720,16666,43984,59696,2634,28213
8600000US28214,30280,13983,16297,60837,73489,3017,28214
8600000US28215,43978,20173,23805,50305,63280,2404,28215
8600000US28216,38691,17164,21527,48647,65668,2517,28216
8600000US28217,22316,11248,11068,49230,59324,3199,28217
8600000US28226,30759,14289,16470,94492,138714,6212,28226
8600000US28227,42887,19755,23132,57752,73316,2686,28227
8600000US28244,0,0,0,,,,28244
8600000US28262,35882,18351,17531,53261,63922,2950,28262
8600000US28269,57861,27713,30148,64803,80958,2689,28269
8600000US28270,25665,12433,13232,95224,133976,7027,28270
8600000US28273,29705,14269,15436,63687,75209,3081,28273
8600000US28277,52429,24243,28186,105885,137378,4041,28277
8600000US28278,19817,9219,10598,90282,111214,5121,28278
8600000US28280,0,0,0,,,,28280
8600000US28282,0,0,0,,,,28282
8600000US28301,13659,6137,7522,26261,38553,3321,28301
8600000US28303,23116,10967,12149,39896,59174,4656,28303
8600000US28304,27916,13213,14703,48358,59865,2166,28304
8600000US28305,4614,2159,2455,50020,68668,5159,28305
8600000US28306,29931,14086,15845,51597,68343,3316,28306
8600000US28307,12286,7518,4768,40559,49045,2385,28307
8600000US28308,598,467,131,,76807,55263,28308
8600000US28310,6470,5799,671,,,,28310
8600000US28311,27069,13013,14056,47534,61918,2490,28311
8600000US28312,14749,7163,7586,44683,61797,4656,28312
8600000US28314,43596,20787,22809,47873,58365,1988,28314
8600000US28315,9875,4695,5180,51725,54929,4028,28315
8600000US28318,3406,1612,1794,47566,59613,9004,28318
8600000US28320,7774,3524,4250,36199,45798,4565,28320
8600000US28323,2869,1396,1473,52351,64098,6751,28323
8600000US28325,320,161,159,56477,56620,11838,28325
8600000US28326,15016,7484,7532,61299,73257,6115,28326
8600000US28327,12107,5272,6835,53080,65996,4872,28327
8600000US28328,20468,9825,10643,35486,54415,3703,28328
8600000US28330,367,165,202,28472,37305,21091,28330
8600000US28332,257,103,154,38333,60745,17621,28332
8600000US28333,7369,3336,4033,30172,41786,7557,28333
8600000US28334,19465,9126,10339,36751,54694,4207,28334
8600000US28337,7817,3563,4254,33981,45030,4086,28337
8600000US28338,3634,1702,1932,45260,58333,9838,28338
8600000US28339,5841,2816,3025,40464,48222,3332,28339
8600000US28340,7770,3616,4154,30026,38279,2548,28340
8600000US28341,3390,1568,1822,38068,47895,7272,28341
8600000US28342,135,72,63,45417,62365,17936,28342
8600000US28343,1170,629,541,39531,54116,13055,28343
8600000US28344,2811,1407,1404,43587,58084,8617,28344
8600000US28345,8965,4233,4732,34918,43518,4438,28345
8600000US28347,1676,1237,439,28125,38317,8220,28347
8600000US28348,24989,11484,13505,53090,64484,4144,28348
8600000US28349,2268,1010,1258,36537,46307,7966,28349
8600000US28350,128,81,47,,,,28350
8600000US28351,3690,1730,1960,36949,47463,6101,28351
8600000US28352,19539,9508,10031,33657,45480,1980,28352
8600000US28356,3629,1750,1879,67609,71200,7352,28356
8600000US28357,2211,1104,1107,32060,41585,5475,28357
8600000US28358,28454,13301,15153,37858,53907,2854,28358
8600000US28360,10630,4874,5756,37608,48952,2936,28360
8600000US28363,1076,681,395,39681,55236,14582,28363
8600000US28364,11379,5403,5976,33462,44310,3009,28364
8600000US28365,12832,6429,6403,44209,57747,7325,28365
8600000US28366,4408,2247,2161,33295,52789,9420,28366
8600000US28367,52,17,35,35500,27997,13718,28367
8600000US28369,2207,1016,1191,29848,49451,14246,28369
8600000US28371,5419,2845,2574,50523,58909,4673,28371
8600000US28372,10905,5140,5765,29399,43848,2806,28372
8600000US28373,1969,893,1076,43836,53040,6173,28373
8600000US28374,14458,6860,7598,82312,113041,8141,28374
8600000US28375,110,53,57,41250,39480,5439,28375
8600000US28376,31896,15729,16167,49480,60348,2250,28376
8600000US28377,9212,4403,4809,28176,47736,8762,28377
8600000US28379,19194,8833,10361,36806,51290,3078,28379
8600000US28382,5534,2778,2756,46930,67536,14917,28382
8600000US28383,6763,3134,3629,33952,46920,5515,28383
8600000US28384,8549,4303,4246,32744,46697,6103,28384
8600000US28385,1913,828,1085,39236,49048,7944,28385
8600000US28386,4050,1856,2194,31092,45979,6265,28386
8600000US28387,12649,5599,7050,60617,88034,9077,28387
8600000US28390,17173,8502,8671,46600,62821,3740,28390
8600000US28391,4482,2277,2205,52762,68553,18365,28391
8600000US28392,1351,721,630,31667,47773,12500,28392
8600000US28393,1617,924,693,42287,75121,36524,28393
8600000US28394,4204,2221,1983,47018,73392,10229,28394
8600000US28395,1927,979,948,54656,64684,6716,28395
8600000US28396,2054,1012,1042,44901,51565,6368,28396
8600000US28398,6019,2913,3106,32813,42876,4388,28398
8600000US28399,1665,853,812,33594,39673,5681,28399
8600000US28401,19018,8827,10191,33309,47219,3488,28401
8600000US28403,35821,16014,19807,37235,59061,3231,28403
8600000US28405,26349,12750,13599,54544,75556,3786,28405
8600000US28409,26174,12238,13936,78761,104359,5493,28409
8600000US28411,29438,14237,15201,72045,95454,6144,28411
8600000US28412,31087,14589,16498,52306,67051,3720,28412
8600000US28420,2964,1528,1436,53519,60929,6244,28420
8600000US28421,1227,620,607,36932,83325,50746,28421
8600000US28422,6995,3430,3565,45183,62683,5226,28422
8600000US28423,1800,832,968,39958,57805,7323,28423
8600000US28424,43,17,26,,36987,15297,28424
8600000US28425,9171,4720,4451,40211,51683,4164,28425
8600000US28428,5478,2490,2988,71250,91074,10103,28428
8600000US28429,6307,3267,3040,49346,57980,5679,28429
8600000US28430,1669,809,860,41169,53759,9170,28430
8600000US28431,5527,2866,2661,36648,58347,12921,28431
8600000US28432,1376,659,717,26198,37927,8216,28432
8600000US28433,4124,1890,2234,27900,43802,7185,28433
8600000US28434,886,411,475,39215,52228,14056,28434
8600000US28435,1816,968,848,36298,45628,6817,28435
8600000US28436,1578,841,737,50972,65813,15678,28436
8600000US28438,1315,563,752,30048,40203,6987,28438
8600000US28439,845,337,508,32778,50382,18838,28439
8600000US28441,2487,1069,1418,26849,37406,5681,28441
8600000US28442,1466,691,775,37002,57447,20740,28442
8600000US28443,16869,8111,8758,64317,85337,5796,28443
8600000US28444,1597,855,742,52668,98395,53085,28444
8600000US28445,5719,2920,2799,59766,81251,8413,28445
8600000US28447,1296,577,719,49199,95602,62839,28447
8600000US28448,685,285,400,20658,37012,19711,28448
8600000US28449,1735,871,864,81181,98972,15693,28449
8600000US28450,1910,814,1096,51680,63859,6582,28450
8600000US28451,26990,12724,14266,55357,66511,3203,28451
8600000US28452,675,286,389,19238,26161,7710,28452
8600000US28453,2647,1318,1329,40691,48624,5975,28453
8600000US28454,1959,954,1005,58889,61961,6064,28454
8600000US28455,1545,711,834,41458,101028,50799,28455
8600000US28456,2908,1364,1544,34451,42683,5438,28456
8600000US28457,7920,3949,3971,48843,61746,6905,28457
8600000US28458,5261,2588,2673,38750,46791,3765,28458
8600000US28460,8441,4694,3747,60580,72016,6117,28460
8600000US28461,16802,7865,8937,64418,89859,6754,28461
8600000US28462,10880,5306,5574,41243,58684,4677,28462
8600000US28463,7819,4405,3414,34564,56474,17545,28463
8600000US28464,2153,887,1266,20625,33533,7638,28464
8600000US28465,6539,3121,3418,65547,87323,4818,28465
8600000US28466,7441,3302,4139,36938,50643,5005,28466
8600000US28467,9514,4237,5277,55367,67596,5031,28467
8600000US28468,4410,2087,2323,55000,71901,12854,28468
8600000US28469,5467,2523,2944,72321,90665,8551,28469
8600000US28470,9829,4725,5104,39636,51912,4045,28470
8600000US28472,14194,6808,7386,35332,48559,3243,28472
8600000US28478,3769,1727,2042,39906,53789,5724,28478
8600000US28479,4914,2488,2426,59175,69590,6654,28479
8600000US28480,2138,1239,899,83417,147095,20109,28480
8600000US28501,14398,6507,7891,30053,45498,4003,28501
8600000US28504,16981,8247,8734,47856,64913,7052,28504
8600000US28508,1855,867,988,33568,51608,12548,28508
8600000US28510,1321,637,684,57381,93993,26451,28510
8600000US28511,516,258,258,38125,51800,12739,28511
8600000US28512,2889,1477,1412,62660,90033,7797,28512
8600000US28513,7600,3587,4013,48269,59576,5167,28513
8600000US28515,2221,1391,830,29292,37450,4586,28515
8600000US28516,9427,4469,4958,48668,61780,4866,28516
8600000US28518,6195,3064,3131,51964,60723,5385,28518
8600000US28519,257,123,134,53875,64063,23707,28519
8600000US28520,232,99,133,59135,61299,19113,28520
8600000US28521,2373,1123,1250,56883,62034,6631,28521
8600000US28523,1982,927,1055,62533,70370,10664,28523
8600000US28524,233,74,159,24867,48735,21875,28524
8600000US28525,2030,1006,1024,36373,44964,7317,28525
8600000US28526,2062,1067,995,29293,47266,15886,28526
8600000US28527,860,450,410,57708,59006,14255,28527
8600000US28528,503,276,227,38906,48897,14014,28528
8600000US28529,1347,673,674,46224,58913,7625,28529
8600000US28530,4762,2295,2467,36357,47059,5352,28530
8600000US28531,1145,505,640,51111,73993,20255,28531
8600000US28532,16042,8094,7948,50634,59145,3837,28532
8600000US28533,3228,3033,195,,,,28533
8600000US28537,112,62,50,24125,35039,16246,28537
8600000US28538,1599,804,795,37250,45782,7290,28538
8600000US28539,11604,5922,5682,52782,63244,4637,28539
8600000US28540,36012,18642,17370,49970,60592,2238,28540
8600000US28543,3606,2048,1558,36164,41669,3523,28543
8600000US28544,4996,2710,2286,39696,48615,6998,28544
8600000US28546,34051,17490,16561,46758,60513,4316,28546
8600000US28547,21890,18873,3017,47662,54878,6204,28547
8600000US28551,11534,5196,6338,37293,52381,4995,28551
8600000US28552,114,69,45,,27696,16665,28552
8600000US28553,301,192,109,115114,102874,26897,28553
8600000US28554,168,71,97,,46893,18753,28554
8600000US28555,3822,1842,1980,47527,57705,13151,28555
8600000US28556,827,457,370,41961,66083,14847,28556
8600000US28557,12816,6272,6544,54528,80110,5232,28557
8600000US28560,21406,10224,11182,46133,59714,3062,28560
8600000US28562,30685,14796,15889,57592,83027,5273,28562
8600000US28570,17099,8312,8787,51569,64180,3064,28570
8600000US28571,2504,1079,1425,53902,69091,6900,28571
8600000US28572,5626,2814,2812,43443,57059,8065,28572
8600000US28573,1698,827,871,44083,50454,7225,28573
8600000US28574,12807,6566,6241,49267,56979,4247,28574
8600000US28575,412,186,226,73214,88821,23799,28575
8600000US28577,326,157,169,61607,65120,14858,28577
8600000US28578,5035,2598,2437,44288,64880,8828,28578
8600000US28579,528,279,249,46964,61067,19743,28579
8600000US28580,10369,5965,4404,37156,52937,5067,28580
8600000US28581,269,119,150,67992,90502,52361,28581
8600000US28582,2280,1196,1084,74738,83183,14713,28582
8600000US28583,207,75,132,60625,70929,25652,28583
8600000US28584,9376,4441,4935,59102,76669,5096,28584
8600000US28585,2898,1417,1481,31600,50838,9299,28585
8600000US28586,5729,2849,2880,35500,46304,4788,28586
8600000US28587,316,165,151,26859,42916,11698,28587
8600000US28589,140,66,74,65227,57384,19716,28589
8600000US28590,18186,8464,9722,65594,89326,7148,28590
8600000US28594,3131,1471,1660,70870,90607,7527,28594
8600000US28601,40230,19095,21135,50821,73458,4020,28601
8600000US28602,22758,11014,11744,47493,59990,3381,28602
8600000US28604,6443,2976,3467,51280,73668,8386,28604
8600000US28605,2954,1498,1456,60172,84429,11512,28605
8600000US28606,1397,707,690,31308,48737,11424,28606
8600000US28607,31770,15787,15983,41143,60857,3781,28607
8600000US28609,4589,2303,2286,59495,75058,11385,28609
8600000US28610,7893,4140,3753,55997,67108,5374,28610
8600000US28611,1089,656,433,61810,74572,28176,28611
8600000US28612,9784,4781,5003,37813,55646,6936,28612
8600000US28613,17103,8048,9055,54585,68573,5228,28613
8600000US28615,1439,627,812,32619,37966,5501,28615
8600000US28616,118,53,65,85625,77051,20476,28616
8600000US28617,1706,806,900,34691,47761,10065,28617
8600000US28618,2148,1085,1063,55529,66721,13230,28618
8600000US28619,1257,539,718,40000,50502,9688,28619
8600000US28621,8036,4007,4029,47034,58139,4692,28621
8600000US28622,1750,887,863,27798,38718,6462,28622
8600000US28623,1249,605,644,43145,45879,5383,28623
8600000US28624,1110,528,582,32432,55321,15462,28624
8600000US28625,30461,14404,16057,50216,65119,3181,28625
8600000US28626,2054,1003,1051,65125,74747,12090,28626
8600000US28627,815,471,344,53368,50704,9759,28627
8600000US28628,385,187,198,40455,50671,12572,28628
8600000US28629,0,0,0,,,,28629
8600000US28630,15809,7915,7894,50190,61573,5288,28630
8600000US28631,734,311,423,37581,51698,15588,28631
8600000US28634,3947,1880,2067,46447,54052,6817,28634
8600000US28635,2500,1219,1281,29599,46873,7579,28635
8600000US28636,3974,2079,1895,43810,53009,5993,28636
8600000US28637,1354,617,737,40880,58953,15971,28637
8600000US28638,9167,4446,4721,41701,52729,3794,28638
8600000US28640,3942,1894,2048,35433,45731,5415,28640
8600000US28642,4542,2282,2260,38750,50834,5833,28642
8600000US28643,2926,1500,1426,41667,49454,6801,28643
8600000US28644,882,379,503,33750,39360,7659,28644
8600000US28645,37027,18014,19013,38697,52154,3216,28645
8600000US28646,280,132,148,63390,101996,35511,28646
8600000US28647,53,19,34,,,,28647
8600000US28649,754,360,394,60754,102299,76409,28649
8600000US28650,8337,4242,4095,50092,62377,5033,28650
8600000US28651,5922,2924,2998,35919,49558,5230,28651
8600000US28652,0,0,0,,,,28652
8600000US28654,2700,1251,1449,45081,56491,8833,28654
8600000US28655,44266,22186,22080,43435,58281,2618,28655
8600000US28657,7154,3395,3759,35963,49592,5353,28657
8600000US28658,21170,10330,10840,46977,59163,3731,28658
8600000US28659,16524,8150,8374,33832,50619,3968,28659
8600000US28660,1512,713,799,45165,59937,8948,28660
8600000US28662,114,57,57,47222,48108,3491,28662
8600000US28663,545,268,277,47667,60120,13565,28663
8600000US28665,1868,964,904,34518,48925,8256,28665
8600000US28666,125,25,100,,21635,14787,28666
8600000US28667,346,167,179,36053,39224,10043,28667
8600000US28668,254,135,119,,84897,30492,28668
8600000US28669,2400,1317,1083,41250,63758,27101,28669
8600000US28670,2652,1293,1359,50774,60979,7716,28670
8600000US28671,531,227,304,40875,45308,8217,28671
8600000US28672,16,16,0,,,,28672
8600000US28673,4900,2465,2435,78479,99408,9995,28673
8600000US28675,5641,2762,2879,34069,47412,4378,28675
8600000US28676,3199,1566,1633,52543,82860,22341,28676
8600000US28677,26713,13041,13672,45191,57579,2485,28677
8600000US28678,5200,2598,2602,48083,76851,16579,28678
8600000US28679,1449,686,763,46250,62796,10227,28679
8600000US28681,20615,10650,9965,45788,61743,4384,28681
8600000US28682,1077,565,512,72589,87235,22762,28682
8600000US28683,894,461,433,28190,48327,14788,28683
8600000US28684,1852,892,960,41163,52347,8730,28684
8600000US28685,1638,802,836,37813,45933,7112,28685
8600000US28689,1545,757,788,61000,73147,14854,28689
8600000US28690,7232,3452,3780,41875,60114,6929,28690
8600000US28692,3256,1705,1551,56361,66793,5854,28692
8600000US28693,1416,706,710,35125,47359,10446,28693
8600000US28694,6162,3032,3130,43586,62492,10117,28694
8600000US28697,10901,4883,6018,46769,66464,8335,28697
8600000US28698,1756,913,843,42609,50453,8842,28698
8600000US28701,2579,1346,1233,53750,57644,7396,28701
8600000US28702,471,253,218,54327,98341,61977,28702
8600000US28704,14862,6725,8137,63223,88336,8180,28704
8600000US28705,5733,2842,2891,43878,50412,3752,28705
8600000US28707,121,53,68,,59007,39513,28707
8600000US28708,318,155,163,34674,40139,19895,28708
8600000US28709,1808,946,862,47250,54900,6849,28709
8600000US28711,11258,5112,6146,45329,60101,4150,28711
8600000US28712,17014,7973,9041,46490,62322,5316,28712
8600000US28713,6983,3336,3647,35963,49002,6044,28713
8600000US28714,13813,6630,7183,40422,54391,3979,28714
8600000US28715,20687,9937,10750,53594,73544,8786,28715
8600000US28716,14179,7019,7160,49018,61220,3611,28716
8600000US28717,1221,626,595,41108,61048,15609,28717
8600000US28718,306,128,178,43512,59063,22293,28718
8600000US28719,5921,2647,3274,37359,49686,4595,28719
8600000US28720,103,54,49,31500,61588,48197,28720
8600000US28721,7970,3636,4334,46290,56148,4398,28721
8600000US28722,5469,2550,2919,48028,71725,8986,28722
8600000US28723,10030,4631,5399,33180,43955,4020,28723
8600000US28725,46,36,10,,78029,66003,28725
8600000US28726,2498,1335,1163,36054,48254,9052,28726
8600000US28729,2723,1438,1285,52702,59771,7734,28729
8600000US28730,7159,3625,3534,62995,87907,10893,28730
8600000US28731,7072,3477,3595,55611,75660,7382,28731
8600000US28732,14054,6804,7250,59993,78448,5392,28732
8600000US28733,10,7,3,,,,28733
8600000US28734,21710,10224,11486,41766,53718,2914,28734
8600000US28735,272,167,105,30229,40707,20032,28735
8600000US28736,463,258,205,40777,50880,10821,28736
8600000US28739,18151,7912,10239,53965,74693,4844,28739
8600000US28740,697,360,337,33314,40181,7339,28740
8600000US28741,3279,1592,1687,61218,114626,19127,28741
8600000US28742,2117,1017,1100,65972,76202,8836,28742
8600000US28743,1658,719,939,38018,47178,7749,28743
8600000US28745,384,143,241,57222,68923,20115,28745
8600000US28746,2107,1087,1020,60400,90611,13060,28746
8600000US28747,1867,917,950,36653,64742,13009,28747
8600000US28748,9767,4717,5050,46075,55390,4369,28748
8600000US28749,29,13,16,,,,28749
8600000US28751,3121,1483,1638,48177,61763,6794,28751
8600000US28752,23877,11638,12239,41632,55225,4112,28752
8600000US28753,8274,3879,4395,40883,55694,4376,28753
8600000US28754,8178,4231,3947,45428,68705,8875,28754
8600000US28756,3509,1501,2008,49452,66421,11459,28756
8600000US28757,108,51,57,113365,110843,27209,28757
8600000US28759,5999,3032,2967,63547,76441,5233,28759
8600000US28761,6305,3163,3142,37889,59324,9092,28761
8600000US28762,5720,2862,2858,37845,53550,5530,28762
8600000US28763,2185,1063,1122,65754,83314,20679,28763
8600000US28766,1013,506,507,56500,65930,10070,28766
8600000US28768,6019,2803,3216,50267,64828,6096,28768
8600000US28771,6389,3082,3307,35238,45021,4613,28771
8600000US28772,898,470,428,45670,53557,8960,28772
8600000US28773,2534,1211,1323,51546,68186,8673,28773
8600000US28774,948,521,427,59167,77107,20033,28774
8600000US28775,260,113,147,,54915,34158,28775
8600000US28777,8904,5428,3476,45220,56619,7324,28777
8600000US28778,8493,4005,4488,46265,55897,6938,28778
8600000US28779,14549,6964,7585,53582,64481,4532,28779
8600000US28781,806,388,418,31429,66499,35144,28781
8600000US28782,5765,2817,2948,51262,68981,6142,28782
8600000US28783,1519,904,615,38459,44571,8805,28783
8600000US28785,6384,3249,3135,58551,84379,13530,28785
8600000US28786,17332,7958,9374,48486,68642,5435,28786
8600000US28787,16561,7927,8634,53258,69819,4066,28787
8600000US28789,4460,2318,2142,40708,61583,8401,28789
8600000US28790,2644,1361,1283,70641,90198,12488,28790
8600000US28791,12472,5629,6843,53964,69434,4311,28791
8600000US28792,26851,12724,14127,45629,59007,3226,28792
8600000US28801,11793,5886,5907,33504,59246,4306,28801
8600000US28803,27722,12273,15449,50475,80849,5067,28803
8600000US28804,18486,9050,9436,59855,93698,6995,28804
8600000US28805,16460,7475,8985,49893,66044,4241,28805
8600000US28806,34294,16324,17970,46726,62934,3966,28806
8600000US28901,3904,1900,2004,33628,42113,4484,28901
8600000US28902,1045,541,504,40167,51895,15893,28902
8600000US28904,7320,3396,3924,38188,59068,8460,28904
8600000US28905,2464,1155,1309,38871,51485,8378,28905
8600000US28906,16273,7932,8341,41856,53193,2862,28906
8600000US28909,799,350,449,42938,45823,7716,28909
8600000US29001,1601,710,891,38830,56746,18934,29001
8600000US29003,4944,2203,2741,42407,51433,5929,29003
8600000US29006,8284,3903,4381,47044,58656,5138,29006
8600000US29009,1808,709,1099,28352,33537,5757,29009
8600000US29010,10113,5520,4593,31317,46068,4963,29010
8600000US29014,1407,641,766,54128,68932,18602,29014
8600000US29015,1207,529,678,30368,43404,7633,29015
8600000US29016,15936,7437,8499,84733,96705,6222,29016
8600000US29018,2532,1260,1272,36133,60174,20019,29018
8600000US29020,17197,7923,9274,41215,59125,4866,29020
8600000US29030,1595,769,826,59231,84326,25019,29030
8600000US29031,862,437,425,41563,55749,15847,29031
8600000US29032,3414,1572,1842,33194,47500,7935,29032
8600000US29033,10251,4883,5368,50981,64250,6041,29033
8600000US29036,16925,8357,8568,84514,109460,6809,29036
8600000US29037,530,244,286,25125,35433,9895,29037
8600000US29038,1579,662,917,33690,51111,12170,29038
8600000US29039,2861,1279,1582,42292,50235,8288,29039
8600000US29040,7824,4177,3647,49167,61102,7050,29040
8600000US29042,4294,2205,2089,26054,37874,7679,29042
8600000US29044,4494,2076,2418,40593,50280,8438,29044
8600000US29045,19221,9700,9521,63179,76159,4244,29045
8600000US29046,143,41,102,31429,31625,9008,29046
8600000US29047,2762,1204,1558,26250,48835,14803,29047
8600000US29048,4083,2302,1781,37767,45941,7983,29048
8600000US29051,1785,1515,270,60917,55080,10724,29051
8600000US29052,1856,728,1128,43361,42297,8812,29052
8600000US29053,13370,6307,7063,41847,48103,2602,29053
8600000US29054,7105,3463,3642,64363,82940,8424,29054
8600000US29055,3012,1295,1717,28886,36783,4334,29055
8600000US29056,1666,758,908,30586,48953,11389,29056
8600000US29058,3822,2030,1792,40960,53993,8142,29058
8600000US29059,4457,2113,2344,32024,45603,5843,29059
8600000US29061,10970,5321,5649,53317,65189,7244,29061
8600000US29062,117,84,33,,28918,31502,29062
8600000US29063,28725,13828,14897,78983,93044,4341,29063
8600000US29065,424,161,263,46645,54379,16579,29065
8600000US29067,8681,5018,3663,39389,53565,4720,29067
8600000US29069,3530,1614,1916,29055,38816,4938,29069
8600000US29070,12332,5929,6403,54867,64427,3658,29070
8600000US29072,43768,21930,21838,81286,102506,3385,29072
8600000US29073,34990,16062,18928,59292,67973,2715,29073
8600000US29074,112,70,42,49643,56183,23199,29074
8600000US29075,2259,1183,1076,68482,74608,12962,29075
8600000US29078,12641,5897,6744,55651,64429,3354,29078
8600000US29079,10,0,10,,,,29079
8600000US29080,2105,925,1180,32857,40595,3932,29080
8600000US29081,1001,417,584,50337,61773,11424,29081
8600000US29082,375,174,201,31250,46988,10599,29082
8600000US29101,2234,1054,1180,33878,46726,5800,29101
8600000US29102,13261,6026,7235,38142,51961,3202,29102
8600000US29104,939,355,584,40592,53563,9606,29104
8600000US29105,804,355,449,28750,42860,8918,29105
8600000US29107,1992,913,1079,37875,48479,6088,29107
8600000US29108,15966,7643,8323,38136,49718,3424,29108
8600000US29111,1316,691,625,42045,67217,20465,29111
8600000US29112,3195,1434,1761,32206,47625,6581,29112
8600000US29113,1063,662,401,44318,62772,18392,29113
8600000US29114,1421,708,713,40130,56273,11629,29114
8600000US29115,21585,9211,12374,28941,43486,3924,29115
8600000US29117,1043,561,482,,,,29117
8600000US29118,13058,6156,6902,47458,63523,5050,29118
8600000US29122,36,15,21,58281,57690,24233,29122
8600000US29123,6354,3256,3098,43977,53927,4237,29123
8600000US29125,1817,1038,779,31814,53042,17357,29125
8600000US29126,1619,867,752,55784,68306,8676,29126
8600000US29127,6827,3194,3633,56568,74066,6346,29127
8600000US29128,4571,2555,2016,36635,49918,6407,29128
8600000US29129,2457,1306,1151,37903,52935,12237,29129
8600000US29130,4962,2356,2606,43988,58961,8386,29130
8600000US29133,712,346,366,37120,48019,13972,29133
8600000US29135,6641,2995,3646,42426,57595,5797,29135
8600000US29137,1598,876,722,39777,57745,15073,29137
8600000US29138,8287,4136,4151,40105,54099,7216,29138
8600000US29142,4137,1851,2286,33780,42499,5373,29142
8600000US29145,756,320,436,52853,65815,25785,29145
8600000US29146,1355,546,809,32188,55537,18109,29146
8600000US29147,0,0,0,,,,29147
8600000US29148,5854,2735,3119,34049,47059,5540,29148
8600000US29150,29538,13226,16312,37957,55123,3414,29150
8600000US29152,1369,761,608,26798,34621,6313,29152
8600000US29153,11570,5373,6197,43095,54498,4438,29153
8600000US29154,21752,10109,11643,51912,62787,3342,29154
8600000US29160,6258,3129,3129,39719,56951,6809,29160
8600000US29161,8405,3823,4582,40383,54509,5123,29161
8600000US29162,2285,1043,1242,40625,57287,8474,29162
8600000US29163,1682,625,1057,27157,33540,8963,29163
8600000US29164,3959,1991,1968,41626,52789,12012,29164
8600000US29166,750,395,355,53661,55377,10881,29166
8600000US29168,2888,1235,1653,34226,49728,8654,29168
8600000US29169,19945,9790,10155,43085,58833,3004,29169
8600000US29170,16858,8133,8725,58086,66136,3297,29170
8600000US29172,7408,3615,3793,50960,62211,5286,29172
8600000US29175,354,195,159,26250,37979,13740,29175
8600000US29178,2524,1273,1251,37258,52497,7046,29178
8600000US29180,11448,5610,5838,35871,58002,7816,29180
8600000US29201,20017,10325,9692,31795,51322,3472,29201
8600000US29202,269,144,125,74602,129906,48928,29202
8600000US29203,30426,13805,16621,30830,44347,2784,29203
8600000US29204,15681,7322,8359,41178,61710,4413,29204
8600000US29205,20929,10589,10340,51631,84495,6205,29205
8600000US29206,14168,6823,7345,74112,110339,9787,29206
8600000US29207,11544,7671,3873,,,,29207
8600000US29208,755,297,458,,,,29208
8600000US29209,26636,13160,13476,53319,78336,5146,29209
8600000US29210,32956,16480,16476,41605,53267,3780,29210
8600000US29212,23204,10902,12302,69130,89208,4474,29212
8600000US29223,39076,16879,22197,50665,71326,4279,29223
8600000US29225,1284,210,1074,,,,29225
8600000US29229,35876,15192,20684,70490,79266,3951,29229
8600000US29301,27075,12836,14239,42796,61383,3655,29301
8600000US29302,13293,6440,6853,58058,93165,6793,29302
8600000US29303,19888,9065,10823,35452,43664,2509,29303
8600000US29306,11818,5263,6555,31125,48704,3740,29306
8600000US29307,14278,6381,7897,46404,60045,3289,29307
8600000US29316,20313,9378,10935,58903,74513,6787,29316
8600000US29320,598,228,370,,35280,21381,29320
8600000US29321,2355,1035,1320,44029,48143,7832,29321
8600000US29322,6516,3469,3047,58225,81507,15171,29322
8600000US29323,10085,4769,5316,44672,63033,10669,29323
8600000US29324,236,170,66,24167,29013,8812,29324
8600000US29325,12261,5654,6607,39156,53274,4982,29325
8600000US29329,204,124,80,,25949,17875,29329
8600000US29330,7046,3373,3673,45274,54233,4893,29330
8600000US29331,158,107,51,,30411,13518,29331
8600000US29332,1909,941,968,35659,51984,7945,29332
8600000US29333,460,227,233,61429,88367,35041,29333
8600000US29334,10131,4970,5161,62000,74656,6515,29334
8600000US29335,4691,3024,1667,34316,50799,4562,29335
8600000US29338,26,13,13,,,,29338
8600000US29340,16500,7992,8508,35054,46886,3384,29340
8600000US29341,15263,7350,7913,41454,61966,10500,29341
8600000US29346,267,113,154,49250,64964,23495,29346
8600000US29349,23895,11634,12261,58378,73865,4595,29349
8600000US29351,1120,650,470,41862,44768,7144,29351
8600000US29353,3493,1734,1759,46377,58633,7749,29353
8600000US29355,795,370,425,30395,72992,45984,29355
8600000US29356,6862,3334,3528,51747,64151,5110,29356
8600000US29360,16008,7566,8442,38770,56490,8840,29360
8600000US29364,382,151,231,28571,30771,6921,29364
8600000US29365,8343,4227,4116,62016,69711,5494,29365
8600000US29368,96,46,50,,,,29368
8600000US29369,10567,4826,5741,75273,87683,5374,29369
8600000US29370,850,436,414,52917,55879,15611,29370
8600000US29372,3173,1561,1612,44000,51730,4815,29372
8600000US29373,366,238,128,43750,48038,15303,29373
8600000US29374,2878,1489,1389,46721,61624,8665,29374
8600000US29375,42,23,19,41429,46204,19025,29375
8600000US29376,6101,2992,3109,63750,79260,7664,29376
8600000US29377,863,422,441,26823,32269,8263,29377
8600000US29378,68,0,68,,19901,7487,29378
8600000US29379,13821,6445,7376,38370,53181,7798,29379
8600000US29384,3458,1691,1767,43031,50995,5464,29384
8600000US29385,5464,2398,3066,46875,54877,4782,29385
8600000US29388,11981,5667,6314,47252,58861,4517,29388
8600000US29401,8612,3918,4694,75375,159927,19325,29401
8600000US29403,18702,8489,10213,42076,67215,3504,29403
8600000US29404,1327,750,577,49063,65924,13490,29404
8600000US29405,23426,12054,11372,35240,53266,4362,29405
8600000US29406,23834,11550,12284,35173,45725,2747,29406
8600000US29407,28640,13013,15627,56167,79314,3840,29407
8600000US29409,2642,2435,207,,,,29409
8600000US29410,17041,8624,8417,65329,77614,3390,29410
8600000US29412,33208,15640,17568,74664,97667,6141,29412
8600000US29414,32436,15846,16590,70762,84068,4138,29414
8600000US29418,17834,8062,9772,39577,51910,4020,29418
8600000US29420,17426,8335,9091,64561,77586,5037,29420
8600000US29423,1020,418,602,,,,29423
8600000US29424,382,214,168,,,,29424
8600000US29426,1583,567,1016,39167,62533,12369,29426
8600000US29429,2471,1153,1318,68071,72572,9029,29429
8600000US29431,5323,2611,2712,53310,61812,5777,29431
8600000US29432,2696,1135,1561,38608,50788,8057,29432
8600000US29434,389,185,204,34271,44467,9996,29434
8600000US29435,3543,1697,1846,36357,58060,9643,29435
8600000US29436,3539,1626,1913,34303,50875,10902,29436
8600000US29437,2446,1196,1250,49479,58495,9611,29437
8600000US29438,2304,1115,1189,54811,92717,13040,29438
8600000US29439,2183,1162,1021,77206,93291,27837,29439
8600000US29440,21319,9718,11601,37146,54823,3545,29440
8600000US29445,45909,23254,22655,58595,72054,2793,29445
8600000US29446,811,412,399,70288,93854,37249,29446
8600000US29448,1772,640,1132,20357,60907,29307,29448
8600000US29449,6863,3241,3622,51266,82639,16377,29449
8600000US29450,2960,1376,1584,55841,71013,15849,29450
8600000US29451,3810,1861,1949,111372,155733,17859,29451
8600000US29452,465,229,236,32721,39623,13019,29452
8600000US29453,867,430,437,34167,46905,10506,29453
8600000US29455,18906,8762,10144,73418,113624,8223,29455
8600000US29456,22758,10952,11806,60415,68472,3638,29456
8600000US29458,2759,1426,1333,38155,51641,9255,29458
8600000US29461,27990,13660,14330,58946,68929,3149,29461
8600000US29464,41238,19200,22038,86446,123292,6605,29464
8600000US29466,27143,12965,14178,103538,138528,11763,29466
8600000US29468,1828,910,918,32095,37527,6232,29468
8600000US29469,804,461,343,84583,113097,48382,29469
8600000US29470,3984,2004,1980,53583,69966,9722,29470
8600000US29471,1180,540,640,44196,58408,10772,29471
8600000US29472,7735,4620,3115,46339,62165,7541,29472
8600000US29474,1619,767,852,35417,52134,8183,29474
8600000US29475,1565,724,841,29417,44346,7657,29475
8600000US29477,5461,2440,3021,37041,53171,6111,29477
8600000US29479,5230,2516,2714,32902,47259,4686,29479
8600000US29481,1254,550,704,34667,42771,6488,29481
8600000US29482,1689,805,884,135577,216733,27566,29482
8600000US29483,60409,28683,31726,60606,75858,3064,29483
8600000US29485,42152,20553,21599,66958,81057,3479,29485
8600000US29487,2375,1197,1178,56786,67686,7907,29487
8600000US29488,16547,7853,8694,36409,47025,3446,29488
8600000US29492,9717,4498,5219,102106,139037,10189,29492
8600000US29493,108,53,55,56250,70396,27202,29493
8600000US29501,35810,16137,19673,49658,74294,3916,29501
8600000US29505,18873,8245,10628,53447,68864,4484,29505
8600000US29506,16183,7043,9140,35136,47452,3003,29506
8600000US29510,8161,3773,4388,36268,59523,10906,29510
8600000US29511,3935,1853,2082,52565,59343,6530,29511
8600000US29512,14531,7922,6609,33840,45568,4146,29512
8600000US29516,763,382,381,37237,48019,9768,29516
8600000US29518,901,510,391,34063,40627,8601,29518
8600000US29519,200,118,82,25761,37335,17138,29519
8600000US29520,10714,4778,5936,39784,55978,7148,29520
8600000US29525,1692,822,870,35662,46538,8843,29525
8600000US29526,38616,19349,19267,46218,59986,3140,29526
8600000US29527,19856,9182,10674,40409,49760,2755,29527
8600000US29530,1799,875,924,43750,50079,6287,29530
8600000US29532,16299,7569,8730,31921,49160,3453,29532
8600000US29536,11945,5361,6584,29102,40917,3399,29536
8600000US29540,4078,1989,2089,30580,43374,6519,29540
8600000US29541,7467,3769,3698,49570,76866,18599,29541
8600000US29543,478,232,246,,46786,17120,29543
8600000US29544,4026,1843,2183,42519,50700,4812,29544
8600000US29545,1095,514,581,29571,39820,7793,29545
8600000US29546,2322,900,1422,35022,49291,8723,29546
8600000US29547,2509,1277,1232,26627,50378,29392,29547
8600000US29550,24417,11639,12778,42243,60104,3380,29550
8600000US29554,6563,2919,3644,36144,49858,7782,29554
8600000US29555,4127,1974,2153,44118,63278,12247,29555
8600000US29556,9009,3806,5203,30625,42894,5870,29556
8600000US29560,9618,4199,5419,38335,47167,3561,29560
8600000US29563,1838,850,988,28824,41653,6393,29563
8600000US29564,625,265,360,22467,39325,11620,29564
8600000US29565,5467,2472,2995,32376,48278,6959,29565
8600000US29566,14917,7206,7711,49477,62548,5060,29566
8600000US29567,402,171,231,26367,81316,58985,29567
8600000US29568,11838,5347,6491,45759,55040,4282,29568
8600000US29569,13806,6249,7557,34656,46341,3325,29569
8600000US29570,2742,1344,1398,26981,38251,4390,29570
8600000US29571,10858,4754,6104,32764,49720,8613,29571
8600000US29572,8276,4112,4164,52283,93269,10469,29572
8600000US29574,9007,4245,4762,32394,51857,15095,29574
8600000US29575,15865,7546,8319,51278,67645,5227,29575
8600000US29576,27637,12518,15119,56060,72665,4859,29576
8600000US29577,25273,12024,13249,40416,61866,3830,29577
8600000US29579,31251,14894,16357,56339,71683,3461,29579
8600000US29580,1083,492,591,30179,39722,8646,29580
8600000US29581,3787,1652,2135,35175,45270,5037,29581
8600000US29582,14809,7254,7555,56138,77474,4823,29582
8600000US29583,3951,1876,2075,39003,54293,6054,29583
8600000US29584,1822,916,906,37452,49216,10140,29584
8600000US29585,13091,6356,6735,75427,98386,7863,29585
8600000US29588,35846,17473,18373,49432,62977,3388,29588
8600000US29590,2933,2100,833,30409,38064,5830,29590
8600000US29591,4163,2112,2051,36953,48142,4883,29591
8600000US29592,582,219,363,35568,38876,9292,29592
8600000US29593,1308,553,755,25469,35840,6409,29593
8600000US29594,74,28,46,25250,27314,4701,29594
8600000US29596,1781,936,845,42661,53216,7485,29596
8600000US29601,10234,5737,4497,47451,83539,7633,29601
8600000US29605,27126,12535,14591,48235,82442,5197,29605
8600000US29607,32139,14540,17599,57536,78501,4337,29607
8600000US29609,22426,10807,11619,48079,76094,4364,29609
8600000US29611,22710,10533,12177,33570,42868,2382,29611
8600000US29613,1909,813,1096,,,,29613
8600000US29614,2121,882,1239,20000,34626,17986,29614
8600000US29615,30650,14403,16247,60185,88957,6342,29615
8600000US29617,21884,10228,11656,37907,54372,4442,29617
8600000US29620,10114,4875,5239,36963,53667,7003,29620
8600000US29621,32221,14666,17555,56887,78706,4515,29621
8600000US29624,12293,5662,6631,24583,35577,3500,29624
8600000US29625,22481,10528,11953,47198,58083,3131,29625
8600000US29626,9893,4555,5338,45272,64306,7565,29626
8600000US29627,14631,7168,7463,42661,52167,2867,29627
8600000US29628,1924,905,1019,25975,40441,10644,29628
8600000US29630,12696,6274,6422,31250,47768,3424,29630
8600000US29631,13121,7275,5846,42886,71555,7481,29631
8600000US29634,5080,2224,2856,,12877,11311,29634
8600000US29635,1063,519,544,49500,73196,16051,29635
8600000US29638,2639,1287,1352,48315,62416,10315,29638
8600000US29639,1373,687,686,46944,55549,8695,29639
8600000US29640,23634,11458,12176,45804,57258,2365,29640
8600000US29642,24546,11984,12562,66813,80912,3131,29642
8600000US29643,1770,960,810,62813,91922,17190,29643
8600000US29644,15989,7888,8101,60683,71145,5602,29644
8600000US29645,7429,3453,3976,47559,55831,4030,29645
8600000US29646,20581,9787,10794,33979,48062,3333,29646
8600000US29649,21065,9094,11971,48726,69178,7200,29649
8600000US29650,25709,12226,13483,74597,95504,4757,29650
8600000US29651,35923,17901,18022,58029,78038,4337,29651
8600000US29653,3651,1791,1860,45581,59706,5581,29653
8600000US29654,7326,3426,3900,42406,58377,7600,29654
8600000US29655,5562,2650,2912,37523,51462,6329,29655
8600000US29657,12113,5911,6202,48724,61354,5932,29657
8600000US29658,411,192,219,48250,134806,105471,29658
8600000US29659,68,27,41,25729,32483,12995,29659
8600000US29661,4605,2054,2551,50328,64455,7953,29661
8600000US29662,12170,5645,6525,60051,70126,4589,29662
8600000US29664,1792,907,885,41589,48434,6775,29664
8600000US29665,140,64,76,37159,31435,17193,29665
8600000US29666,5366,2410,2956,46553,62650,7385,29666
8600000US29667,191,90,101,46250,86499,48010,29667
8600000US29669,9363,4506,4857,47209,58346,3783,29669
8600000US29670,7073,3829,3244,48169,62239,5628,29670
8600000US29671,13634,6710,6924,47446,61383,4643,29671
8600000US29672,10174,5121,5053,58833,87673,7375,29672
8600000US29673,22188,10861,11327,56091,71030,4353,29673
8600000US29676,4775,2374,2401,67484,108392,20284,29676
8600000US29678,17526,8420,9106,41277,57200,4843,29678
8600000US29680,24235,11906,12329,71741,86613,4317,29680
8600000US29681,41953,19795,22158,82721,104033,3860,29681
8600000US29682,2796,1389,1407,56593,68698,7854,29682
8600000US29683,162,94,68,43000,47014,14453,29683
8600000US29684,3069,1388,1681,44182,49532,4913,29684
8600000US29685,1472,797,675,66115,138981,37800,29685
8600000US29686,778,431,347,,60239,18067,29686
8600000US29687,31958,15496,16462,53318,68318,3553,29687
8600000US29689,3141,1478,1663,49821,66157,8991,29689
8600000US29690,18198,9004,9194,54071,71858,6081,29690
8600000US29691,8579,4052,4527,34859,46411,3319,29691
8600000US29692,3685,1727,1958,38237,49792,6520,29692
8600000US29693,11439,5552,5887,41875,55170,3611,29693
8600000US29696,3977,1964,2013,53537,70469,8566,29696
8600000US29697,9873,4791,5082,44767,56378,4265,29697
8600000US29702,7583,3640,3943,29944,44532,4772,29702
8600000US29704,2850,1299,1551,53462,71626,13823,29704
8600000US29706,15229,7261,7968,37286,49949,3057,29706
8600000US29707,22316,10586,11730,81228,101876,5807,29707
8600000US29708,24097,11849,12248,110297,130501,6107,29708
8600000US29709,5596,2765,2831,46607,54372,4218,29709
8600000US29710,26815,12924,13891,68716,89247,4986,29710
8600000US29712,1662,841,821,54878,81794,24430,29712
8600000US29714,2263,1091,1172,43425,49597,9331,29714
8600000US29715,23096,10956,12140,77956,93945,4040,29715
8600000US29717,1058,515,543,47852,55710,7843,29717
8600000US29718,3285,1657,1628,41302,48877,4505,29718
8600000US29720,37241,17115,20126,40823,64386,5613,29720
8600000US29724,15,7,8,,,,29724
8600000US29726,1244,612,632,39736,54757,7947,29726
8600000US29727,1161,571,590,41838,46723,6486,29727
8600000US29728,7441,3713,3728,34410,49541,6461,29728
8600000US29729,1733,899,834,42059,57360,8393,29729
8600000US29730,42592,20086,22506,46736,60914,2967,29730
8600000US29732,45370,21367,24003,61482,80612,3509,29732
8600000US29733,1844,452,1392,,,,29733
8600000US29741,1878,909,969,42043,53459,8307,29741
8600000US29742,2027,1054,973,45437,54520,7242,29742
8600000US29743,675,331,344,40096,50390,12017,29743
8600000US29745,23300,10784,12516,52808,70337,4344,29745
8600000US29801,22478,10423,12055,41703,56001,3683,29801
8600000US29803,31164,15156,16008,63809,83586,3316,29803
8600000US29805,4751,2177,2574,54422,65066,9483,29805
8600000US29809,2002,860,1142,40795,49073,7321,29809
8600000US29810,3309,1513,1796,22096,34622,5190,29810
8600000US29812,8682,4078,4604,36383,51441,4267,29812
8600000US29816,782,401,381,24231,31270,8155,29816
8600000US29817,3266,1449,1817,31829,41852,5578,29817
8600000US29819,1352,560,792,44267,49076,7357,29819
8600000US29821,1129,565,564,56637,69589,8519,29821
8600000US29824,7101,4327,2774,40775,56398,6910,29824
8600000US29826,107,47,60,31875,34511,7950,29826
8600000US29827,3500,2192,1308,30490,42600,7562,29827
8600000US29828,576,233,343,33409,55950,40031,29828
8600000US29829,8650,4192,4458,53899,67960,5551,29829
8600000US29831,3434,1705,1729,44935,54210,4800,29831
8600000US29832,4081,2091,1990,33780,52172,6004,29832
8600000US29834,1292,652,640,30633,38620,6967,29834
8600000US29835,5438,2558,2880,41205,54168,4072,29835
8600000US29836,341,156,185,34632,45148,16965,29836
8600000US29838,366,182,184,60179,96556,40298,29838
8600000US29840,318,168,150,16382,25859,10626,29840
8600000US29841,24629,11424,13205,49077,62748,3370,29841
8600000US29842,5662,2649,3013,39750,49861,5119,29842
8600000US29843,873,418,455,36346,43339,9508,29843
8600000US29844,123,61,62,71667,66281,10352,29844
8600000US29845,796,372,424,38750,68020,45427,29845
8600000US29847,4355,2512,1843,44471,65932,11426,29847
8600000US29848,475,254,221,45179,57482,10333,29848
8600000US29849,410,168,242,38636,37570,7569,29849
8600000US29850,107,0,107,23359,23278,7694,29850
8600000US29851,5656,2717,2939,43780,60958,8947,29851
8600000US29853,4824,2392,2432,40664,50255,5772,29853
8600000US29856,2049,993,1056,41500,69765,27568,29856
8600000US29860,12595,5887,6708,80433,96082,8123,29860
8600000US29899,1120,1120,0,,,,29899
8600000US29902,12191,5864,6327,52813,73527,6751,29902
8600000US29904,712,634,78,,,,29904
8600000US29905,3025,2482,543,78750,77369,8202,29905
8600000US29906,17867,8255,9612,47391,60397,3962,29906
8600000US29907,11264,5726,5538,67679,83577,5754,29907
8600000US29909,17500,7774,9726,68351,87705,6702,29909
8600000US29910,31391,15658,15733,70414,92397,6071,29910
8600000US29911,1285,593,692,33494,47015,8816,29911
8600000US29912,0,0,0,,,,29912
8600000US29915,422,211,211,140865,258910,94771,29915
8600000US29916,1212,582,630,55227,60995,10650,29916
8600000US29918,4557,2661,1896,31056,41816,4821,29918
8600000US29920,9568,4497,5071,51625,72248,5021,29920
8600000US29921,188,94,94,31615,35763,5794,29921
8600000US29922,624,365,259,26625,37337,8361,29922
8600000US29923,301,124,177,19583,26768,11117,29923
8600000US29924,3382,1650,1732,33763,42409,4874,29924
8600000US29926,21727,10685,11042,72388,101741,6059,29926
8600000US29927,7240,3794,3446,41087,55806,6867,29927
8600000US29928,14667,6783,7884,77725,134245,13161,29928
8600000US29929,814,367,447,40385,44268,6225,29929
8600000US29932,131,49,82,19688,34209,11139,29932
8600000US29934,854,459,395,34141,46424,23737,29934
8600000US29935,3327,1702,1625,40998,53925,9550,29935
8600000US29936,10873,5461,5412,40478,53144,4928,29936
8600000US29939,295,178,117,26875,35231,8304,29939
8600000US29940,3119,1471,1648,39194,53849,6249,29940
8600000US29941,506,219,287,22163,28465,7100,29941
8600000US29943,496,349,147,30082,27047,6512,29943
8600000US29944,3052,1475,1577,32143,45714,5566,29944
8600000US29945,4199,1748,2451,34685,50984,9912,29945
8600000US30002,4650,2087,2563,59931,96597,10009,30002
8600000US30004,46374,23005,23369,111925,161635,10931,30004
8600000US30005,28287,14383,13904,127764,159960,8395,30005
8600000US30008,23441,11774,11667,47702,65173,6066,30008
8600000US30009,12051,5681,6370,91811,124136,11351,30009
8600000US30011,11525,5813,5712,62283,75091,4711,30011
8600000US30012,19627,8801,10826,43492,60382,4728,30012
8600000US30013,20569,9626,10943,61085,79163,6340,30013
8600000US30014,27944,12573,15371,48076,65258,4722,30014
8600000US30016,39446,18278,21168,54575,66040,3954,30016
8600000US30017,17625,8305,9320,93813,117506,8798,30017
8600000US30019,35012,16278,18734,96742,116008,8029,30019
8600000US30021,16199,7721,8478,34360,45887,2228,30021
8600000US30022,51119,25100,26019,105988,141259,5220,30022
8600000US30024,54656,25962,28694,108845,131117,4020,30024
8600000US30025,7277,3608,3669,69710,85795,7539,30025
8600000US30028,18074,8694,9380,87759,101665,4751,30028
8600000US30030,21324,8892,12432,81331,118206,7001,30030
8600000US30032,39399,19011,20388,38448,51282,2769,30032
8600000US30033,27199,12623,14576,78053,107233,6444,30033
8600000US30034,35537,15342,20195,51603,65794,4219,30034
8600000US30035,17185,7732,9453,43595,54706,4987,30035
8600000US30038,28310,11778,16532,48203,62867,4755,30038
8600000US30039,33177,15637,17540,66774,78927,3124,30039
8600000US30040,50201,24527,25674,94377,113263,4097,30040
8600000US30041,47714,23383,24331,107284,129633,3558,30041
8600000US30043,67193,32768,34425,76493,91866,3509,30043
8600000US30044,62561,30733,31828,61130,75170,3411,30044
8600000US30045,28056,13068,14988,79568,93272,7043,30045
8600000US30046,27196,13119,14077,49084,65674,3771,30046
8600000US30047,48696,24343,24353,70307,88471,3440,30047
8600000US30052,47786,22848,24938,67394,79865,2937,30052
8600000US30054,9139,4459,4680,61843,75678,7490,30054
8600000US30055,2396,1160,1236,69595,82330,12275,30055
8600000US30056,1672,851,821,50462,66439,9557,30056
8600000US30058,41996,17610,24386,51470,65397,3862,30058
8600000US30060,30022,15582,14440,44597,60194,3138,30060
8600000US30062,48372,23656,24716,99101,125107,4754,30062
8600000US30064,37057,17471,19586,90567,116592,4917,30064
8600000US30066,43673,21482,22191,90034,112926,5010,30066
8600000US30067,35993,17276,18717,57816,91787,5950,30067
8600000US30068,24353,11852,12501,117475,147937,6044,30068
8600000US30070,339,121,218,17404,27849,10700,30070
8600000US30071,17569,9018,8551,49175,67198,3846,30071
8600000US30072,640,228,412,55114,70109,9526,30072
8600000US30075,40520,19477,21043,116923,150824,5584,30075
8600000US30076,34370,17249,17121,74454,104683,5285,30076
8600000US30078,26660,12679,13981,70966,97020,9040,30078
8600000US30079,2233,1003,1230,48750,62373,10885,30079
8600000US30080,43245,20666,22579,68529,93958,3660,30080
8600000US30082,22018,10213,11805,75548,93114,5619,30082
8600000US30083,43194,19426,23768,40489,51785,2557,30083
8600000US30084,30485,14634,15851,66523,82143,3734,30084
8600000US30087,30821,14369,16452,72805,94347,3946,30087
8600000US30088,22782,9843,12939,50171,57351,2935,30088
8600000US30092,27061,12902,14159,62114,94067,5186,30092
8600000US30093,38546,19782,18764,41043,49636,2178,30093
8600000US30094,26287,12027,14260,67870,80359,4171,30094
8600000US30096,51158,23113,28045,53514,71053,2207,30096
8600000US30097,34825,16411,18414,101119,143121,8396,30097
8600000US30101,42591,20749,21842,88809,105937,5291,30101
8600000US30102,31959,15734,16225,64585,79842,3128,30102
8600000US30103,12335,5823,6512,47534,63009,6400,30103
8600000US30104,4056,2201,1855,58112,69672,9109,30104
8600000US30105,1493,706,787,58393,68536,8541,30105
8600000US30106,15973,7107,8866,52294,67907,5629,30106
8600000US30107,11054,5714,5340,74200,87975,6534,30107
8600000US30108,5967,2948,3019,39464,53552,4814,30108
8600000US30110,9741,4609,5132,47676,69097,8975,30110
8600000US30113,4883,2458,2425,45175,56994,5403,30113
8600000US30114,39143,18787,20356,72730,93786,6911,30114
8600000US30115,29658,14143,15515,90519,107035,4385,30115
8600000US30116,18437,9549,8888,54823,72262,5471,30116
8600000US30117,26983,12556,14427,43871,62190,4773,30117
8600000US30118,2159,773,1386,,,,30118
8600000US30120,30753,14588,16165,58240,73378,4849,30120
8600000US30121,17581,8443,9138,53658,66988,6727,30121
8600000US30122,19293,9465,9828,54360,66327,6265,30122
8600000US30124,2288,1159,1129,44301,58069,6869,30124
8600000US30125,17885,8753,9132,41210,62434,12498,30125
8600000US30126,31004,14076,16928,78028,106775,7257,30126
8600000US30127,50438,24249,26189,78060,97711,3516,30127
8600000US30132,29621,14153,15468,67641,81612,4866,30132
8600000US30134,32244,14628,17616,52875,65713,5124,30134
8600000US30135,48799,22683,26116,72968,84563,3162,30135
8600000US30137,1289,603,686,51806,62362,10219,30137
8600000US30139,3227,1790,1437,49444,57973,5755,30139
8600000US30141,18325,8600,9725,61329,74763,4917,30141
8600000US30143,17689,8636,9053,68162,82047,6386,30143
8600000US30144,44290,20391,23899,68581,84553,4124,30144
8600000US30145,5650,2907,2743,65030,71659,6775,30145
8600000US30147,3442,1557,1885,48652,66126,11200,30147
8600000US30148,592,291,301,42402,61360,23516,30148
8600000US30149,1876,558,1318,,103772,37071,30149
8600000US30152,31994,15258,16736,89729,109739,5485,30152
8600000US30153,12812,5887,6925,45657,57668,6465,30153
8600000US30157,35887,16682,19205,63119,74767,4259,30157
8600000US30161,26363,12519,13844,41082,61764,3622,30161
8600000US30164,0,0,0,,,,30164
8600000US30165,31036,15088,15948,50283,70812,3990,30165
8600000US30168,18222,7982,10240,44911,55991,3034,30168
8600000US30170,2235,1170,1065,50385,64500,8181,30170
8600000US30171,2927,1589,1338,66179,79980,10637,30171
8600000US30173,4422,1964,2458,45292,55637,7408,30173
8600000US30175,4281,2018,2263,52007,69343,9036,30175
8600000US30176,5075,2383,2692,44309,55311,7516,30176
8600000US30177,1016,533,483,55456,79124,23176,30177
8600000US30178,2295,1266,1029,50750,68723,13281,30178
8600000US30179,14684,7289,7395,57803,69048,7183,30179
8600000US30180,26460,12129,14331,61702,77143,4596,30180
8600000US30182,2161,1014,1147,37217,55670,9633,30182
8600000US30183,5095,2336,2759,76800,95744,17712,30183
8600000US30184,5200,2669,2531,63750,77581,9876,30184
8600000US30185,3158,1479,1679,53491,62434,7712,30185
8600000US30187,5881,2957,2924,73399,83897,7406,30187
8600000US30188,47337,22497,24840,77454,96462,3989,30188
8600000US30189,29047,14595,14452,87366,105389,5896,30189
8600000US30204,10550,4783,5767,37441,52929,4594,30204
8600000US30205,2206,1114,1092,87664,103389,17152,30205
8600000US30206,2657,1318,1339,66050,74343,7757,30206
8600000US30213,22439,9492,12947,52539,63102,4860,30213
8600000US30214,23884,11161,12723,72770,92490,5461,30214
8600000US30215,27588,13049,14539,92806,118885,7547,30215
8600000US30216,1753,869,884,34792,45709,6984,30216
8600000US30217,6984,3308,3676,47540,54955,3281,30217
8600000US30218,1201,667,534,53667,61758,12562,30218
8600000US30220,4055,1911,2144,52243,60186,6261,30220
8600000US30222,2989,1197,1792,33405,44300,8097,30222
8600000US30223,28683,13616,15067,39341,52277,2401,30223
8600000US30224,18733,8733,10000,46863,69061,5881,30224
8600000US30228,30040,13467,16573,63243,72001,3878,30228
8600000US30230,7298,3548,3750,36929,53928,5222,30230
8600000US30233,18794,10392,8402,44748,72722,14625,30233
8600000US30234,1394,510,884,39460,53128,11233,30234
8600000US30236,36256,17295,18961,50906,64971,3442,30236
8600000US30238,26898,11989,14909,48880,59581,3746,30238
8600000US30240,21634,9741,11893,44422,61895,3057,30240
8600000US30241,18995,9397,9598,43717,56800,4101,30241
8600000US30248,17748,8521,9227,68030,78439,5329,30248
8600000US30250,630,570,60,,,,30250
8600000US30251,1906,923,983,41411,54681,11889,30251
8600000US30252,33577,15942,17635,83727,97603,4412,30252
8600000US30253,40967,19007,21960,65675,79309,3802,30253
8600000US30256,1836,935,901,52500,70653,13340,30256
8600000US30257,3259,1672,1587,46691,60653,12928,30257
8600000US30258,2404,1143,1261,49454,61318,8099,30258
8600000US30259,2310,1091,1219,67150,92203,20318,30259
8600000US30260,19420,9102,10318,46834,54317,3308,30260
8600000US30263,43847,20768,23079,55699,74992,4261,30263
8600000US30265,25951,12221,13730,83485,102264,5458,30265
8600000US30268,7485,3452,4033,51902,62958,7329,30268
8600000US30269,26941,13126,13815,95837,127456,7567,30269
8600000US30273,10743,4615,6128,58690,66548,8591,30273
8600000US30274,25543,11182,14361,41676,49231,2182,30274
8600000US30275,0,0,0,,,,30275
8600000US30276,11650,5986,5664,78604,95917,10851,30276
8600000US30277,16732,8421,8311,83424,99201,5802,30277
8600000US30281,50205,23257,26948,58003,72401,3195,30281
8600000US30284,61,26,35,,42453,17862,30284
8600000US30285,551,257,294,39856,66465,34682,30285
8600000US30286,16853,7818,9035,34568,50080,4305,30286
8600000US30288,6947,3277,3670,54365,58346,5361,30288
8600000US30289,193,104,89,153452,125178,28313,30289
8600000US30290,6496,2952,3544,94769,116025,10866,30290
8600000US30291,15419,6188,9231,37357,45005,3930,30291
8600000US30292,4257,1944,2313,63181,73527,6900,30292
8600000US30293,2416,1132,1284,40527,58053,13176,30293
8600000US30294,32078,14294,17784,65446,78749,4806,30294
8600000US30295,3353,1633,1720,52287,57818,8089,30295
8600000US30296,21024,9093,11931,54273,66110,4466,30296
8600000US30297,19282,9392,9890,34295,45447,5893,30297
8600000US30303,6616,3641,2975,22663,42802,8053,30303
8600000US30305,19883,9566,10317,101718,183054,14466,30305
8600000US30306,19822,9972,9850,104934,173162,10663,30306
8600000US30307,16028,7701,8327,98986,148934,10235,30307
8600000US30308,16869,9404,7465,60370,85625,5931,30308
8600000US30309,22099,11055,11044,88691,144017,12102,30309
8600000US30310,22529,10362,12167,31490,50113,8037,30310
8600000US30311,28162,11544,16618,29153,46539,3125,30311
8600000US30312,18524,8667,9857,52003,73811,3555,30312
8600000US30313,10769,6798,3971,54469,72069,9336,30313
8600000US30314,19860,8910,10950,26752,36679,2227,30314
8600000US30315,26204,12888,13316,28249,48191,3754,30315
8600000US30316,27595,13520,14075,66880,87418,4241,30316
8600000US30317,10730,4943,5787,69063,95141,6553,30317
8600000US30318,44474,24235,20239,47918,74356,2716,30318
8600000US30319,34424,16583,17841,100679,151183,8371,30319
8600000US30322,2790,1237,1553,,,,30322
8600000US30324,23877,12169,11708,70657,100369,5307,30324
8600000US30326,5604,2515,3089,82225,127175,20139,30326
8600000US30327,17115,8320,8795,154738,260100,15169,30327
8600000US30328,30287,13968,16319,83860,123137,7344,30328
8600000US30329,21323,10273,11050,54274,80249,5014,30329
8600000US30331,48162,20036,28126,45852,64109,3304,30331
8600000US30332,3079,1733,1346,,,,30332
8600000US30334,0,0,0,,,,30334
8600000US30336,217,115,102,,53034,29956,30336
8600000US30337,10130,4749,5381,34003,58988,12418,30337
8600000US30338,25947,12091,13856,101982,134735,6699,30338
8600000US30339,20707,9477,11230,79883,117826,8596,30339
8600000US30340,20345,10666,9679,48250,64831,3387,30340
8600000US30341,24506,12685,11821,60154,85425,5373,30341
8600000US30342,22467,10381,12086,84458,168980,14387,30342
8600000US30344,25380,11559,13821,40750,52497,3513,30344
8600000US30345,19549,10130,9419,76635,113505,6191,30345
8600000US30346,4349,2356,1993,90190,101246,9928,30346
8600000US30349,54570,24429,30141,49316,62353,3023,30349
8600000US30350,31530,15238,16292,64722,106818,5411,30350
8600000US30354,12178,5007,7171,37967,45300,3132,30354
8600000US30360,11124,5637,5487,70063,91248,5079,30360
8600000US30363,3441,2041,1400,59591,88571,15744,30363
8600000US30401,9887,4676,5211,36210,46162,3806,30401
8600000US30410,1276,630,646,49125,62428,10320,30410
8600000US30411,4179,3043,1136,32372,40498,6779,30411
8600000US30412,64,33,31,,72292,23467,30412
8600000US30413,1360,564,796,46250,50011,9175,30413
8600000US30415,4843,2194,2649,56324,66350,5607,30415
8600000US30417,7972,3772,4200,39801,53763,4246,30417
8600000US30420,704,309,395,31094,48240,11023,30420
8600000US30421,2457,1079,1378,48598,60471,8113,30421
8600000US30423,72,26,46,,126730,159213,30423
8600000US30425,1032,469,563,44500,50526,7711,30425
8600000US30426,527,245,282,40625,48486,10328,30426
8600000US30427,9571,5408,4163,43108,63952,7300,30427
8600000US30428,2205,1218,987,29429,39886,5756,30428
8600000US30429,155,41,114,52059,45933,14406,30429
8600000US30434,3992,2024,1968,29253,47072,8896,30434
8600000US30436,8767,4073,4694,34213,52193,5516,30436
8600000US30438,26,10,16,,29120,16624,30438
8600000US30439,8105,3903,4202,33150,48647,5806,30439
8600000US30441,1272,634,638,36838,59249,20830,30441
8600000US30442,5752,2361,3391,26961,39741,5668,30442
8600000US30445,3266,1765,1501,35644,44283,6530,30445
8600000US30446,894,401,493,38029,41440,5726,30446
8600000US30448,55,30,25,90250,84567,37957,30448
8600000US30449,109,60,49,46719,68769,26564,30449
8600000US30450,1820,849,971,30455,37238,4617,30450
8600000US30451,33,14,19,,67556,37408,30451
8600000US30452,1088,514,574,46588,58028,9668,30452
8600000US30453,8707,6176,2531,30022,43103,6118,30453
8600000US30454,560,260,300,31896,47717,19661,30454
8600000US30455,401,171,230,37969,47573,8703,30455
8600000US30456,1409,643,766,34178,46938,7589,30456
8600000US30457,4644,2453,2191,38919,59202,11921,30457
8600000US30458,35148,17127,18021,34415,53096,3405,30458
8600000US30460,2053,902,1151,,,,30460
8600000US30461,10903,5613,5290,55910,68933,5361,30461
8600000US30464,58,28,30,35000,44279,14422,30464
8600000US30467,9530,4614,4916,37189,55162,4423,30467
8600000US30470,273,161,112,21875,45611,18094,30470
8600000US30471,3998,2106,1892,30558,40138,5136,30471
8600000US30473,1915,1001,914,41836,53528,8185,30473
8600000US30474,12359,5640,6719,40835,73106,21394,30474
8600000US30475,0,0,0,,,,30475
8600000US30477,2249,1052,1197,30865,40469,6278,30477
8600000US30501,21561,10208,11353,45910,61639,3791,30501
8600000US30504,19269,9527,9742,49067,66840,5012,30504
8600000US30506,34429,16942,17487,77060,99349,5026,30506
8600000US30507,21077,10636,10441,50081,68272,4514,30507
8600000US30510,6999,2502,4497,41087,53315,5652,30510
8600000US30511,2896,1519,1377,45143,55294,6672,30511
8600000US30512,17660,8551,9109,46497,63915,4734,30512
8600000US30513,9568,4474,5094,47549,62913,5478,30513
8600000US30516,1579,839,740,37050,50990,9571,30516
8600000US30517,10804,5156,5648,84863,122240,13116,30517
8600000US30518,38063,18176,19887,73753,90078,5108,30518
8600000US30519,33382,16478,16904,82113,108499,11261,30519
8600000US30520,3769,1914,1855,39348,53588,7818,30520
8600000US30521,3881,2010,1871,46741,59975,9112,30521
8600000US30522,799,444,355,36875,59848,20802,30522
8600000US30523,10088,4796,5292,51193,68960,5423,30523
8600000US30525,6182,2915,3267,37134,63155,9131,30525
8600000US30527,3448,1618,1830,57154,65295,5468,30527
8600000US30528,19352,9242,10110,45474,62098,5588,30528
8600000US30529,8779,4002,4777,49755,59445,5154,30529
8600000US30530,4794,2328,2466,51824,61186,5591,30530
8600000US30531,7740,3792,3948,47409,57949,5806,30531
8600000US30533,22384,10880,11504,49693,66230,6191,30533
8600000US30534,22383,11007,11376,63271,84084,5888,30534
8600000US30535,5961,3024,2937,48663,58171,4701,30535
8600000US30536,6404,3089,3315,50614,67425,10978,30536
8600000US30537,1157,553,604,51771,66853,13628,30537
8600000US30538,2326,1137,1189,50725,63763,12663,30538
8600000US30540,15886,7999,7887,49265,61139,3949,30540
8600000US30541,1394,657,737,39412,53802,11831,30541
8600000US30542,28139,14223,13916,73607,89733,4114,30542
8600000US30543,3526,1659,1867,61250,77980,16540,30543
8600000US30545,573,303,270,43533,64332,9207,30545
8600000US30546,6077,2750,3327,46590,59261,5951,30546
8600000US30547,2635,1256,1379,47586,57226,5744,30547
8600000US30548,13769,6827,6942,84122,102886,7516,30548
8600000US30549,18456,9073,9383,64465,79154,5018,30549
8600000US30552,1420,666,754,44097,62749,10406,30552
8600000US30553,6257,2973,3284,47169,63538,7919,30553
8600000US30554,5767,2859,2908,54186,61877,5669,30554
8600000US30555,1734,903,831,35990,56838,12444,30555
8600000US30557,4128,2110,2018,44449,55096,8744,30557
8600000US30558,4543,2306,2237,41576,54267,5562,30558
8600000US30559,3896,1735,2161,41588,63532,13196,30559
8600000US30560,4186,2145,2041,53786,61031,6561,30560
8600000US30562,1132,494,638,29474,38219,7465,30562
8600000US30563,4488,2242,2246,49861,60055,5266,30563
8600000US30564,2616,1229,1387,47857,55477,7983,30564
8600000US30565,3483,1713,1770,48378,61513,7833,30565
8600000US30566,5656,2742,2914,55625,81120,13899,30566
8600000US30567,2293,1065,1228,60690,88799,17810,30567
8600000US30568,1393,787,606,36736,83520,56230,30568
8600000US30571,3238,1687,1551,57060,69156,8992,30571
8600000US30572,696,267,429,33036,37064,8464,30572
8600000US30573,200,130,70,140714,114283,38528,30573
8600000US30575,1140,517,623,53250,65400,14193,30575
8600000US30576,1959,1020,939,45714,63817,9174,30576
8600000US30577,16409,7458,8951,41177,55055,4878,30577
8600000US30581,17,9,8,,,,30581
8600000US30582,4313,2052,2261,42632,50447,5862,30582
8600000US30601,18514,8963,9551,24783,38054,2910,30601
8600000US30602,2814,1035,1779,,,,30602
8600000US30605,35258,16244,19014,33857,52529,2668,30605
8600000US30606,35314,16679,18635,48890,78475,4888,30606
8600000US30607,7559,3743,3816,53769,70777,10737,30607
8600000US30609,2280,924,1356,,,,30609
8600000US30619,1011,542,469,47411,58198,9442,30619
8600000US30620,9845,4650,5195,66918,75053,4055,30620
8600000US30621,4255,2064,2191,98173,119270,13621,30621
8600000US30622,9145,4735,4410,63736,82695,7593,30622
8600000US30623,122,64,58,31179,38925,10842,30623
8600000US30624,2437,1256,1181,40373,52301,8226,30624
8600000US30625,1806,914,892,56912,73057,9832,30625
8600000US30627,1971,1053,918,39500,51648,7548,30627
8600000US30628,5096,2552,2544,61905,74888,7554,30628
8600000US30629,3514,1781,1733,43088,57208,7161,30629
8600000US30630,1878,771,1107,42636,51000,5784,30630
8600000US30631,1387,702,685,31853,49117,9093,30631
8600000US30633,7209,3583,3626,51888,65518,7400,30633
8600000US30634,1482,763,719,33304,40638,6907,30634
8600000US30635,11791,5453,6338,38369,56776,5789,30635
8600000US30641,1524,709,815,47835,63496,8955,30641
8600000US30642,9703,4506,5197,55602,101820,10013,30642
8600000US30643,12682,5964,6718,39993,56937,5954,30643
8600000US30646,4950,2232,2718,50221,62026,7427,30646
8600000US30648,2409,1236,1173,42438,54875,5353,30648
8600000US30650,9044,4277,4767,62000,84164,8624,30650
8600000US30655,18542,8769,9773,48427,64622,4013,30655
8600000US30656,12555,5999,6556,60662,76602,6403,30656
8600000US30660,862,437,425,35357,43463,8522,30660
8600000US30662,7063,3458,3605,31860,51281,7192,30662
8600000US30663,2488,1117,1371,49449,61229,8738,30663
8600000US30664,27,15,12,41042,31394,8048,30664
8600000US30665,44,22,22,31250,28165,10862,30665
8600000US30666,7501,3759,3742,60369,79828,9078,30666
8600000US30667,795,364,431,52083,64869,9166,30667
8600000US30668,1293,621,672,36490,47792,5792,30668
8600000US30669,2630,1263,1367,30434,42011,4564,30669
8600000US30673,6022,2810,3212,34821,57826,12534,30673
8600000US30677,14034,6601,7433,78892,106711,8959,30677
8600000US30678,1090,639,451,56250,72384,13613,30678
8600000US30680,31323,15220,16103,55156,65586,2193,30680
8600000US30683,5370,2627,2743,48125,62667,6124,30683
8600000US30701,30109,14559,15550,44794,61608,4101,30701
8600000US30705,24748,11921,12827,44902,56788,3933,30705
8600000US30707,12559,6064,6495,49457,63053,7568,30707
8600000US30708,174,111,63,48900,88636,47001,30708
8600000US30710,5493,2753,2740,63641,81767,8278,30710
8600000US30711,2806,1365,1441,48670,52654,5470,30711
8600000US30720,20896,10534,10362,51449,72381,5482,30720
8600000US30721,38614,18854,19760,41547,54575,3526,30721
8600000US30725,3680,1809,1871,51627,66743,9139,30725
8600000US30726,0,0,0,,,,30726
8600000US30728,15784,7706,8078,40121,54502,5673,30728
8600000US30730,1433,660,773,36512,64230,26684,30730
8600000US30731,1744,859,885,38417,57032,11678,30731
8600000US30733,1509,723,786,36354,48058,8404,30733
8600000US30734,2721,1384,1337,45811,61670,11600,30734
8600000US30735,4824,2451,2373,46401,62471,10406,30735
8600000US30736,32793,15861,16932,64241,77272,3095,30736
8600000US30738,3033,1450,1583,46660,63054,8787,30738
8600000US30739,4931,2615,2316,68021,73794,8840,30739
8600000US30740,6622,3233,3389,50912,85685,13167,30740
8600000US30741,22613,10291,12322,39300,51531,3978,30741
8600000US30742,5954,2561,3393,43846,49473,4212,30742
8600000US30746,720,279,441,33472,48047,16388,30746
8600000US30747,12350,6707,5643,35427,47817,3278,30747
8600000US30750,3820,1824,1996,70109,114534,15049,30750
8600000US30751,40,7,33,,,,30751
8600000US30752,6838,3292,3546,44693,60038,6524,30752
8600000US30753,5335,2526,2809,39141,44501,3776,30753
8600000US30755,6764,3180,3584,51222,63834,9882,30755
8600000US30756,82,16,66,18494,21620,9464,30756
8600000US30757,1680,797,883,31784,55578,12461,30757
8600000US30802,4653,2396,2257,60341,73185,9822,30802
8600000US30803,695,311,384,43125,50079,6860,30803
8600000US30805,2038,959,1079,35500,61018,20232,30805
8600000US30807,61,18,43,37639,49866,21226,30807
8600000US30808,3431,1630,1801,41903,55166,7114,30808
8600000US30809,33373,16182,17191,102132,118176,4527,30809
8600000US30810,1466,729,737,41802,50279,7813,30810
8600000US30812,394,291,103,,,,30812
8600000US30813,31675,16368,15307,73376,80918,4043,30813
8600000US30814,6484,3210,3274,52095,62300,5823,30814
8600000US30815,31282,13994,17288,51071,60572,3175,30815
8600000US30816,1635,729,906,65091,69257,10391,30816
8600000US30817,6090,2902,3188,41105,59746,6367,30817
8600000US30818,542,228,314,76250,74093,14841,30818
8600000US30820,835,355,480,38250,48100,6249,30820
8600000US30821,630,310,320,51083,66372,19635,30821
8600000US30822,705,445,260,27353,37847,19591,30822
8600000US30823,1427,700,727,29825,51994,10246,30823
8600000US30824,12544,5671,6873,36266,53455,4893,30824
8600000US30828,3336,1565,1771,31107,48145,9362,30828
8600000US30830,10150,4676,5474,43025,57882,4709,30830
8600000US30833,2244,1003,1241,34906,46554,7823,30833
8600000US30901,12738,6376,6362,21338,30889,2321,30901
8600000US30903,495,181,314,,70839,24417,30903
8600000US30904,19905,8857,11048,34444,55592,3512,30904
8600000US30905,6317,4627,1690,56440,71828,13882,30905
8600000US30906,42245,19988,22257,35071,46983,3072,30906
8600000US30907,40947,18775,22172,66066,89736,4548,30907
8600000US30909,33908,15361,18547,50749,69723,4098,30909
8600000US30912,127,83,44,,,,30912
8600000US31001,3792,2791,1001,30485,45211,9395,31001
8600000US31002,2286,1203,1083,29265,42955,5168,31002
8600000US31003,68,38,30,29583,38079,11332,31003
8600000US31005,12776,5976,6800,76938,91601,9861,31005
8600000US31006,3585,1707,1878,33315,46574,5782,31006
8600000US31007,975,535,440,29932,46658,7078,31007
8600000US31008,14146,6699,7447,55387,65518,5230,31008
8600000US31009,1115,568,547,26114,37581,6256,31009
8600000US31011,559,283,276,52500,62920,8070,31011
8600000US31012,2740,2082,658,29107,42857,7746,31012
8600000US31014,10350,4768,5582,42765,51438,4086,31014
8600000US31015,16108,7406,8702,34306,56002,7083,31015
8600000US31016,1651,651,1000,48063,57719,14031,31016
8600000US31017,1542,713,829,37917,53815,6965,31017
8600000US31018,2474,1966,508,43201,56484,10726,31018
8600000US31019,1460,656,804,36928,51427,6686,31019
8600000US31020,1340,715,625,30096,38592,6952,31020
8600000US31021,21719,10006,11713,38061,56392,3727,31021
8600000US31022,1272,564,708,52625,61881,8169,31022
8600000US31023,11200,5363,5837,36699,50992,4559,31023
8600000US31024,16113,7794,8319,51420,69403,5921,31024
8600000US31025,731,347,384,82875,112424,33455,31025
8600000US31027,6428,2912,3516,35539,48305,7396,31027
8600000US31028,4748,2237,2511,52062,74628,10542,31028
8600000US31029,12695,6182,6513,52570,73984,8357,31029
8600000US31030,13923,6830,7093,34752,51238,4762,31030
8600000US31031,4531,2014,2517,34247,50187,5271,31031
8600000US31032,11202,5380,5822,57428,71106,5282,31032
8600000US31033,1497,764,733,49715,56055,10468,31033
8600000US31035,932,490,442,42188,57239,12546,31035
8600000US31036,9990,4360,5630,41023,61024,6818,31036
8600000US31037,3711,2382,1329,27989,38236,7724,31037
8600000US31038,475,261,214,51691,72399,28324,31038
8600000US31039,0,0,0,,,,31039
8600000US31041,597,259,338,30347,42049,14138,31041
8600000US31042,1260,632,628,44583,54256,6424,31042
8600000US31044,2726,1305,1421,31181,49343,8053,31044
8600000US31045,35,19,16,,,,31045
8600000US31046,2792,1529,1263,45929,71381,17402,31046
8600000US31047,10723,5249,5474,82301,94968,6479,31047
8600000US31049,1289,649,640,42348,55352,13668,31049
8600000US31050,749,450,299,38512,41752,11465,31050
8600000US31051,105,64,41,21250,33904,16419,31051
8600000US31052,6558,3165,3393,60691,70652,6464,31052
8600000US31054,1261,659,602,44063,58842,9954,31054
8600000US31055,6688,4234,2454,28941,39618,5735,31055
8600000US31057,1648,748,900,28200,42158,6229,31057
8600000US31058,1092,553,539,35000,44590,8971,31058
8600000US31060,1567,768,799,41714,54836,8619,31060
8600000US31061,35438,17583,17855,39642,54518,4452,31061
8600000US31062,499,452,47,,,,31062
8600000US31063,3720,1681,2039,31964,40385,5136,31063
8600000US31064,7019,3279,3740,41390,51621,4669,31064
8600000US31065,832,448,384,37708,46388,9345,31065
8600000US31066,1159,578,581,66797,76076,17427,31066
8600000US31067,224,101,123,39531,58545,20310,31067
8600000US31068,4338,3077,1261,31566,44325,6916,31068
8600000US31069,15069,7388,7681,52016,64322,4639,31069
8600000US31070,796,399,397,49688,56312,10140,31070
8600000US31071,927,403,524,37595,43403,5917,31071
8600000US31072,1109,617,492,50625,57297,10579,31072
8600000US31075,1998,899,1099,38125,48661,10626,31075
8600000US31076,2674,1245,1429,35552,43835,5029,31076
8600000US31077,1158,551,607,33529,47304,6971,31077
8600000US31078,2227,915,1312,36604,50007,8459,31078
8600000US31079,1687,726,961,37468,51182,5511,31079
8600000US31081,52,13,39,,,,31081
8600000US31082,7426,3330,4096,37996,53536,4414,31082
8600000US31083,304,175,129,32500,40232,7935,31083
8600000US31084,43,27,16,24028,36626,11012,31084
8600000US31085,918,502,416,48750,61374,10312,31085
8600000US31087,7477,4490,2987,31714,49824,6412,31087
8600000US31088,40872,19231,21641,60247,78060,5022,31088
8600000US31089,3449,1550,1899,35387,46542,5219,31089
8600000US31090,801,348,453,29205,53759,25292,31090
8600000US31091,3582,2368,1214,33253,44440,7327,31091
8600000US31092,5856,2894,2962,40938,53999,8192,31092
8600000US31093,21421,9972,11449,43609,54037,3615,31093
8600000US31094,901,441,460,52969,52174,7079,31094
8600000US31096,5928,3326,2602,37971,51723,4749,31096
8600000US31097,1220,583,637,56020,66125,10052,31097
8600000US31098,2350,1357,993,66667,73955,8561,31098
8600000US31201,6896,3764,3132,22093,43709,5809,31201
8600000US31204,22413,9140,13273,32610,47565,2908,31204
8600000US31206,18150,7688,10462,25542,39225,4870,31206
8600000US31207,1100,449,651,,,,31207
8600000US31210,25779,11773,14006,62158,92177,5533,31210
8600000US31211,11854,5505,6349,37640,57085,8266,31211
8600000US31213,0,0,0,,,,31213
8600000US31216,13473,7288,6185,60341,68654,4938,31216
8600000US31217,12532,5685,6847,32319,45056,3956,31217
8600000US31220,11377,5417,5960,59191,85187,8880,31220
8600000US31301,3003,1567,1436,39458,51172,8177,31301
8600000US31302,6422,3051,3371,52533,63368,5436,31302
8600000US31303,1964,889,1075,70565,74699,10329,31303
8600000US31304,0,0,0,,,,31304
8600000US31305,4766,2241,2525,42283,59322,10523,31305
8600000US31307,834,530,304,59091,58987,14872,31307
8600000US31308,5329,2618,2711,49355,61379,4867,31308
8600000US31309,717,341,376,40612,40915,9903,31309
8600000US31312,14735,7178,7557,78610,86538,4626,31312
8600000US31313,29332,14096,15236,47668,55095,1875,31313
8600000US31314,1635,1519,116,,,,31314
8600000US31315,4404,2351,2053,39533,48843,5784,31315
8600000US31316,9351,4373,4978,57425,63455,6692,31316
8600000US31318,432,274,158,72813,69376,28663,31318
8600000US31320,6375,3187,3188,54406,65195,4175,31320
8600000US31321,5580,2647,2933,42320,60201,9429,31321
8600000US31322,19033,8944,10089,80276,92190,7593,31322
8600000US31323,1014,523,491,42443,54448,10776,31323
8600000US31324,18005,8888,9117,83095,97947,7610,31324
8600000US31326,14605,7173,7432,65668,77658,4510,31326
8600000US31327,187,107,80,,70173,41632,31327
8600000US31328,2981,1469,1512,78487,112120,17256,31328
8600000US31329,7109,3425,3684,50965,95888,45397,31329
8600000US31331,6680,3291,3389,52629,63511,4865,31331
8600000US31401,17246,7912,9334,33716,60741,5001,31401
8600000US31404,25873,11377,14496,37472,52609,2879,31404
8600000US31405,29274,13911,15363,49034,74886,3891,31405
8600000US31406,27250,12992,14258,53108,75250,5195,31406
8600000US31407,9318,5010,4308,79758,106072,21434,31407
8600000US31408,8257,5206,3051,45762,55207,7973,31408
8600000US31409,701,603,98,,,,31409
8600000US31410,18868,8713,10155,76622,97907,7209,31410
8600000US31411,7890,3659,4231,96103,150870,18088,31411
8600000US31415,9269,4100,5169,27240,42064,5652,31415
8600000US31419,45427,21087,24340,54577,71057,4158,31419
8600000US31501,11941,5987,5954,35287,50644,5743,31501
8600000US31503,15254,7134,8120,43830,55611,4134,31503
8600000US31510,7369,3648,3721,36131,51885,6482,31510
8600000US31512,1689,807,882,35672,58444,17007,31512
8600000US31513,12073,5937,6136,38259,53116,4016,31513
8600000US31516,10880,5206,5674,41888,57433,7573,31516
8600000US31518,663,287,376,31136,51183,10947,31518
8600000US31519,2735,1250,1485,37561,46996,5516,31519
8600000US31520,17538,7672,9866,29745,48144,5258,31520
8600000US31522,13909,6435,7474,87777,123900,12729,31522
8600000US31523,10553,5204,5349,55873,89557,17388,31523
8600000US31524,0,0,0,,,,31524
8600000US31525,22409,10243,12166,49812,60615,2942,31525
8600000US31527,568,289,279,75089,102038,37117,31527
8600000US31532,501,243,258,40385,50282,15204,31532
8600000US31533,11991,5309,6682,37647,49919,5870,31533
8600000US31535,8629,4181,4448,41635,61879,6212,31535
8600000US31537,8815,5356,3459,40584,54328,5734,31537
8600000US31539,10696,5176,5520,36780,48523,5038,31539
8600000US31542,2138,1098,1040,37419,57342,10810,31542
8600000US31543,3057,1576,1481,36728,47528,7574,31543
8600000US31544,661,260,401,39261,45666,10402,31544
8600000US31545,11430,5390,6040,44954,59725,6368,31545
8600000US31546,6476,3810,2666,42481,58090,5959,31546
8600000US31547,1215,1120,95,76607,73671,11772,31547
8600000US31548,15467,7594,7873,51835,77350,13178,31548
8600000US31549,1776,849,927,23818,41629,12379,31549
8600000US31550,602,298,304,31520,41083,17546,31550
8600000US31551,762,460,302,38981,49361,12159,31551
8600000US31552,637,350,287,43352,45978,15926,31552
8600000US31553,3652,1592,2060,31215,44273,6357,31553
8600000US31554,6917,4774,2143,46087,48856,4540,31554
8600000US31555,2230,1003,1227,45662,53564,9153,31555
8600000US31556,55,19,36,25313,33632,9589,31556
8600000US31557,2534,1366,1168,48889,57562,6562,31557
8600000US31558,16158,8396,7762,61045,71214,4067,31558
8600000US31560,2223,1176,1047,51367,59558,7639,31560
8600000US31561,39,19,20,,,,31561
8600000US31562,1898,1131,767,41220,57134,8809,31562
8600000US31563,1026,532,494,40750,49940,9825,31563
8600000US31565,1617,778,839,56818,74776,11591,31565
8600000US31566,3479,1872,1607,39329,44329,6525,31566
8600000US31567,695,388,307,37121,47297,12108,31567
8600000US31568,662,318,344,51939,61992,16751,31568
8600000US31569,4451,2185,2266,61319,73022,6525,31569
8600000US31601,24190,11413,12777,25030,39768,3592,31601
8600000US31602,28322,14017,14305,41381,68590,7949,31602
8600000US31605,16514,7530,8984,56622,71263,5311,31605
8600000US31606,2692,1369,1323,44914,53052,7574,31606
8600000US31620,7982,3707,4275,46006,55323,4664,31620
8600000US31622,1530,713,817,37292,46668,6930,31622
8600000US31623,88,34,54,35000,37660,15869,31623
8600000US31624,1026,462,564,40993,54620,9894,31624
8600000US31625,759,383,376,38750,59911,20514,31625
8600000US31626,2576,1253,1323,37287,59982,13986,31626
8600000US31627,207,104,103,35893,36539,7742,31627
8600000US31629,597,251,346,42273,59378,26596,31629
8600000US31630,349,158,191,16532,24486,9552,31630
8600000US31631,325,130,195,44375,53014,17384,31631
8600000US31632,9617,4632,4985,65837,74488,6377,31632
8600000US31634,4129,2015,2114,26594,42090,6252,31634
8600000US31635,4925,2455,2470,30932,46233,8204,31635
8600000US31636,8080,3883,4197,43406,61197,8908,31636
8600000US31637,2252,1095,1157,36000,53908,10908,31637
8600000US31638,891,387,504,21324,40628,13969,31638
8600000US31639,8025,3874,4151,39715,45416,3873,31639
8600000US31641,1567,783,784,47122,64813,12158,31641
8600000US31642,3429,1687,1742,35768,51352,10707,31642
8600000US31643,6926,3261,3665,31849,55661,11041,31643
8600000US31645,3587,1770,1817,32068,42235,5349,31645
8600000US31647,2574,1259,1315,28196,38348,4174,31647
8600000US31648,735,335,400,32083,63082,24907,31648
8600000US31649,813,431,382,39250,55220,16495,31649
8600000US31650,2580,1271,1309,37989,63303,20745,31650
8600000US31698,727,335,392,,,,31698
8600000US31699,684,608,76,,,,31699
8600000US31701,14266,6625,7641,28140,41158,3064,31701
8600000US31705,24104,11296,12808,29000,40554,2760,31705
8600000US31707,19557,8067,11490,38672,52795,3099,31707
8600000US31709,12035,5402,6633,36438,52858,3735,31709
8600000US31711,826,420,406,38889,41131,8009,31711
8600000US31712,878,425,453,40543,46335,8300,31712
8600000US31714,4350,2125,2225,41489,49240,6330,31714
8600000US31716,1910,882,1028,43975,49925,5658,31716
8600000US31719,6763,3374,3389,34673,46430,5526,31719
8600000US31720,214,109,105,32250,41709,10185,31720
8600000US31721,15988,7305,8683,70177,89922,5007,31721
8600000US31722,363,164,199,38125,48282,8686,31722
8600000US31730,6519,2821,3698,33709,52879,12453,31730
8600000US31733,1022,491,531,49095,74015,26382,31733
8600000US31735,625,270,355,,45499,14040,31735
8600000US31738,1505,745,760,42435,51711,7489,31738
8600000US31743,298,153,145,38018,42259,10880,31743
8600000US31744,2180,1048,1132,43125,57166,9685,31744
8600000US31747,127,56,71,17500,34082,14256,31747
8600000US31749,1821,987,834,37471,47608,6934,31749
8600000US31750,13771,6464,7307,34426,45075,3193,31750
8600000US31756,567,232,335,41548,63877,24546,31756
8600000US31757,8019,3625,4394,55047,74897,8599,31757
8600000US31763,17729,8844,8885,62928,77583,5066,31763
8600000US31764,1183,515,668,48980,68028,15952,31764
8600000US31765,2211,1036,1175,31757,41714,5009,31765
8600000US31768,16773,8084,8689,32700,52227,5212,31768
8600000US31771,4759,2528,2231,42500,53992,5673,31771
8600000US31772,473,230,243,48177,50056,9900,31772
8600000US31773,2805,1430,1375,42719,52538,5359,31773
8600000US31774,5235,2600,2635,24103,41312,6157,31774
8600000US31775,2484,1256,1228,35614,60608,17392,31775
8600000US31778,1918,915,1003,36761,56939,10739,31778
8600000US31779,7914,4771,3143,39136,49033,5942,31779
8600000US31780,1763,771,992,38040,53164,10184,31780
8600000US31781,1509,738,771,37283,51290,7899,31781
8600000US31783,689,302,387,42750,67958,20105,31783
8600000US31784,493,225,268,34837,48431,9123,31784
8600000US31787,1165,551,614,30195,52160,9447,31787
8600000US31788,7515,3502,4013,36918,51327,5607,31788
8600000US31789,691,354,337,46731,50321,8230,31789
8600000US31790,1473,745,728,34181,43940,7169,31790
8600000US31791,9270,4280,4990,47401,59907,7333,31791
8600000US31792,18304,8419,9885,34492,61792,5769,31792
8600000US31793,7812,3577,4235,60395,72295,5521,31793
8600000US31794,20026,9601,10425,40429,53497,3383,31794
8600000US31795,1420,671,749,29079,46420,10722,31795
8600000US31796,915,441,474,37269,53392,10691,31796
8600000US31798,628,402,226,40588,49744,20987,31798
8600000US31801,2698,1269,1429,53380,57732,7525,31801
8600000US31803,4367,2264,2103,42169,56526,7883,31803
8600000US31804,4597,2350,2247,80278,103985,21207,31804
8600000US31805,1871,860,1011,35481,48809,9709,31805
8600000US31806,3942,1919,2023,41421,53065,5898,31806
8600000US31807,2562,1233,1329,90635,87408,9811,31807
8600000US31808,5422,2576,2846,97175,117695,20006,31808
8600000US31810,224,127,97,23182,33572,11604,31810
8600000US31811,4913,2569,2344,73676,89861,16573,31811
8600000US31812,492,245,247,27813,44549,13545,31812
8600000US31814,190,74,116,49241,45047,18704,31814
8600000US31815,3394,2649,745,32902,46132,8800,31815
8600000US31816,4021,1886,2135,33018,44655,6354,31816
8600000US31820,8425,4169,4256,99150,123173,11820,31820
8600000US31821,72,21,51,18264,,,31821
8600000US31822,4916,2397,2519,53007,65890,7471,31822
8600000US31823,657,321,336,,68643,18271,31823
8600000US31824,1261,604,657,26250,37889,5722,31824
8600000US31825,1981,881,1100,30288,53440,7938,31825
8600000US31826,1757,819,938,45066,50167,8688,31826
8600000US31827,1702,742,960,34271,49375,10730,31827
8600000US31829,788,392,396,85893,112030,17355,31829
8600000US31830,1992,915,1077,40313,51395,9984,31830
8600000US31831,2780,1371,1409,60705,66570,8133,31831
8600000US31832,203,111,92,31429,43861,11843,31832
8600000US31833,5407,2398,3009,40943,58137,8707,31833
8600000US31836,762,327,435,43261,46567,9756,31836
8600000US31901,5291,2673,2618,20571,45192,7994,31901
8600000US31903,13706,6202,7504,23227,33937,2974,31903
8600000US31904,25597,11947,13650,49482,77535,4976,31904
8600000US31905,12986,9660,3326,55094,68576,9551,31905
8600000US31906,16000,6977,9023,31063,51840,3188,31906
8600000US31907,43277,20908,22369,41924,57849,3076,31907
8600000US31909,29059,13921,15138,59543,72172,3279,31909
8600000US32003,21927,10417,11510,91287,110991,7256,32003
8600000US32008,3806,1992,1814,40573,50399,7703,32008
8600000US32009,2977,1509,1468,69821,81527,6936,32009
8600000US32011,10783,5229,5554,61038,74213,7113,32011
8600000US32024,14852,7138,7714,51607,66321,5680,32024
8600000US32025,17796,10543,7253,44904,58519,4916,32025
8600000US32026,1907,1907,0,,,,32026
8600000US32033,3994,2045,1949,52419,64813,7994,32033
8600000US32034,29170,13970,15200,71476,102561,6483,32034
8600000US32038,8129,3986,4143,40534,56091,6034,32038
8600000US32040,5643,2792,2851,59604,73303,8208,32040
8600000US32043,19117,9304,9813,62317,76804,4979,32043
8600000US32044,1475,689,786,46250,58523,12069,32044
8600000US32046,7346,3599,3747,57445,66138,4563,32046
8600000US32052,8112,5306,2806,36486,47107,5508,32052
8600000US32053,2295,1066,1229,36034,58982,13831,32053
8600000US32054,9368,5931,3437,41566,58946,11853,32054
8600000US32055,13061,6179,6882,40173,64798,7408,32055
8600000US32058,3793,2440,1353,38500,49654,5852,32058
8600000US32059,1890,884,1006,44792,52079,9137,32059
8600000US32060,18006,8825,9181,40619,60442,9338,32060
8600000US32061,306,167,139,83125,72720,21169,32061
8600000US32062,1836,1040,796,50990,59573,11584,32062
8600000US32063,10415,5117,5298,64643,76125,8797,32063
8600000US32064,5695,3017,2678,39827,46875,7276,32064
8600000US32065,27184,12776,14408,69791,85242,6069,32065
8600000US32066,5860,3655,2205,39726,58873,9349,32066
8600000US32068,42578,21505,21073,59722,73401,4547,32068
8600000US32071,2773,1517,1256,40852,56364,8949,32071
8600000US32072,299,146,153,,51858,21139,32072
8600000US32073,32896,15837,17059,57201,69588,3125,32073
8600000US32079,461,210,251,39097,54052,11650,32079
8600000US32080,19233,9645,9588,73350,98141,6521,32080
8600000US32081,9235,4748,4487,115250,123163,9789,32081
8600000US32082,24974,11701,13273,107717,162314,10381,32082
8600000US32083,3145,2664,481,37647,46465,7592,32083
8600000US32084,29010,13473,15537,48691,68147,4048,32084
8600000US32086,24943,11530,13413,56647,73675,5762,32086
8600000US32087,4638,3104,1534,46825,69866,18319,32087
8600000US32091,11554,5529,6025,44211,55028,5679,32091
8600000US32092,25439,12579,12860,89018,105496,8048,32092
8600000US32094,1970,1114,856,43750,73725,24870,32094
8600000US32095,7437,3809,3628,66731,106296,16201,32095
8600000US32096,1811,881,930,38033,48350,8880,32096
8600000US32097,14062,7073,6989,67279,81212,9671,32097
8600000US32102,1939,906,1033,35051,48416,9796,32102
8600000US32110,6551,3187,3364,34188,46738,5037,32110
8600000US32112,5748,2861,2887,36940,44018,4107,32112
8600000US32113,4237,2291,1946,35000,46278,11558,32113
8600000US32114,27017,12763,14254,25894,42442,5827,32114
8600000US32117,19391,9572,9819,35690,46066,4070,32117
8600000US32118,15667,7993,7674,41278,64874,4918,32118
8600000US32119,19235,9379,9856,38951,51910,2709,32119
8600000US32124,4950,3290,1660,58125,76067,9776,32124
8600000US32127,25716,12236,13480,49903,68639,3449,32127
8600000US32128,15858,7572,8286,75787,97596,12071,32128
8600000US32129,18779,9228,9551,44331,54775,3637,32129
8600000US32130,4570,2151,2419,50341,67962,12961,32130
8600000US32131,3776,2161,1615,41553,64440,10169,32131
8600000US32132,6377,2729,3648,41224,52671,3760,32132
8600000US32133,34,9,25,,,,32133
8600000US32134,6106,3241,2865,34288,49703,6938,32134
8600000US32136,6999,3243,3756,52419,77592,9601,32136
8600000US32137,36357,17511,18846,58155,76212,3876,32137
8600000US32139,777,423,354,29688,34036,7832,32139
8600000US32140,1277,644,633,51591,83756,42889,32140
8600000US32141,15598,7888,7710,50266,63631,5107,32141
8600000US32145,4199,2052,2147,39295,46602,5061,32145
8600000US32147,427,221,206,,36811,29536,32147
8600000US32148,7733,3776,3957,31014,41618,3393,32148
8600000US32157,158,103,55,51250,53180,12710,32157
8600000US32159,27510,12572,14938,45198,61077,3812,32159
8600000US32162,53763,25017,28746,61654,75597,4083,32162
8600000US32164,36496,17063,19433,52466,62231,3090,32164
8600000US32168,22834,11422,11412,50557,68870,4268,32168
8600000US32169,9616,4474,5142,67245,94912,7606,32169
8600000US32174,42803,20365,22438,52527,75069,3820,32174
8600000US32176,12932,6049,6883,46875,74814,6150,32176
8600000US32177,20270,9447,10823,34645,49507,2994,32177
8600000US32179,6676,3213,3463,31626,41501,4736,32179
8600000US32180,2879,1515,1364,46757,62129,8562,32180
8600000US32181,1722,852,870,39018,43520,4918,32181
8600000US32187,1698,903,795,37591,59512,14644,32187
8600000US32189,4763,2509,2254,31712,39255,4012,32189
8600000US32190,895,346,549,32930,43629,10147,32190
8600000US32193,577,220,357,35433,47304,10632,32193
8600000US32195,2433,1137,1296,44375,57114,8614,32195
8600000US32202,5873,3611,2262,26250,44290,8471,32202
8600000US32204,6482,2888,3594,40483,62891,8922,32204
8600000US32205,23224,11030,12194,44546,68772,5324,32205
8600000US32206,13042,6211,6831,26565,41225,3013,32206
8600000US32207,27365,13460,13905,47115,72995,3970,32207
8600000US32208,24614,10954,13660,35898,48819,4504,32208
8600000US32209,25617,11329,14288,24664,34526,2048,32209
8600000US32210,45785,21305,24480,45006,61596,2178,32210
8600000US32211,25759,12205,13554,39375,52285,2769,32211
8600000US32212,2020,1410,610,45119,45969,13057,32212
8600000US32216,29956,14097,15859,52100,65839,3256,32216
8600000US32217,15659,7686,7973,44389,73463,6688,32217
8600000US32218,46300,21431,24869,53969,66919,3506,32218
8600000US32219,9699,4912,4787,50865,57420,4804,32219
8600000US32220,9849,4977,4872,54253,69590,6846,32220
8600000US32221,22068,10349,11719,61924,74261,6062,32221
8600000US32222,7207,3404,3803,60861,70295,7144,32222
8600000US32223,19520,9580,9940,79878,106670,7390,32223
8600000US32224,34145,15317,18828,76546,106701,6380,32224
8600000US32225,42480,20603,21877,75517,93012,3473,32225
8600000US32226,11873,5837,6036,77368,93449,9147,32226
8600000US32227,2193,1551,642,51750,63677,13180,32227
8600000US32228,357,317,40,,,,32228
8600000US32233,20562,11120,9442,62713,99899,8975,32233
8600000US32234,4698,2447,2251,52449,72439,13424,32234
8600000US32244,45005,21323,23682,52928,62783,3711,32244
8600000US32246,40542,19515,21027,57507,70535,3618,32246
8600000US32250,22405,11159,11246,79125,112878,7834,32250
8600000US32254,9335,4173,5162,31141,39450,3390,32254
8600000US32256,37120,17645,19475,62235,91243,8740,32256
8600000US32257,30619,14789,15830,58246,75983,3478,32257
8600000US32258,24294,11920,12374,80207,103539,10557,32258
8600000US32259,35494,16953,18541,114033,137505,7674,32259
8600000US32266,5767,2649,3118,89500,118741,17147,32266
8600000US32277,24165,10666,13499,49474,63792,2979,32277
8600000US32301,26150,11354,14796,42165,54549,3364,32301
8600000US32303,41263,19435,21828,48338,64018,3356,32303
8600000US32304,44074,21413,22661,23438,29908,1600,32304
8600000US32305,15450,7148,8302,39723,51727,4653,32305
8600000US32308,18112,8132,9980,61260,86527,6479,32308
8600000US32309,24168,11247,12921,80544,100559,4945,32309
8600000US32310,12182,5853,6329,36653,49884,4210,32310
8600000US32311,16389,7224,9165,73731,91652,4679,32311
8600000US32312,25124,12133,12991,97594,130157,9154,32312
8600000US32317,11158,5413,5745,92598,103733,6845,32317
8600000US32320,3030,1504,1526,49167,59186,7840,32320
8600000US32321,5346,3456,1890,34792,48738,6287,32321
8600000US32322,3588,2582,1006,35116,53477,8855,32322
8600000US32323,334,183,151,42554,46141,22524,32323
8600000US32324,3909,2180,1729,32614,43811,5736,32324
8600000US32327,22365,12699,9666,64221,71180,3685,32327
8600000US32328,2567,1233,1334,45357,86455,20155,32328
8600000US32330,513,220,293,41250,41570,7492,32330
8600000US32331,3418,1565,1853,39312,53969,9099,32331
8600000US32332,1005,510,495,31938,38898,7326,32332
8600000US32333,8902,4435,4467,47784,57108,3293,32333
8600000US32334,1626,806,820,42218,60011,8747,32334
8600000US32336,1022,432,590,50506,65062,15252,32336
8600000US32340,9200,5235,3965,34882,48624,5054,32340
8600000US32343,2346,1078,1268,54526,69324,11255,32343
8600000US32344,10466,5774,4692,43485,60502,5323,32344
8600000US32346,1384,739,645,44375,60449,12673,32346
8600000US32347,5981,2845,3136,42226,54119,4712,32347
8600000US32348,10480,6679,3801,33145,48404,5697,32348
8600000US32350,1058,519,539,36705,55623,12785,32350
8600000US32351,13996,5925,8071,36082,47243,3662,32351
8600000US32352,5260,2523,2737,46604,59215,8773,32352
8600000US32355,181,85,96,41250,52905,14886,32355
8600000US32356,91,45,46,,,,32356
8600000US32358,1434,617,817,56719,68278,10110,32358
8600000US32359,1119,555,564,38564,44244,10613,32359
8600000US32361,180,91,89,54286,49668,13216,32361
8600000US32399,0,0,0,,,,32399
8600000US32401,17878,8453,9425,37691,52393,4330,32401
8600000US32403,2021,1089,932,64875,79292,12642,32403
8600000US32404,30921,15856,15065,50681,66436,4147,32404
8600000US32405,25008,12153,12855,47988,65123,3659,32405
8600000US32407,8825,4467,4358,60908,72498,5112,32407
8600000US32408,14356,7225,7131,56740,83859,6865,32408
8600000US32409,7844,3865,3979,55466,70665,8749,32409
8600000US32410,952,481,471,55417,71009,9241,32410
8600000US32413,12276,6292,5984,63477,90020,10699,32413
8600000US32420,1651,823,828,31858,47627,8046,32420
8600000US32421,3912,2129,1783,44571,57256,7423,32421
8600000US32423,828,464,364,70195,69139,14462,32423
8600000US32424,5841,3669,2172,36176,50797,12851,32424
8600000US32425,10819,6004,4815,37434,48196,3929,32425
8600000US32426,736,342,394,29821,38817,8396,32426
8600000US32427,811,380,431,24474,29507,7010,32427
8600000US32428,13953,8066,5887,39990,52751,3786,32428
8600000US32430,876,404,472,53000,55182,9213,32430
8600000US32431,3089,1479,1610,43520,53493,8027,32431
8600000US32432,0,0,0,,,,32432
8600000US32433,13342,7386,5956,35575,52504,4628,32433
8600000US32435,5771,2703,3068,44118,62345,8217,32435
8600000US32437,574,274,300,25536,38369,13037,32437
8600000US32438,2939,1414,1525,31496,37021,5757,32438
8600000US32439,7929,3982,3947,54637,68776,4349,32439
8600000US32440,6572,4210,2362,44014,53792,4069,32440
8600000US32442,2473,1159,1314,39961,49476,6418,32442
8600000US32443,2525,1186,1339,34701,44367,4148,32443
8600000US32444,16643,7592,9051,66822,83477,5843,32444
8600000US32445,2191,1723,468,36838,49298,6912,32445
8600000US32446,9205,4768,4437,45596,60481,6452,32446
8600000US32447,23,23,0,,,,32447
8600000US32448,6744,3402,3342,26738,41076,4617,32448
8600000US32449,459,193,266,38438,44978,12592,32449
8600000US32455,3684,1809,1875,40785,51786,6736,32455
8600000US32456,6763,3511,3252,47770,65537,5210,32456
8600000US32459,12351,6018,6333,80335,109867,13138,32459
8600000US32460,4998,3412,1586,40034,54247,5774,32460
8600000US32461,34,23,11,,,,32461
8600000US32462,2933,1487,1446,37485,51428,7841,32462
8600000US32463,117,49,68,,35449,14526,32463
8600000US32464,3505,1738,1767,39755,50931,8020,32464
8600000US32465,7139,4875,2264,39289,48183,4626,32465
8600000US32466,4698,2395,2303,53283,61300,6571,32466
8600000US32501,8766,4272,4494,30253,49259,3776,32501
8600000US32502,2526,1379,1147,48316,94323,20021,32502
8600000US32503,27424,13100,14324,49416,68457,4257,32503
8600000US32504,16717,7352,9365,49845,70074,4802,32504
8600000US32505,20659,9349,11310,38214,43859,1924,32505
8600000US32506,27996,13477,14519,48783,59891,2446,32506
8600000US32507,24066,12040,12026,47605,75510,5409,32507
8600000US32508,5043,4018,1025,39417,52915,8153,32508
8600000US32509,702,702,0,,,,32509
8600000US32511,1034,770,264,,,,32511
8600000US32514,34834,17054,17780,47175,61673,3731,32514
8600000US32526,29098,14091,15007,58665,69281,2719,32526
8600000US32530,0,0,0,,,,32530
8600000US32531,4457,2288,2169,58650,69730,11224,32531
8600000US32533,22270,11158,11112,71528,80300,3927,32533
8600000US32534,12065,5160,6905,49130,59886,4114,32534
8600000US32535,5048,3252,1796,38917,51212,5341,32535
8600000US32536,16957,8657,8300,68599,80863,6139,32536
8600000US32539,21637,11361,10276,57757,64844,3074,32539
8600000US32541,15510,7696,7814,77609,104335,6976,32541
8600000US32542,2263,1477,786,48409,56065,12857,32542
8600000US32544,1412,942,470,,76386,24002,32544
8600000US32547,27003,13294,13709,51335,63829,3285,32547
8600000US32548,17313,8732,8581,52883,69061,3779,32548
8600000US32550,7213,3594,3619,64974,108330,14388,32550
8600000US32561,7406,3741,3665,103769,149971,17289,32561
8600000US32563,19514,9472,10042,67546,92049,5565,32563
8600000US32564,2252,1106,1146,75795,93999,20895,32564
8600000US32565,4064,2047,2017,46233,66618,7934,32565
8600000US32566,28630,14211,14419,78368,90079,5494,32566
8600000US32567,2367,1087,1280,43094,58496,6141,32567
8600000US32568,2179,1119,1060,53854,70380,12076,32568
8600000US32569,10234,5406,4828,61976,79497,8025,32569
8600000US32570,24172,11360,12812,57160,65490,3144,32570
8600000US32571,26817,13384,13433,71494,82638,3748,32571
8600000US32577,3532,1751,1781,56619,65453,6637,32577
8600000US32578,25347,12516,12831,82569,99578,4682,32578
8600000US32579,8263,3742,4521,71988,83905,5151,32579
8600000US32580,3262,1579,1683,56581,76832,11104,32580
8600000US32583,23546,14337,9209,57124,70546,5447,32583
8600000US32601,16944,8054,8890,25481,43073,4150,32601
8600000US32603,6872,4123,2749,21992,57973,34560,32603
8600000US32605,20129,9324,10805,69102,91459,6663,32605
8600000US32606,18531,8580,9951,67984,88877,6111,32606
8600000US32607,26001,11738,14263,38521,58471,3611,32607
8600000US32608,40905,19897,21008,42424,70146,3523,32608
8600000US32609,15845,7684,8161,33585,46576,3851,32609
8600000US32612,7503,3196,4307,,,,32612
8600000US32615,11174,5215,5959,56662,81335,11269,32615
8600000US32616,837,497,340,31250,43088,14303,32616
8600000US32617,3209,1476,1733,42536,60862,7368,32617
8600000US32618,6299,2791,3508,53987,83640,11255,32618
8600000US32619,4195,2074,2121,40963,51176,5902,32619
8600000US32621,4306,2008,2298,36368,41159,3684,32621
8600000US32622,767,369,398,66250,63159,9448,32622
8600000US32625,1288,652,636,38571,58955,10536,32625
8600000US32626,6800,3171,3629,34039,43811,3569,32626
8600000US32628,4063,2751,1312,38460,50220,7352,32628
8600000US32631,253,61,192,64901,90427,30884,32631
8600000US32639,123,70,53,25568,28406,12113,32639
8600000US32640,9031,4339,4692,44821,53212,4270,32640
8600000US32641,11308,5417,5891,36885,46602,5024,32641
8600000US32643,9142,4847,4295,56108,68807,5891,32643
8600000US32648,365,185,180,74000,87873,25622,32648
8600000US32653,10742,5074,5668,65427,85354,8651,32653
8600000US32656,11457,5671,5786,46256,57465,4763,32656
8600000US32658,310,162,148,46250,59613,16228,32658
8600000US32664,477,253,224,44821,55282,12451,32664
8600000US32666,6049,2995,3054,47067,62189,8135,32666
8600000US32667,3296,1612,1684,52500,72303,10107,32667
8600000US32668,4047,2022,2025,39277,57463,8734,32668
8600000US32669,9387,4644,4743,69439,94573,7783,32669
8600000US32680,8289,4238,4051,36117,49328,8009,32680
8600000US32681,47,16,31,,,,32681
8600000US32683,106,45,61,14138,21665,10335,32683
8600000US32686,3876,1954,1922,36905,64783,18273,32686
8600000US32692,250,124,126,,66787,45053,32692
8600000US32693,9433,5081,4352,37988,54440,6404,32693
8600000US32694,1790,935,855,48816,58752,9236,32694
8600000US32696,9805,4698,5107,48982,64256,8527,32696
8600000US32697,229,104,125,25357,41923,10281,32697
8600000US32701,18133,8498,9635,54546,67621,3864,32701
8600000US32702,2184,872,1312,37470,50103,6241,32702
8600000US32703,38199,18093,20106,49742,68565,4136,32703
8600000US32707,29250,13779,15471,53373,63836,3949,32707
8600000US32708,36191,17415,18776,68774,96423,4871,32708
8600000US32709,1797,936,861,43462,83033,27287,32709
8600000US32712,35521,17849,17672,69726,88775,5909,32712
8600000US32713,16795,8154,8641,56002,72441,4578,32713
8600000US32714,29865,14201,15664,51814,70183,4795,32714
8600000US32720,25865,11934,13931,44146,59992,3541,32720
8600000US32724,29409,13932,15477,47182,64525,3003,32724
8600000US32725,37717,17560,20157,48830,59670,3384,32725
8600000US32726,17719,8280,9439,42208,56363,3669,32726
8600000US32730,5201,2613,2588,42772,52244,6601,32730
8600000US32732,3978,2117,1861,83962,100010,14041,32732
8600000US32735,3711,1773,1938,58962,62255,5774,32735
8600000US32736,7808,3807,4001,73430,95179,9662,32736
8600000US32738,34693,17082,17611,50446,60314,3590,32738
8600000US32744,3088,1470,1618,45510,68969,12756,32744
8600000US32746,34415,16411,18004,80756,107878,5831,32746
8600000US32750,19777,9693,10084,71842,85661,5150,32750
8600000US32751,17198,8079,9119,71382,101696,6769,32751
8600000US32754,8507,4399,4108,52463,65060,4906,32754
8600000US32757,22120,9974,12146,56206,76974,5700,32757
8600000US32759,2438,1349,1089,32456,45363,7544,32759
8600000US32763,18293,8818,9475,44390,57653,3759,32763
8600000US32764,2829,1416,1413,61667,76362,12713,32764
8600000US32765,50330,24108,26222,77074,95930,3620,32765
8600000US32766,12226,5880,6346,104938,124367,8918,32766
8600000US32767,2572,1396,1176,47531,56364,9034,32767
8600000US32771,40938,19060,21878,56934,78769,4701,32771
8600000US32773,23449,11299,12150,44804,59739,4428,32773
8600000US32776,9188,4403,4785,79602,94634,15153,32776
8600000US32778,17695,8341,9354,45828,61003,3616,32778
8600000US32779,23129,11246,11883,91996,125991,6467,32779
8600000US32780,29502,13897,15605,48531,64759,4042,32780
8600000US32784,9434,4753,4681,45320,65129,8325,32784
8600000US32789,21557,10043,11514,73003,147488,9679,32789
8600000US32792,42346,20754,21592,50943,71195,4419,32792
8600000US32796,17237,8376,8861,45654,60484,3642,32796
8600000US32798,2376,1247,1129,42591,52358,6400,32798
8600000US32801,10968,5524,5444,53628,84765,10091,32801
8600000US32803,17296,8863,8433,67009,102545,7728,32803
8600000US32804,14580,7186,7394,72782,109478,11613,32804
8600000US32805,16272,7890,8382,26584,39525,3109,32805
8600000US32806,22167,10947,11220,60878,84211,4948,32806
8600000US32807,27180,13554,13626,42781,51753,2853,32807
8600000US32808,41683,18998,22685,35186,46985,2952,32808
8600000US32809,22133,11915,10218,43919,58989,4135,32809
8600000US32810,29751,13878,15873,48727,58340,3944,32810
8600000US32811,31176,14371,16805,35911,46323,2708,32811
8600000US32812,28891,14121,14770,49611,72286,4981,32812
8600000US32814,5792,2713,3079,93589,125617,17038,32814
8600000US32817,29299,15144,14155,58958,75937,3908,32817
8600000US32818,39857,17825,22032,43438,52530,2294,32818
8600000US32819,22279,10870,11409,68964,108099,7142,32819
8600000US32820,7017,3523,3494,81628,100468,14242,32820
8600000US32821,14836,7203,7633,56090,67012,7587,32821
8600000US32822,46950,22489,24461,37565,47636,2303,32822
8600000US32824,35477,17380,18097,60405,75325,7196,32824
8600000US32825,47960,22513,25447,57839,71045,2962,32825
8600000US32826,32694,16990,15704,46240,60212,4945,32826
8600000US32827,7032,3376,3656,76304,112173,16084,32827
8600000US32828,49761,23100,26661,70619,87442,5825,32828
8600000US32829,14506,6654,7852,67782,78053,5698,32829
8600000US32830,5,5,0,,,,32830
8600000US32831,3259,3259,0,38125,36736,3732,32831
8600000US32832,17747,9200,8547,87310,106292,8177,32832
8600000US32833,7400,3736,3664,59250,81237,9001,32833
8600000US32835,36165,16399,19766,54805,73758,3757,32835
8600000US32836,15887,7761,8126,91060,143024,15884,32836
8600000US32837,41028,20031,20997,60460,75129,3889,32837
8600000US32839,40577,20178,20399,36011,47915,2012,32839
8600000US32901,21752,10690,11062,37225,49583,3395,32901
8600000US32903,11670,5391,6279,79870,109961,8475,32903
8600000US32904,24906,11973,12933,65074,80691,6526,32904
8600000US32905,19009,9775,9234,37746,48996,2988,32905
8600000US32907,34252,16201,18051,49769,61229,2527,32907
8600000US32908,9535,4520,5015,57313,64137,5528,32908
8600000US32909,23579,11258,12321,50285,63083,3326,32909
8600000US32920,9259,4510,4749,46806,71882,9413,32920
8600000US32922,11418,4854,6564,29066,48524,6921,32922
8600000US32925,1087,610,477,49758,63964,7779,32925
8600000US32926,18627,9310,9317,50015,65371,5088,32926
8600000US32927,21179,10849,10330,60761,71093,3819,32927
8600000US32931,12501,6097,6404,60494,88930,7416,32931
8600000US32934,15439,7546,7893,66163,98656,8279,32934
8600000US32935,33864,16132,17732,47344,61688,3735,32935
8600000US32937,22102,10529,11573,69642,98334,5830,32937
8600000US32940,32393,14911,17482,71198,94102,5976,32940
8600000US32948,5600,2723,2877,39683,48348,6207,32948
8600000US32949,2054,1007,1047,65227,81877,11006,32949
8600000US32950,3623,1867,1756,67716,83487,7138,32950
8600000US32951,10473,5209,5264,71091,100268,7573,32951
8600000US32952,17148,8569,8579,73469,99616,8097,32952
8600000US32953,19859,9717,10142,57281,75496,3427,32953
8600000US32955,31061,14813,16248,68946,82435,5136,32955
8600000US32958,23455,11666,11789,50752,63238,4488,32958
8600000US32960,17478,7875,9603,38133,62099,9753,32960
8600000US32962,21497,10333,11164,47643,61806,4633,32962
8600000US32963,13912,6671,7241,110471,205510,20831,32963
8600000US32966,15771,6846,8925,46464,65293,5826,32966
8600000US32967,16436,7739,8697,49613,74061,6388,32967
8600000US32968,11259,5485,5774,78349,95088,7435,32968
8600000US32970,204,16,188,13488,13357,5421,32970
8600000US32976,8442,4320,4122,36049,44726,3897,32976
8600000US33001,317,156,161,44338,48619,11668,33001
8600000US33004,13419,6436,6983,44137,62518,7337,33004
8600000US33009,34075,16075,18000,37794,55937,4190,33009
8600000US33010,39727,19022,20705,27116,39763,1643,33010
8600000US33012,63298,29942,33356,32241,45797,1804,33012
8600000US33013,28241,13552,14689,32461,45570,2698,33013
8600000US33014,33446,15820,17626,38846,57625,3242,33014
8600000US33015,51578,24026,27552,50426,63665,4105,33015
8600000US33016,40704,18996,21708,44330,64195,6202,33016
8600000US33018,41716,20181,21535,60063,73388,3359,33018
8600000US33019,12693,6355,6338,80727,122213,10286,33019
8600000US33020,36255,18392,17863,41641,55221,2658,33020
8600000US33021,39294,18563,20731,57926,79745,4483,33021
8600000US33023,55905,26616,29289,50406,60228,2248,33023
8600000US33024,57829,27564,30265,58893,77835,3786,33024
8600000US33025,56132,25422,30710,57219,67641,3325,33025
8600000US33026,24904,10981,13923,74362,93360,4821,33026
8600000US33027,48536,21862,26674,63227,84319,5573,33027
8600000US33028,21213,10248,10965,103811,122259,5736,33028
8600000US33029,35908,17956,17952,107109,121255,7287,33029
8600000US33030,24993,13919,11074,37576,53440,3880,33030
8600000US33031,5438,2660,2778,73193,93627,15950,33031
8600000US33032,33152,15624,17528,48341,60003,4020,33032
8600000US33033,40349,19310,21039,45782,59445,3551,33033
8600000US33034,16008,8493,7515,36363,42857,2984,33034
8600000US33035,10999,5047,5952,51207,71872,10847,33035
8600000US33036,3090,1682,1408,76080,128277,22180,33036
8600000US33037,9387,4768,4619,63979,107240,9899,33037
8600000US33039,345,173,172,75046,60131,22988,33039
8600000US33040,28850,15277,13573,67740,93199,6220,33040
8600000US33042,5856,3031,2825,83530,115729,14468,33042
8600000US33043,4175,2114,2061,58479,78788,7819,33043
8600000US33050,8033,4374,3659,55846,87186,14519,33050
8600000US33051,569,305,264,90625,176218,99023,33051
8600000US33054,24000,11088,12912,24597,38590,3550,33054
8600000US33055,33868,15126,18742,43373,52622,2282,33055
8600000US33056,27313,12160,15153,40985,52866,2788,33056
8600000US33060,28519,14439,14080,43924,61918,3615,33060
8600000US33062,20261,10327,9934,62162,96121,7600,33062
8600000US33063,45798,20562,25236,45964,61370,3023,33063
8600000US33064,47352,24589,22763,49984,73865,4296,33064
8600000US33065,41653,19316,22337,54621,72387,3835,33065
8600000US33066,14946,6285,8661,47605,59265,4022,33066
8600000US33067,20716,9899,10817,98750,143966,10534,33067
8600000US33068,38424,17980,20444,44857,57596,3230,33068
8600000US33069,23404,12599,10805,47279,58462,3446,33069
8600000US33070,4503,2246,2257,68375,113866,20353,33070
8600000US33071,30126,14355,15771,89440,108614,5661,33071
8600000US33073,25450,11959,13491,75640,91340,5188,33073
8600000US33076,25812,12970,12842,124303,162285,11651,33076
8600000US33101,0,0,0,,,,33101
8600000US33109,475,235,240,223618,485916,301528,33109
8600000US33122,81,59,22,,64206,47164,33122
8600000US33125,51071,25105,25966,27518,39690,1883,33125
8600000US33126,44609,20736,23873,35319,47069,2691,33126
8600000US33127,25752,12414,13338,30231,39746,2748,33127
8600000US33128,6294,3100,3194,18920,28753,3247,33128
8600000US33129,11062,5138,5924,82143,123373,14360,33129
8600000US33130,23555,11769,11786,30618,58968,10027,33130
8600000US33131,14744,7101,7643,88917,128466,12400,33131
8600000US33132,11968,7207,4761,77779,108724,11493,33132
8600000US33133,27482,12926,14556,63992,126930,9202,33133
8600000US33134,35321,16574,18747,67818,101891,5692,33134
8600000US33135,33137,16655,16482,27172,40612,2708,33135
8600000US33136,12105,6016,6089,24702,38557,4528,33136
8600000US33137,20556,10626,9930,60259,83004,6369,33137
8600000US33138,24146,12502,11644,47604,82684,5893,33138
8600000US33139,34077,18945,15132,52278,108673,7582,33139
8600000US33140,17522,8705,8817,79804,149250,14247,33140
8600000US33141,34066,17305,16761,48096,73214,4293,33141
8600000US33142,44587,21023,23564,24106,34981,1991,33142
8600000US33143,26055,12900,13155,67170,122246,10293,33143
8600000US33144,26029,12535,13494,44611,61255,4995,33144
8600000US33145,26872,12626,14246,51181,74160,6614,33145
8600000US33146,13302,6345,6957,121319,199141,23997,33146
8600000US33147,36082,16826,19256,30632,42217,2389,33147
8600000US33149,9442,4492,4950,133958,230319,21145,33149
8600000US33150,22090,10854,11236,28069,42462,4177,33150
8600000US33154,11329,5160,6169,74212,119728,13614,33154
8600000US33155,39310,18701,20609,63653,90724,5561,33155
8600000US33156,26358,13232,13126,112373,203254,14322,33156
8600000US33157,51297,23838,27459,63943,89177,4112,33157
8600000US33158,4887,2337,2550,159914,238809,35934,33158
8600000US33160,34824,16552,18272,52170,96682,7504,33160
8600000US33161,42344,19834,22510,36618,50636,2193,33161
8600000US33162,36748,17506,19242,42643,55681,3519,33162
8600000US33165,46904,22070,24834,50758,71450,6342,33165
8600000US33166,20575,10847,9728,53717,74314,3806,33166
8600000US33167,15305,7075,8230,36870,48940,5077,33167
8600000US33168,22782,11260,11522,45395,57408,4084,33168
8600000US33169,30855,13742,17113,43331,55056,2505,33169
8600000US33170,9993,4534,5459,42946,51875,5211,33170
8600000US33172,35193,16793,18400,46983,56870,2121,33172
8600000US33173,26055,12007,14048,69414,89416,5271,33173
8600000US33174,29405,12935,16470,46613,60407,4131,33174
8600000US33175,46674,21703,24971,55304,74784,3266,33175
8600000US33176,42089,19486,22603,70572,105010,6406,33176
8600000US33177,46428,22466,23962,58912,70637,3161,33177
8600000US33178,37118,17051,20067,80554,95971,4284,33178
8600000US33179,35912,16763,19149,48456,69937,4248,33179
8600000US33180,26740,12627,14113,70014,109681,8687,33180
8600000US33181,16207,8178,8029,46038,70818,7015,33181
8600000US33182,14537,8378,6159,73785,90381,7463,33182
8600000US33183,30025,13969,16056,56400,71726,3693,33183
8600000US33184,18444,8961,9483,50569,64878,4293,33184
8600000US33185,24256,11340,12916,87438,102981,5287,33185
8600000US33186,56039,25712,30327,69823,82248,2943,33186
8600000US33187,15110,7905,7205,75543,91588,6469,33187
8600000US33189,20266,9998,10268,54834,69018,4406,33189
8600000US33190,11466,5122,6344,59057,72876,4503,33190
8600000US33193,40872,19241,21631,58004,70735,3837,33193
8600000US33194,6552,4127,2425,112730,116162,13139,33194
8600000US33196,40453,18888,21565,73853,87900,3622,33196
8600000US33301,13466,7393,6073,90497,157821,21195,33301
8600000US33304,16126,9045,7081,54749,95267,10971,33304
8600000US33305,11302,7259,4043,67665,107223,10902,33305
8600000US33306,2956,1659,1297,64125,102405,16803,33306
8600000US33308,25094,12631,12463,62768,117952,7417,33308
8600000US33309,31931,16420,15511,54639,65962,3348,33309
8600000US33311,52931,25034,27897,35075,46632,2409,33311
8600000US33312,41354,21725,19629,54918,76696,4592,33312
8600000US33313,46194,20546,25648,36410,44727,1905,33313
8600000US33314,20873,10562,10311,44785,58600,3789,33314
8600000US33315,11603,6287,5316,61890,78754,6936,33315
8600000US33316,8865,4915,3950,57862,126529,15093,33316
8600000US33317,29450,14661,14789,65934,85064,3954,33317
8600000US33319,37569,16555,21014,45531,58984,3388,33319
8600000US33321,39739,17753,21986,48986,61343,3337,33321
8600000US33322,33064,14900,18164,49681,71943,5005,33322
8600000US33323,16702,7511,9191,87667,108209,8724,33323
8600000US33324,39204,17713,21491,65297,88885,4814,33324
8600000US33325,22431,11018,11413,78367,105205,8549,33325
8600000US33326,24981,11808,13173,84910,113659,5747,33326
8600000US33327,15681,7422,8259,106414,147830,14747,33327
8600000US33328,22286,10485,11801,85858,105834,6524,33328
8600000US33330,11679,5815,5864,122204,162952,17500,33330
8600000US33331,19145,9488,9657,119518,151951,10758,33331
8600000US33332,8478,4418,4060,127708,175791,25895,33332
8600000US33334,24664,13563,11101,51241,73238,3833,33334
8600000US33351,27053,12134,14919,58962,70348,4189,33351
8600000US33401,23602,11224,12378,48767,81842,8411,33401
8600000US33403,9711,4730,4981,50320,58133,4279,33403
8600000US33404,21817,9877,11940,42044,72020,5157,33404
8600000US33405,16479,8267,8212,49770,79009,7069,33405
8600000US33406,21012,10405,10607,60142,77501,6563,33406
8600000US33407,24101,12092,12009,41085,55182,3909,33407
8600000US33408,16122,7815,8307,73890,120955,7161,33408
8600000US33409,25821,12105,13716,49256,63298,3962,33409
8600000US33410,29913,13898,16015,69037,104661,7202,33410
8600000US33411,56205,26469,29736,68507,90842,5741,33411
8600000US33412,12559,6553,6006,89052,126201,12796,33412
8600000US33413,12940,6232,6708,60635,80390,14015,33413
8600000US33414,45448,21118,24330,86034,111003,4686,33414
8600000US33415,38978,18057,20921,42077,54260,2777,33415
8600000US33417,26491,12386,14105,36228,47826,2553,33417
8600000US33418,33782,15861,17921,90130,143727,6830,33418
8600000US33426,19203,8459,10744,57983,67453,3597,33426
8600000US33428,32126,15317,16809,67500,95079,5197,33428
8600000US33430,16157,8000,8157,24840,34286,2009,33430
8600000US33431,17658,8372,9286,74614,127467,13091,33431
8600000US33432,17852,8830,9022,72425,145602,10508,33432
8600000US33433,32968,14923,18045,62710,93197,6193,33433
8600000US33434,17573,7966,9607,56760,105941,7870,33434
8600000US33435,29929,14470,15459,46283,74861,4906,33435
8600000US33436,36369,17071,19298,55735,77514,2941,33436
8600000US33437,34860,15637,19223,61472,84807,5467,33437
8600000US33438,247,121,126,56500,75090,32343,33438
8600000US33440,15014,7981,7033,37359,54593,6123,33440
8600000US33441,22583,10934,11649,46098,65788,3697,33441
8600000US33442,24318,10658,13660,45781,59474,3125,33442
8600000US33444,19131,9481,9650,53352,79983,6856,33444
8600000US33445,27335,13137,14198,53929,72918,3100,33445
8600000US33446,22655,10732,11923,56361,112904,11827,33446
8600000US33449,8684,4068,4616,116269,138026,12140,33449
8600000US33455,19279,9170,10109,54113,105025,10702,33455
8600000US33458,44105,21319,22786,82555,123953,6479,33458
8600000US33460,25454,13896,11558,37863,56027,3193,33460
8600000US33461,35189,16816,18373,41081,51607,1913,33461
8600000US33462,26961,13812,13149,52165,76633,5445,33462
8600000US33463,45202,21684,23518,52352,68135,3184,33463
8600000US33467,43286,20570,22716,69644,94328,4533,33467
8600000US33469,13088,6351,6737,76662,120626,14771,33469
8600000US33470,20737,10544,10193,83668,96779,6239,33470
8600000US33471,6167,3523,2644,38690,46265,4941,33471
8600000US33472,16714,7986,8728,74700,105701,11044,33472
8600000US33473,8099,3845,4254,137895,148682,12663,33473
8600000US33476,6374,3621,2753,21748,35062,5327,33476
8600000US33477,12833,5893,6940,74614,127833,10787,33477
8600000US33478,10458,5354,5104,103333,130518,10267,33478
8600000US33480,9453,4215,5238,110756,279319,35079,33480
8600000US33483,10937,5382,5555,83592,175457,16513,33483
8600000US33484,24448,11096,13352,41044,64427,3516,33484
8600000US33486,19196,9235,9961,78931,115045,9041,33486
8600000US33487,17054,8046,9008,80947,128425,10499,33487
8600000US33493,4831,4105,726,35104,55723,17548,33493
8600000US33496,18411,8134,10277,86461,166109,14689,33496
8600000US33498,11208,5346,5862,99514,125133,13855,33498
8600000US33503,190,110,80,,70824,44258,33503
8600000US33510,21881,10421,11460,58631,68940,3725,33510
8600000US33511,44901,20996,23905,57868,70599,2587,33511
8600000US33513,10221,6041,4180,37761,54769,6398,33513
8600000US33514,1600,671,929,39145,48881,8720,33514
8600000US33521,338,144,194,32143,44897,10337,33521
8600000US33523,14146,6710,7436,45839,62376,4059,33523
8600000US33525,16665,8359,8306,52865,70008,5120,33525
8600000US33527,11142,5779,5363,55841,73623,4982,33527
8600000US33534,11302,5379,5923,49596,62205,5400,33534
8600000US33538,3764,1764,2000,35849,47004,5863,33538
8600000US33540,7186,3403,3783,35602,52464,6476,33540
8600000US33541,17230,8476,8754,39334,52439,3560,33541
8600000US33542,17562,8195,9367,33956,47100,3346,33542
8600000US33543,19626,9420,10206,80443,95902,4922,33543
8600000US33544,19774,9879,9895,81115,97570,5203,33544
8600000US33545,13348,6329,7019,77705,93607,7715,33545
8600000US33547,16439,7967,8472,103167,131728,6487,33547
8600000US33548,5453,2608,2845,106182,127460,11865,33548
8600000US33549,14415,7469,6946,71176,87858,5250,33549
8600000US33556,17526,8639,8887,100456,132359,10511,33556
8600000US33558,16914,8368,8546,78391,108079,5719,33558
8600000US33559,14352,6501,7851,63414,77072,5642,33559
8600000US33563,20444,9941,10503,44121,54862,3025,33563
8600000US33565,13539,6749,6790,53883,70967,4094,33565
8600000US33566,15068,7363,7705,61201,79567,4494,33566
8600000US33567,9008,4525,4483,49403,67866,5307,33567
8600000US33569,20458,9855,10603,65761,80830,4194,33569
8600000US33570,20733,10448,10285,50809,69403,4682,33570
8600000US33572,15198,7615,7583,83642,113288,6349,33572
8600000US33573,21009,9022,11987,46681,62497,3328,33573
8600000US33576,4090,1858,2232,58431,76922,8524,33576
8600000US33578,37348,17365,19983,61604,74649,2945,33578
8600000US33579,24205,11633,12572,81635,92553,6457,33579
8600000US33584,20601,10013,10588,62899,75781,4004,33584
8600000US33585,1035,455,580,47339,59874,11188,33585
8600000US33592,8600,4268,4332,38297,59342,5593,33592
8600000US33594,27055,12896,14159,63853,81325,4555,33594
8600000US33596,22411,10621,11790,99210,113688,6547,33596
8600000US33597,6556,3174,3382,50385,60088,6929,33597
8600000US33598,13222,6913,6309,61650,73438,3932,33598
8600000US33602,12675,6768,5907,71043,109633,8742,33602
8600000US33603,16463,7643,8820,43012,59045,3396,33603
8600000US33604,30773,15216,15557,40621,54581,3584,33604
8600000US33605,13286,6173,7113,26954,38455,2399,33605
8600000US33606,17008,8026,8982,79598,122199,9112,33606
8600000US33607,19313,8917,10396,41794,56272,4612,33607
8600000US33609,14973,7616,7357,63873,118995,13909,33609
8600000US33610,32341,14391,17950,34878,45464,1983,33610
8600000US33611,26096,12794,13302,64523,100068,6682,33611
8600000US33612,37346,17553,19793,33196,46263,2180,33612
8600000US33613,29424,15178,14246,32676,51591,3383,33613
8600000US33614,37926,18660,19266,39746,49597,2614,33614
8600000US33615,36414,17929,18485,49506,68899,4252,33615
8600000US33616,12467,6224,6243,60538,86330,10308,33616
8600000US33617,34982,16987,17995,37257,56836,3508,33617
8600000US33618,22090,10263,11827,70545,105437,8492,33618
8600000US33619,30144,15522,14622,41318,55042,4117,33619
8600000US33620,5329,2108,3221,,,,33620
8600000US33621,1414,842,572,67708,72806,11956,33621
8600000US33624,31021,14897,16124,68125,82746,3258,33624
8600000US33625,20866,9633,11233,68300,81530,4868,33625
8600000US33626,21764,10398,11366,106560,127323,6012,33626
8600000US33629,18931,9155,9776,115180,164597,9414,33629
8600000US33634,18189,8932,9257,58013,72628,6035,33634
8600000US33635,14129,6490,7639,60267,79528,5848,33635
8600000US33637,13307,6019,7288,52635,60701,3486,33637
8600000US33647,50950,23708,27242,84967,114247,4813,33647
8600000US33701,13844,6531,7313,35770,75335,9050,33701
8600000US33702,25138,12011,13127,50214,72981,3589,33702
8600000US33703,20618,9962,10656,69575,95517,5973,33703
8600000US33704,13675,6556,7119,78090,118373,9241,33704
8600000US33705,22430,10744,11686,48171,65426,3409,33705
8600000US33706,14880,7344,7536,75212,104018,6371,33706
8600000US33707,22379,10521,11858,47259,71792,3887,33707
8600000US33708,14619,7220,7399,59189,85523,5007,33708
8600000US33709,21336,10406,10930,42146,51850,2183,33709
8600000US33710,28066,14019,14047,57815,72985,3427,33710
8600000US33711,16168,7278,8890,39720,60651,4949,33711
8600000US33712,20425,9406,11019,45077,58106,3319,33712
8600000US33713,26800,13377,13423,54067,64328,3157,33713
8600000US33714,16137,8064,8073,35301,43901,2476,33714
8600000US33715,6915,3497,3418,89301,133056,11601,33715
8600000US33716,15272,7074,8198,53713,65641,3695,33716
8600000US33744,145,123,22,,,,33744
8600000US33755,19671,9310,10361,39461,60707,5469,33755
8600000US33756,26701,12317,14384,42241,70035,6374,33756
8600000US33759,14856,7052,7804,51316,71533,4617,33759
8600000US33760,13876,7100,6776,48195,59728,4171,33760
8600000US33761,16929,7322,9607,50703,70342,3953,33761
8600000US33762,7223,4310,2913,65161,94178,7728,33762
8600000US33763,17744,8254,9490,42992,56498,3199,33763
8600000US33764,21785,10869,10916,50800,73495,6388,33764
8600000US33765,11645,5680,5965,42224,55068,4007,33765
8600000US33767,7205,3472,3733,80625,134019,15735,33767
8600000US33770,22027,10424,11603,44321,69194,8329,33770
8600000US33771,25599,11859,13740,41473,51386,2690,33771
8600000US33772,18878,8455,10423,50833,71153,5178,33772
8600000US33773,14999,7153,7846,52241,72642,4951,33773
8600000US33774,15734,7229,8505,50085,68703,3746,33774
8600000US33776,10866,5146,5720,74332,95355,6361,33776
8600000US33777,14337,6811,7526,55650,83852,6760,33777
8600000US33778,12081,5807,6274,46037,64540,4842,33778
8600000US33781,20373,9906,10467,40055,54165,3370,33781
8600000US33782,18605,8306,10299,48382,63883,3708,33782
8600000US33785,5112,2447,2665,67838,113434,16514,33785
8600000US33786,1415,672,743,78571,130642,19327,33786
8600000US33801,27923,13441,14482,35696,45120,2632,33801
8600000US33803,23791,10966,12825,51502,74156,6475,33803
8600000US33805,19605,9331,10274,35198,49016,3895,33805
8600000US33809,24744,11831,12913,52268,64732,3370,33809
8600000US33810,38739,18858,19881,54509,65821,2610,33810
8600000US33811,17015,8334,8681,57589,73707,3573,33811
8600000US33812,10053,4786,5267,79405,95759,9394,33812
8600000US33813,28783,13608,15175,82354,103608,4540,33813
8600000US33815,10901,5358,5543,30973,41382,3501,33815
8600000US33823,24875,11886,12989,50066,64666,3330,33823
8600000US33825,20911,10523,10388,36595,55154,9572,33825
8600000US33827,2374,1166,1208,61425,90736,20095,33827
8600000US33830,20932,10205,10727,50521,63162,4110,33830
8600000US33834,5854,3774,2080,44167,48764,4034,33834
8600000US33837,21216,10340,10876,55877,70966,5462,33837
8600000US33838,2823,1507,1316,36299,45082,6126,33838
8600000US33839,2349,1206,1143,45417,64748,10851,33839
8600000US33841,6781,3340,3441,42838,58409,5290,33841
8600000US33843,9281,5241,4040,42200,52002,3889,33843
8600000US33844,26395,12384,14011,39759,50454,2867,33844
8600000US33847,105,59,46,,57938,12075,33847
8600000US33848,736,356,380,,40873,16759,33848
8600000US33849,926,459,467,46875,59752,16200,33849
8600000US33850,5989,2880,3109,42768,58749,12144,33850
8600000US33851,844,388,456,49500,61695,13494,33851
8600000US33852,17570,8669,8901,36972,61207,11795,33852
8600000US33853,8778,3971,4807,38300,49558,4200,33853
8600000US33854,212,94,118,30982,44259,17498,33854
8600000US33855,0,0,0,,,,33855
8600000US33856,330,158,172,31094,32537,6160,33856
8600000US33857,1558,803,755,27165,38674,7815,33857
8600000US33859,8486,4034,4452,39407,46579,3934,33859
8600000US33860,18461,8891,9570,51665,62880,5242,33860
8600000US33865,941,439,502,43500,50911,15801,33865
8600000US33867,393,215,178,,65034,20115,33867
8600000US33868,9868,5623,4245,52787,62822,3345,33868
8600000US33870,18281,8845,9436,31195,45555,5522,33870
8600000US33872,13526,6463,7063,41381,55167,4475,33872
8600000US33873,9899,4766,5133,36250,55766,7710,33873
8600000US33875,9326,4586,4740,50380,65343,5980,33875
8600000US33876,4023,2123,1900,49828,59684,8136,33876
8600000US33877,368,98,270,,33658,22778,33877
8600000US33880,30999,15472,15527,42623,56256,3105,33880
8600000US33881,26621,12377,14244,40871,55599,4926,33881
8600000US33884,25326,11474,13852,58227,74517,3307,33884
8600000US33890,3431,1800,1631,35446,60126,17017,33890
8600000US33896,7919,3810,4109,61738,72395,5636,33896
8600000US33897,15397,7198,8199,53130,67755,7428,33897
8600000US33898,13868,6766,7102,43237,64217,11023,33898
8600000US33901,17218,8060,9158,35758,60929,6513,33901
8600000US33903,19395,9304,10091,39783,54196,2513,33903
8600000US33904,27871,13603,14268,51558,67740,2948,33904
8600000US33905,29542,14872,14670,47430,63340,3608,33905
8600000US33907,19379,9205,10174,42566,54422,3041,33907
8600000US33908,32524,14980,17544,56593,91155,5573,33908
8600000US33909,24267,11366,12901,54280,63000,4004,33909
8600000US33912,16279,7719,8560,73271,108803,9106,33912
8600000US33913,20181,9568,10613,80713,109130,7728,33913
8600000US33914,31528,16383,15145,64484,82854,5375,33914
8600000US33916,16991,8099,8892,36765,49514,5893,33916
8600000US33917,25750,12553,13197,45736,59192,2225,33917
8600000US33919,26438,12214,14224,55669,75161,3600,33919
8600000US33920,5008,2538,2470,78750,92827,11260,33920
8600000US33921,839,413,426,68661,119061,32957,33921
8600000US33922,3283,1681,1602,41607,53215,5594,33922
8600000US33924,200,91,109,,44373,23448,33924
8600000US33928,21115,10008,11107,75302,104718,7280,33928
8600000US33930,618,287,331,44018,56627,26072,33930
8600000US33931,10371,5037,5334,58019,89352,7673,33931
8600000US33935,15721,8292,7429,41605,58087,7544,33935
8600000US33936,18864,9191,9673,40732,50772,3800,33936
8600000US33944,165,61,104,,,,33944
8600000US33945,0,0,0,,,,33945
8600000US33946,2261,1131,1130,74063,107920,23005,33946
8600000US33947,8184,3753,4431,51078,66543,8995,33947
8600000US33948,14101,6463,7638,45197,58351,3567,33948
8600000US33950,20553,9879,10674,56855,81696,5393,33950
8600000US33952,28463,13770,14693,39761,53208,3087,33952
8600000US33953,6355,3167,3188,56888,81913,10653,33953
8600000US33954,7805,3672,4133,55546,68476,7104,33954
8600000US33955,10330,5739,4591,60169,91854,20219,33955
8600000US33956,3139,1560,1579,54464,78594,16785,33956
8600000US33957,6660,3183,3477,102135,166386,21867,33957
8600000US33960,660,324,336,49464,50014,7312,33960
8600000US33965,1651,747,904,,,,33965
8600000US33966,8606,4222,4384,61911,94467,12342,33966
8600000US33967,20028,10244,9784,64896,81572,8973,33967
8600000US33971,19033,9353,9680,50212,59884,3108,33971
8600000US33972,11603,5772,5831,58151,62140,3833,33972
8600000US33973,9091,4140,4951,39250,48599,5122,33973
8600000US33974,12244,5848,6396,47831,56746,3461,33974
8600000US33976,12478,6519,5959,48957,58665,3424,33976
8600000US33980,11438,5090,6348,43559,57556,3627,33980
8600000US33981,9373,4580,4793,54461,69971,6875,33981
8600000US33982,9115,4995,4120,47067,61100,5574,33982
8600000US33983,11962,5423,6539,54683,73904,8917,33983
8600000US33990,27400,12745,14655,54022,67672,4236,33990
8600000US33991,16879,8125,8754,66095,80259,6135,33991
8600000US33993,19402,9430,9972,58935,74802,6008,33993
8600000US34101,0,0,0,,,,34101
8600000US34102,10141,4612,5529,80609,188279,16631,34102
8600000US34103,11735,5417,6318,84972,159673,15707,34103
8600000US34104,20443,9671,10772,51793,71795,4953,34104
8600000US34105,14846,6684,8162,88223,142848,13930,34105
8600000US34108,15153,7483,7670,90907,161199,11281,34108
8600000US34109,20451,9095,11356,66038,101901,6972,34109
8600000US34110,21236,10099,11137,77197,120656,9738,34110
8600000US34112,24186,11875,12311,55687,74042,5392,34112
8600000US34113,17248,8526,8722,51992,85502,10191,34113
8600000US34114,14672,7340,7332,59800,84966,6586,34114
8600000US34116,27158,13630,13528,50579,65118,3399,34116
8600000US34117,12883,6559,6324,73010,85312,5901,34117
8600000US34119,25785,12349,13436,87992,115697,9899,34119
8600000US34120,24345,12500,11845,79244,114951,17994,34120
8600000US34134,13142,6356,6786,83135,157485,16915,34134
8600000US34135,39337,19778,19559,61809,89364,5286,34135
8600000US34137,195,81,114,23219,,,34137
8600000US34138,268,71,197,,,,34138
8600000US34139,275,112,163,,47065,19991,34139
8600000US34140,346,146,200,,344531,443939,34140
8600000US34141,41,26,15,,,,34141
8600000US34142,21382,11948,9434,32128,49110,4194,34142
8600000US34145,16274,8039,8235,79157,129120,9286,34145
8600000US34201,3567,1699,1868,92876,138157,35271,34201
8600000US34202,18987,9257,9730,96919,129420,9453,34202
8600000US34203,30119,14239,15880,51569,66573,3196,34203
8600000US34205,25639,11266,14373,40613,52540,2766,34205
8600000US34207,29603,14980,14623,37906,48792,2810,34207
8600000US34208,29411,14251,15160,47139,63994,3486,34208
8600000US34209,29931,14200,15731,57995,82916,6768,34209
8600000US34210,14439,6646,7793,47547,70866,7739,34210
8600000US34211,6616,3318,3298,103385,120618,13086,34211
8600000US34212,15234,7433,7801,91971,106857,7234,34212
8600000US34215,544,255,289,45000,68723,27947,34215
8600000US34216,814,375,439,70833,93104,18343,34216
8600000US34217,4781,2178,2603,61228,98858,13948,34217
8600000US34219,18542,8583,9959,81918,96001,5965,34219
8600000US34221,35611,17466,18145,53329,74676,4039,34221
8600000US34222,9501,4527,4974,51103,64050,5840,34222
8600000US34223,16117,7786,8331,53430,72698,3199,34223
8600000US34224,14221,6825,7396,44673,58185,4644,34224
8600000US34228,7112,3396,3716,104825,181903,20082,34228
8600000US34229,6717,3282,3435,91972,136110,24149,34229
8600000US34231,26068,12108,13960,51758,72353,4719,34231
8600000US34232,28691,13518,15173,64331,82160,4108,34232
8600000US34233,14661,6672,7989,60589,81831,5545,34233
8600000US34234,17371,8115,9256,35891,50173,4073,34234
8600000US34235,12484,5716,6768,56761,81505,8294,34235
8600000US34236,11820,5250,6570,53247,109248,12089,34236
8600000US34237,14560,7558,7002,42341,52796,3246,34237
8600000US34238,17479,8002,9477,72426,107643,8344,34238
8600000US34239,12908,6081,6827,56059,90848,6685,34239
8600000US34240,8663,3940,4723,88430,131617,14308,34240
8600000US34241,11984,5623,6361,82616,105343,8647,34241
8600000US34242,6985,3408,3577,100352,159573,13670,34242
8600000US34243,27482,12403,15079,61541,77313,3654,34243
8600000US34251,4819,2415,2404,82154,103923,18759,34251
8600000US34266,25519,15096,10423,33810,47001,3937,34266
8600000US34268,109,35,74,23286,21925,2956,34268
8600000US34269,3626,1790,1836,41535,57458,6761,34269
8600000US34275,17425,8732,8693,60258,91701,11399,34275
8600000US34285,17313,8007,9306,52701,73491,4728,34285
8600000US34286,13970,6472,7498,64500,77994,8887,34286
8600000US34287,23841,10998,12843,50627,67759,5593,34287
8600000US34288,9908,4823,5085,56746,80062,20195,34288
8600000US34289,2959,1501,1458,54922,81807,22681,34289
8600000US34291,4812,2163,2649,57841,71959,9283,34291
8600000US34292,14457,6778,7679,61759,81607,6778,34292
8600000US34293,33612,16046,17566,57835,80698,3347,34293
8600000US34420,14210,6812,7398,42040,56847,8349,34420
8600000US34428,7935,3737,4198,38250,62097,13264,34428
8600000US34429,7308,3852,3456,42398,67439,14594,34429
8600000US34431,6470,2980,3490,38553,49123,5303,34431
8600000US34432,10624,5086,5538,41921,52973,4012,34432
8600000US34433,5098,2428,2670,52525,67122,14399,34433
8600000US34434,6132,2816,3316,47369,52116,4688,34434
8600000US34436,6837,3415,3422,36401,52822,7115,34436
8600000US34442,12501,6191,6310,46612,64132,5059,34442
8600000US34445,0,0,0,,,,34445
8600000US34446,14609,7003,7606,44962,51801,3312,34446
8600000US34448,9043,4571,4472,38397,49270,5833,34448
8600000US34449,2668,1347,1321,25970,39130,5817,34449
8600000US34450,9171,4018,5153,36630,60290,13888,34450
8600000US34452,9521,4447,5074,38151,48055,4011,34452
8600000US34453,9158,4528,4630,39495,50688,4793,34453
8600000US34461,9386,4679,4707,44536,61591,6760,34461
8600000US34465,14601,6485,8116,37870,51532,4095,34465
8600000US34470,15694,7864,7830,36440,50451,4553,34470
8600000US34471,19127,9029,10098,49805,77197,8535,34471
8600000US34472,23229,10496,12733,42003,56137,4483,34472
8600000US34473,15315,6989,8326,52949,63197,5819,34473
8600000US34474,13199,5959,7240,43394,59473,8087,34474
8600000US34475,9926,5085,4841,23955,40968,6019,34475
8600000US34476,19492,8882,10610,51241,63557,4099,34476
8600000US34479,10431,4653,5778,43879,55169,4911,34479
8600000US34480,14566,6873,7693,53160,75928,9536,34480
8600000US34481,17734,8440,9294,42276,55466,5051,34481
8600000US34482,21290,9403,11887,41820,62397,7195,34482
8600000US34484,2785,1021,1764,42697,54815,9307,34484
8600000US34488,8243,4224,4019,33302,42833,4301,34488
8600000US34491,22066,10701,11365,46338,59129,4017,34491
8600000US34498,461,224,237,40938,51606,7495,34498
8600000US34601,17680,8044,9636,38699,54713,4078,34601
8600000US34602,5864,2863,3001,53675,66347,6352,34602
8600000US34604,9209,4287,4922,53694,68128,5174,34604
8600000US34606,22042,10387,11655,41744,51975,2300,34606
8600000US34607,7806,3789,4017,44213,66301,7303,34607
8600000US34608,27605,13472,14133,45573,54341,2351,34608
8600000US34609,32107,15031,17076,52582,65797,3351,34609
8600000US34610,11587,5814,5773,49551,62108,4708,34610
8600000US34613,15319,7459,7860,43059,55157,4073,34613
8600000US34614,5731,2713,3018,49841,68908,11823,34614
8600000US34637,6854,4171,2683,80691,106329,12406,34637
8600000US34638,18430,8777,9653,92393,108091,5276,34638
8600000US34639,21182,9721,11461,80380,93299,3932,34639
8600000US34652,19758,9208,10550,37171,57981,4636,34652
8600000US34653,28274,13149,15125,40321,52479,3152,34653
8600000US34654,18643,9250,9393,48903,67184,4278,34654
8600000US34655,32008,15108,16900,61845,79604,3596,34655
8600000US34661,101,17,84,31250,31619,13775,34661
8600000US34667,29215,13701,15514,42472,52902,2479,34667
8600000US34668,37950,17741,20209,36261,46553,1980,34668
8600000US34669,10328,5061,5267,47072,54509,3397,34669
8600000US34677,18015,8387,9628,62288,92196,5996,34677
8600000US34679,86,30,56,,44034,15036,34679
8600000US34681,677,372,305,58438,75871,30150,34681
8600000US34683,27037,12246,14791,62766,90289,6695,34683
8600000US34684,24774,11214,13560,51853,68785,3347,34684
8600000US34685,15217,7086,8131,84403,109731,8687,34685
8600000US34688,5485,2606,2879,85766,130238,15862,34688
8600000US34689,22563,10456,12107,47262,72889,5217,34689
8600000US34690,9982,4730,5252,35364,47273,4722,34690
8600000US34691,16363,8044,8319,39836,49383,3100,34691
8600000US34695,14784,6786,7998,72813,101388,8979,34695
8600000US34698,33498,15393,18105,48246,65229,2780,34698
8600000US34705,1951,957,994,54708,67193,12923,34705
8600000US34711,47468,22665,24803,67795,77493,3798,34711
8600000US34714,16378,8432,7946,54141,63150,4627,34714
8600000US34715,13884,7237,6647,59202,74226,6541,34715
8600000US34731,11107,5076,6031,46800,65942,5081,34731
8600000US34734,3017,1213,1804,62014,87691,13692,34734
8600000US34736,14115,6494,7621,58628,69973,7611,34736
8600000US34737,2069,995,1074,58011,81119,11241,34737
8600000US34739,235,116,119,,35689,15856,34739
8600000US34741,34559,17444,17115,37148,49849,3168,34741
8600000US34743,33593,15489,18104,43915,53235,3329,34743
8600000US34744,41526,20570,20956,48991,66078,4115,34744
8600000US34746,33323,16045,17278,54056,64493,5513,34746
8600000US34747,15508,7479,8029,63591,89904,8993,34747
8600000US34748,32957,15379,17578,43969,54246,2344,34748
8600000US34753,4294,2420,1874,43750,49714,5509,34753
8600000US34756,2805,1475,1330,70565,92644,17362,34756
8600000US34758,29943,15019,14924,49329,60567,5355,34758
8600000US34759,29773,14291,15482,50952,56627,3991,34759
8600000US34760,668,269,399,62614,87772,23195,34760
8600000US34761,33661,16539,17122,63923,81010,6513,34761
8600000US34762,470,249,221,60781,65868,23338,34762
8600000US34769,19221,9213,10008,45951,62193,7359,34769
8600000US34771,13264,6829,6435,72769,89327,7339,34771
8600000US34772,22231,10313,11918,66652,74820,5046,34772
8600000US34773,2483,1116,1367,64529,73062,10055,34773
8600000US34785,33138,18287,14851,59268,76454,5864,34785
8600000US34786,30509,14813,15696,102375,161948,15347,34786
8600000US34787,48047,22536,25511,70723,99287,7362,34787
8600000US34788,14633,7046,7587,42605,54622,3356,34788
8600000US34797,927,429,498,79056,75864,7851,34797
8600000US34945,4111,2506,1605,46576,68605,9248,34945
8600000US34946,4802,2546,2256,30657,42971,5601,34946
8600000US34947,9333,3896,5437,32818,43743,4269,34947
8600000US34949,7165,3335,3830,63718,91250,9480,34949
8600000US34950,12583,5988,6595,25278,39450,4301,34950
8600000US34951,13933,6782,7151,42272,54152,3783,34951
8600000US34952,33952,16112,17840,44462,58571,3354,34952
8600000US34953,51958,24645,27313,61171,70857,5303,34953
8600000US34956,7490,4558,2932,39282,53753,4785,34956
8600000US34957,20323,10143,10180,54349,75749,4745,34957
8600000US34972,15432,8967,6465,37151,49175,3510,34972
8600000US34974,19829,9948,9881,41952,57601,4790,34974
8600000US34981,4095,2211,1884,52841,59555,9621,34981
8600000US34982,20485,9677,10808,37947,49491,3596,34982
8600000US34983,33679,16464,17215,54359,70259,4895,34983
8600000US34984,12587,6479,6108,61667,74991,7919,34984
8600000US34986,21341,10171,11170,54167,76261,7778,34986
8600000US34987,6794,3227,3567,72581,79701,7488,34987
8600000US34990,24991,11379,13612,79817,122377,10580,34990
8600000US34994,13874,6908,6966,45905,67586,6424,34994
8600000US34996,9789,4899,4890,65798,116920,13063,34996
8600000US34997,36502,17929,18573,54215,75148,3356,34997
8600000US35004,8820,4219,4601,60822,69626,5015,35004
8600000US35005,5691,2620,3071,47490,58674,5464,35005
8600000US35006,2308,1165,1143,45743,64874,13356,35006
8600000US35007,19178,9439,9739,71173,78914,3420,35007
8600000US35010,16142,7809,8333,38584,55634,3608,35010
8600000US35013,40,40,0,,,,35013
8600000US35014,3889,2099,1790,46709,54822,7376,35014
8600000US35016,12655,5913,6742,43863,62886,3923,35016
8600000US35019,1579,724,855,30441,47339,10456,35019
8600000US35020,20248,9382,10866,29067,40071,1895,35020
8600000US35022,16354,7728,8626,58195,70255,5108,35022
8600000US35023,18835,9744,9091,53013,63266,3180,35023
8600000US35031,6210,2885,3325,43663,56401,7217,35031
8600000US35032,35,15,20,29250,31518,5720,35032
8600000US35033,2361,1306,1055,37548,56520,10497,35033
8600000US35034,4700,3222,1478,34408,43277,8969,35034
8600000US35035,1049,619,430,86750,88997,29777,35035
8600000US35036,176,57,119,16150,25049,7923,35036
8600000US35040,12290,5737,6553,63763,68511,2746,35040
8600000US35042,4843,2258,2585,49719,60891,8485,35042
8600000US35043,8086,3838,4248,87398,95848,5327,35043
8600000US35044,5417,2709,2708,38560,45392,5157,35044
8600000US35045,11483,5582,5901,45323,68862,11583,35045
8600000US35046,3593,1657,1936,46831,56421,6061,35046
8600000US35049,2605,1245,1360,46250,54524,7312,35049
8600000US35051,7079,3700,3379,47460,71720,12837,35051
8600000US35052,275,138,137,,,,35052
8600000US35053,2157,1046,1111,50577,91829,37739,35053
8600000US35054,3069,1646,1423,45469,61618,12523,35054
8600000US35055,15774,7438,8336,42252,59748,6474,35055
8600000US35057,10183,5017,5166,51868,65414,4083,35057
8600000US35058,7309,3384,3925,41788,59957,8253,35058
8600000US35060,294,176,118,22961,28561,8289,35060
8600000US35061,971,531,440,39313,56939,12290,35061
8600000US35062,5865,2743,3122,48125,72699,11438,35062
8600000US35063,2892,1450,1442,45260,60482,9359,35063
8600000US35064,8910,3864,5046,37199,45429,3805,35064
8600000US35068,6292,2817,3475,57723,68411,8418,35068
8600000US35070,182,96,86,34063,51231,24273,35070
8600000US35071,12359,5721,6638,66928,79372,5578,35071
8600000US35072,3866,1973,1893,42011,51084,6488,35072
8600000US35073,1929,801,1128,43281,51657,6464,35073
8600000US35074,0,0,0,,,,35074
8600000US35077,10843,5596,5247,40411,52980,4234,35077
8600000US35078,1535,699,836,56833,76846,11625,35078
8600000US35079,7127,3580,3547,55265,64859,4312,35079
8600000US35080,12646,6045,6601,87346,95844,5279,35080
8600000US35082,0,0,0,,,,35082
8600000US35083,2477,1249,1228,34637,43094,5661,35083
8600000US35085,6812,3280,3532,38943,58095,9044,35085
8600000US35087,1864,771,1093,28534,56797,27947,35087
8600000US35089,1783,798,985,30306,42014,7084,35089
8600000US35091,2122,1022,1100,86250,89148,5862,35091
8600000US35094,10899,5482,5417,58988,77129,4369,35094
8600000US35096,6329,2878,3451,54808,62905,4579,35096
8600000US35097,1453,725,728,49063,59438,6893,35097
8600000US35098,827,430,397,36250,53097,10648,35098
8600000US35111,13496,6591,6905,76288,83862,4955,35111
8600000US35112,240,111,129,,84065,33485,35112
8600000US35114,6516,3269,3247,82102,94237,7411,35114
8600000US35115,12260,5249,7011,40514,53337,4292,35115
8600000US35116,3431,1622,1809,62544,72665,5144,35116
8600000US35117,4097,2047,2050,70982,80870,6486,35117
8600000US35118,2386,1161,1225,56983,61166,5048,35118
8600000US35119,197,39,158,,,,35119
8600000US35120,10449,5126,5323,61161,69092,4580,35120
8600000US35121,11959,5738,6221,46847,61982,7917,35121
8600000US35124,18805,8795,10010,75701,97118,7598,35124
8600000US35125,8986,4176,4810,40560,50205,5178,35125
8600000US35126,16452,7574,8878,64349,76926,5096,35126
8600000US35127,8067,3716,4351,69524,80238,6840,35127
8600000US35128,8375,3872,4503,60046,72797,7576,35128
8600000US35130,2205,993,1212,38333,49083,5287,35130
8600000US35131,3266,1767,1499,38906,55629,7292,35131
8600000US35133,2741,1274,1467,50517,54357,8479,35133
8600000US35135,1531,713,818,54138,70920,10209,35135
8600000US35136,1676,831,845,41184,58028,12191,35136
8600000US35139,148,71,77,,29660,15475,35139
8600000US35143,2474,1161,1313,55500,69010,12618,35143
8600000US35146,9214,5026,4188,66969,76497,10048,35146
8600000US35147,4536,2250,2286,77007,96068,9159,35147
8600000US35148,1897,879,1018,38828,59031,10005,35148
8600000US35149,413,215,198,41139,39006,8501,35149
8600000US35150,13113,5889,7224,32496,47998,2884,35150
8600000US35151,5865,2942,2923,41797,61641,10732,35151
8600000US35160,21345,10494,10851,34666,49740,3210,35160
8600000US35171,2700,1370,1330,48646,60187,5681,35171
8600000US35172,2612,1374,1238,29811,51115,9811,35172
8600000US35173,20007,9531,10476,85378,102554,5620,35173
8600000US35175,4270,2165,2105,51411,66077,10566,35175
8600000US35176,711,435,276,,49910,10982,35176
8600000US35178,2692,1190,1502,39145,55151,6944,35178
8600000US35179,6852,3267,3585,44859,57047,4581,35179
8600000US35180,10794,5351,5443,58968,68937,4517,35180
8600000US35183,892,436,456,56512,74959,23169,35183
8600000US35184,3417,1636,1781,41639,52246,6173,35184
8600000US35186,4099,2112,1987,62670,86763,13962,35186
8600000US35187,5,3,2,,,,35187
8600000US35188,2980,1427,1553,60739,69790,11049,35188
8600000US35203,2846,1669,1177,16617,50633,11782,35203
8600000US35204,7715,3510,4205,21425,32041,2880,35204
8600000US35205,17874,8975,8899,36391,62253,4295,35205
8600000US35206,13287,5781,7506,32807,46142,4862,35206
8600000US35207,6431,2734,3697,24419,34830,3344,35207
8600000US35208,10258,4659,5599,33020,42116,3176,35208
8600000US35209,21772,9910,11862,56525,93329,6996,35209
8600000US35210,10949,4748,6201,51623,71735,10650,35210
8600000US35211,19988,8783,11205,31396,42402,2048,35211
8600000US35212,8823,4150,4673,29171,45365,3608,35212
8600000US35213,10008,4641,5367,113472,169124,15168,35213
8600000US35214,14452,6474,7978,47385,57500,2971,35214
8600000US35215,33731,14114,19617,41787,58379,6754,35215
8600000US35216,27347,12541,14806,60650,95941,6049,35216
8600000US35217,10519,4761,5758,33387,47708,6110,35217
8600000US35218,5357,2523,2834,26506,43448,8387,35218
8600000US35221,3797,1738,2059,35691,51250,12916,35221
8600000US35222,7210,3526,3684,60989,81545,6518,35222
8600000US35223,8463,3908,4555,131295,188929,15617,35223
8600000US35224,4037,1929,2108,34435,40702,5679,35224
8600000US35226,26130,12431,13699,100686,121690,5577,35226
8600000US35228,8291,3624,4667,32943,44848,4180,35228
8600000US35229,1211,382,829,,,,35229
8600000US35233,1631,984,647,41500,55558,11619,35233
8600000US35234,4696,2150,2546,26008,38522,7080,35234
8600000US35235,15965,7010,8955,55609,62829,3720,35235
8600000US35242,42572,20013,22559,91966,128831,6147,35242
8600000US35243,13874,6686,7188,82965,126186,10658,35243
8600000US35244,24586,11971,12615,86971,111574,4640,35244
8600000US35254,1525,734,791,20057,33154,15527,35254
8600000US35401,31933,14748,17185,25147,38238,2225,35401
8600000US35404,18619,9615,9004,40616,56486,5483,35404
8600000US35405,35083,16310,18773,56240,68266,2957,35405
8600000US35406,12677,5898,6779,102403,131900,9220,35406
8600000US35441,812,440,372,40865,54477,10084,35441
8600000US35442,5119,1889,3230,30332,45339,5775,35442
8600000US35443,1459,844,615,14983,27021,8328,35443
8600000US35444,3129,1402,1727,50875,58432,5480,35444
8600000US35446,1575,682,893,45250,57892,8357,35446
8600000US35447,2279,1179,1100,33750,52046,11325,35447
8600000US35452,2504,1111,1393,52589,81284,32868,35452
8600000US35453,8150,3754,4396,56044,62591,5065,35453
8600000US35456,2799,1330,1469,53462,66922,14367,35456
8600000US35457,0,0,0,,,,35457
8600000US35458,478,290,188,34167,85661,58619,35458
8600000US35459,1057,454,603,36500,47948,10368,35459
8600000US35460,765,389,376,22163,35593,12055,35460
8600000US35461,1683,899,784,40104,56049,13203,35461
8600000US35462,3580,1546,2034,21295,32668,4798,35462
8600000US35463,1360,708,652,53897,66670,11116,35463
8600000US35464,445,209,236,12500,23935,8102,35464
8600000US35466,4324,2191,2133,50968,67573,11629,35466
8600000US35469,166,55,111,,27188,21522,35469
8600000US35470,3781,1633,2148,14983,37134,11272,35470
8600000US35473,12549,6085,6464,64045,73287,4587,35473
8600000US35474,4868,2220,2648,51228,72795,13470,35474
8600000US35475,12072,6268,5804,77537,86234,4667,35475
8600000US35476,5750,2393,3357,35777,45179,3810,35476
8600000US35477,125,93,32,54191,44332,17074,35477
8600000US35480,1097,567,530,83375,82452,12268,35480
8600000US35481,2949,1466,1483,27917,44674,6190,35481
8600000US35490,2892,1404,1488,54202,61913,5913,35490
8600000US35501,7357,3705,3652,37712,53262,6228,35501
8600000US35503,7159,3524,3635,49542,60020,6554,35503
8600000US35504,10362,4930,5432,50305,67272,6955,35504
8600000US35540,1964,934,1030,43844,64027,19117,35540
8600000US35541,2897,1382,1515,45640,60682,8165,35541
8600000US35542,866,377,489,36150,55179,12554,35542
8600000US35543,992,529,463,32957,44737,9896,35543
8600000US35544,378,188,190,45000,72753,44659,35544
8600000US35545,104,49,55,30592,32788,9853,35545
8600000US35546,2930,1387,1543,46207,53951,6913,35546
8600000US35548,1349,642,707,35573,42171,4577,35548
8600000US35549,2792,1256,1536,34476,44194,4989,35549
8600000US35550,4590,2239,2351,40286,49514,5963,35550
8600000US35552,602,311,291,34375,43886,10403,35552
8600000US35553,3568,1910,1658,34706,44474,5539,35553
8600000US35554,817,389,428,33000,44094,6844,35554
8600000US35555,7572,3646,3926,39398,57335,6549,35555
8600000US35559,12,6,6,,,,35559
8600000US35563,3623,1800,1823,38114,49842,5039,35563
8600000US35564,1703,756,947,26594,44415,7407,35564
8600000US35565,10206,5066,5140,34163,47479,5113,35565
8600000US35570,9177,4333,4844,36168,51155,6107,35570
8600000US35571,670,356,314,43264,59558,16348,35571
8600000US35572,1022,541,481,31250,46735,12349,35572
8600000US35574,1376,713,663,36649,74925,35288,35574
8600000US35575,808,371,437,40792,46676,5986,35575
8600000US35576,2524,1284,1240,46361,56104,6201,35576
8600000US35577,20,9,11,,,,35577
8600000US35578,4537,2180,2357,37275,51479,5803,35578
8600000US35579,2649,1150,1499,40994,53230,9270,35579
8600000US35580,2798,1325,1473,40919,54938,5746,35580
8600000US35581,4217,1863,2354,37402,49423,5841,35581
8600000US35582,3111,1443,1668,36850,46798,5185,35582
8600000US35584,282,149,133,38125,42478,8769,35584
8600000US35585,951,499,452,42414,59592,12532,35585
8600000US35586,3185,1378,1807,29076,42170,4902,35586
8600000US35587,587,339,248,35563,44232,7675,35587
8600000US35592,3556,1717,1839,36299,46720,8293,35592
8600000US35593,1300,696,604,40885,51332,5458,35593
8600000US35594,5448,2827,2621,38878,54858,6079,35594
8600000US35601,24588,11719,12869,41204,54827,2913,35601
8600000US35603,24944,11792,13152,53396,73862,5134,35603
8600000US35610,1479,722,757,41198,56656,9983,35610
8600000US35611,20323,9232,11091,38210,56663,4579,35611
8600000US35613,20061,11031,9030,77179,94233,7014,35613
8600000US35614,5759,2883,2876,42936,51027,4649,35614
8600000US35615,245,136,109,,,,35615
8600000US35616,2936,1476,1460,41636,52861,6332,35616
8600000US35618,1417,716,701,30655,36703,4086,35618
8600000US35619,3570,1853,1717,50036,63712,8524,35619
8600000US35620,7120,3564,3556,53401,69908,7956,35620
8600000US35621,2411,1347,1064,45991,61106,11965,35621
8600000US35622,5986,3066,2920,52198,58729,4819,35622
8600000US35630,27240,12540,14700,34781,49476,3314,35630
8600000US35633,15876,7529,8347,55859,70460,5734,35633
8600000US35634,8167,4041,4126,70996,87513,11217,35634
8600000US35640,18755,8989,9766,55706,69525,3774,35640
8600000US35643,3154,1487,1667,48568,61171,10220,35643
8600000US35645,11098,5265,5833,61442,81043,6582,35645
8600000US35646,3815,1880,1935,42028,50851,4579,35646
8600000US35647,966,485,481,46979,63560,11855,35647
8600000US35648,2506,1253,1253,49961,58742,5932,35648
8600000US35649,71,33,38,108750,161118,147777,35649
8600000US35650,10758,5166,5592,43727,55933,4266,35650
8600000US35651,935,370,565,33456,47003,8733,35651
8600000US35652,6862,3224,3638,50233,67712,6587,35652
8600000US35653,8199,4096,4103,42485,53810,5649,35653
8600000US35654,6126,2969,3157,41168,53168,5195,35654
8600000US35660,7200,3154,4046,34688,50632,5286,35660
8600000US35661,13529,6208,7321,57127,71629,7362,35661
8600000US35670,5325,2722,2603,51495,62475,5968,35670
8600000US35671,1826,954,872,,53957,13718,35671
8600000US35672,4666,2315,2351,52236,60762,5014,35672
8600000US35673,5804,2950,2854,54379,74530,12772,35673
8600000US35674,14323,6910,7413,51127,58084,3694,35674
8600000US35677,1334,630,704,38802,48053,5530,35677
8600000US35739,3810,1975,1835,51563,67218,11158,35739
8600000US35740,2427,1034,1393,30071,43843,6011,35740
8600000US35741,2467,1131,1336,78942,124613,47095,35741
8600000US35744,1699,787,912,34800,43720,6445,35744
8600000US35745,158,87,71,30938,56799,24664,35745
8600000US35746,510,228,282,33087,35064,12015,35746
8600000US35747,4224,2133,2091,50016,78403,18291,35747
8600000US35748,5521,2770,2751,62394,97420,20060,35748
8600000US35749,16472,7885,8587,88455,95356,5866,35749
8600000US35750,9775,4884,4891,50284,66032,5542,35750
8600000US35751,234,170,64,18304,80127,69867,35751
8600000US35752,2116,835,1281,45293,47530,6402,35752
8600000US35754,4253,2117,2136,53245,65774,9012,35754
8600000US35755,584,263,321,37297,59828,17075,35755
8600000US35756,9835,4628,5207,87409,102471,8041,35756
8600000US35757,12312,5847,6465,92018,104766,8100,35757
8600000US35758,34976,17417,17559,85353,113423,5532,35758
8600000US35759,5888,2974,2914,87260,104580,17975,35759
8600000US35760,3824,1809,2015,49832,65898,6526,35760
8600000US35761,9490,4506,4984,63528,75256,5644,35761
8600000US35763,13250,6687,6563,110264,132199,10093,35763
8600000US35764,398,179,219,46125,47209,12456,35764
8600000US35765,3196,1717,1479,31192,53354,8706,35765
8600000US35766,93,42,51,,33875,24184,35766
8600000US35768,9055,4297,4758,41854,55425,5787,35768
8600000US35769,7831,3704,4127,42369,62869,7253,35769
8600000US35771,3015,1516,1499,47639,53518,6592,35771
8600000US35772,3337,1722,1615,32449,42768,6271,35772
8600000US35773,9967,4925,5042,51959,66867,5084,35773
8600000US35774,223,110,113,45833,41518,10905,35774
8600000US35775,837,552,285,31750,38349,9231,35775
8600000US35776,2742,1392,1350,38182,50341,6230,35776
8600000US35801,19334,10009,9325,69276,103385,7096,35801
8600000US35802,17769,8377,9392,67029,95380,4446,35802
8600000US35803,20296,9609,10687,76796,95445,5849,35803
8600000US35805,15375,7271,8104,25329,36754,4135,35805
8600000US35806,17800,8653,9147,68255,84103,4589,35806
8600000US35808,1143,781,362,84375,93571,11474,35808
8600000US35810,23401,10505,12896,37879,50917,2609,35810
8600000US35811,21606,10079,11527,62688,79199,4366,35811
8600000US35816,11577,5317,6260,25270,33356,2197,35816
8600000US35824,6654,3317,3337,86222,97655,9545,35824
8600000US35896,690,172,518,,,,35896
8600000US35901,15575,7398,8177,37809,58465,4292,35901
8600000US35903,13715,6333,7382,36949,51285,4298,35903
8600000US35904,11048,5435,5613,36763,52028,5283,35904
8600000US35905,4904,2206,2698,58219,71687,8790,35905
8600000US35906,7673,3715,3958,49419,66068,8033,35906
8600000US35907,6807,3352,3455,71368,81185,7048,35907
8600000US35950,14788,7146,7642,40945,51800,3007,35950
8600000US35951,9410,4614,4796,36473,55407,6364,35951
8600000US35952,5624,2810,2814,40826,49479,4512,35952
8600000US35953,5677,2827,2850,50072,57382,5402,35953
8600000US35954,9281,4297,4984,40664,50362,3956,35954
8600000US35956,6968,3325,3643,49789,61135,4402,35956
8600000US35957,11769,5779,5990,38342,55195,5517,35957
8600000US35958,2938,1532,1406,43092,55325,10527,35958
8600000US35959,3814,1816,1998,40589,51184,5946,35959
8600000US35960,7823,3788,4035,42073,62163,7682,35960
8600000US35961,5349,2756,2593,38535,51049,6351,35961
8600000US35962,6818,3505,3313,37230,51963,6065,35962
8600000US35963,967,410,557,26637,47421,16040,35963
8600000US35966,3086,1459,1627,36432,47439,6346,35966
8600000US35967,12137,5848,6289,39746,50963,3373,35967
8600000US35968,3684,1810,1874,41443,57001,7882,35968
8600000US35971,4115,2065,2050,39980,65504,14696,35971
8600000US35972,861,446,415,58472,64540,14421,35972
8600000US35973,2263,1193,1070,33011,42605,5311,35973
8600000US35974,1081,532,549,28798,58993,20864,35974
8600000US35975,416,179,237,,53222,19929,35975
8600000US35976,13862,6670,7192,48841,70877,4768,35976
8600000US35978,3742,1858,1884,40104,51258,5819,35978
8600000US35979,1215,576,639,40500,37574,8472,35979
8600000US35980,3642,1870,1772,39340,56092,8252,35980
8600000US35981,1482,698,784,39402,62621,26159,35981
8600000US35983,3101,1582,1519,52852,64724,8475,35983
8600000US35984,1371,658,713,35167,66755,12920,35984
8600000US35986,6183,2861,3322,38046,51264,5941,35986
8600000US35987,1956,887,1069,39766,48831,5469,35987
8600000US35988,1539,730,809,45819,59293,7559,35988
8600000US35989,2579,1304,1275,37750,60365,9323,35989
8600000US35990,86,41,45,48214,51480,24558,35990
8600000US36003,1696,756,940,27841,54852,13610,36003
8600000US36005,1318,686,632,46250,68258,18725,36005
8600000US36006,833,373,460,47148,58171,16448,36006
8600000US36009,1832,868,964,34074,56942,8127,36009
8600000US36010,3857,1726,2131,36639,51269,6527,36010
8600000US36013,512,234,278,103259,108856,24848,36013
8600000US36016,4217,2672,1545,33142,42988,5007,36016
8600000US36017,2471,1783,688,25288,41282,9171,36017
8600000US36020,744,314,430,42273,57206,10534,36020
8600000US36022,9389,4726,4663,67513,84131,13664,36022
8600000US36024,4045,1877,2168,57970,75628,11196,36024
8600000US36025,5929,4273,1656,46714,68013,12070,36025
8600000US36026,821,437,384,44028,62647,21994,36026
8600000US36027,11566,5405,6161,34588,49896,2765,36027
8600000US36028,1312,613,699,37604,50932,6292,36028
8600000US36029,945,630,315,44525,62533,20410,36029
8600000US36030,550,209,341,29688,57745,16956,36030
8600000US36031,158,61,97,31250,43989,21806,36031
8600000US36032,1740,773,967,35545,47414,7160,36032
8600000US36033,3353,1497,1856,38575,47698,5594,36033
8600000US36034,753,377,376,40417,55335,10148,36034
8600000US36035,1128,584,544,44563,61337,9696,36035
8600000US36036,1538,750,788,42250,69899,26070,36036
8600000US36037,10081,4496,5585,39346,54085,4488,36037
8600000US36038,47,18,29,33333,36983,10169,36038
8600000US36039,234,120,114,50481,57352,12763,36039
8600000US36040,2823,1354,1469,23968,39591,5182,36040
8600000US36041,1080,656,424,44671,92904,45873,36041
8600000US36042,1440,779,661,49792,59569,12281,36042
8600000US36043,2952,1328,1624,37917,61841,13500,36043
8600000US36046,1142,501,641,46625,52913,8114,36046
8600000US36047,820,374,446,38710,49831,14168,36047
8600000US36048,1205,609,596,35787,44167,6582,36048
8600000US36049,4731,2131,2600,41042,53541,4488,36049
8600000US36051,1672,863,809,69423,92382,23104,36051
8600000US36052,264,112,152,66563,102105,29601,36052
8600000US36053,1323,682,641,25282,41178,7342,36053
8600000US36054,11624,4946,6678,58573,71255,5841,36054
8600000US36064,6944,3406,3538,105830,117948,8143,36064
8600000US36066,14339,6900,7439,62089,84257,16866,36066
8600000US36067,21545,10193,11352,53578,67246,3722,36067
8600000US36069,1771,812,959,44255,64560,11864,36069
8600000US36071,385,194,191,39107,45023,10502,36071
8600000US36075,1725,835,890,39500,59471,15154,36075
8600000US36078,9959,4598,5361,54149,64302,6822,36078
8600000US36079,8002,4108,3894,48438,67147,7112,36079
8600000US36080,1742,888,854,65406,86791,19033,36080
8600000US36081,12767,5647,7120,27711,46617,6569,36081
8600000US36082,1250,625,625,,,,36082
8600000US36083,6056,2845,3211,32019,49119,4048,36083
8600000US36088,4163,1665,2498,27743,47388,8702,36088
8600000US36089,5800,3123,2677,29602,43304,7173,36089
8600000US36091,2839,1433,1406,40125,66309,20777,36091
8600000US36092,15726,6913,8813,54499,64390,5849,36092
8600000US36093,8030,3775,4255,86869,101971,7957,36093
8600000US36104,6711,3500,3211,23652,43642,4982,36104
8600000US36105,8021,3396,4625,30660,44124,4580,36105
8600000US36106,12028,5202,6826,55255,80530,5668,36106
8600000US36107,5651,2638,3013,30797,44208,5754,36107
8600000US36108,13961,5953,8008,24690,38474,3494,36108
8600000US36109,19905,9838,10067,53548,67123,3349,36109
8600000US36110,8881,4177,4704,31305,45152,6871,36110
8600000US36111,9152,4043,5109,49988,81665,8667,36111
8600000US36112,320,274,46,,,,36112
8600000US36113,1453,1213,240,92813,90945,8164,36113
8600000US36115,606,351,255,62019,95139,22695,36115
8600000US36116,32587,14527,18060,43683,64682,5025,36116
8600000US36117,40752,18826,21926,62753,82560,3405,36117
8600000US36201,14060,6567,7493,28402,40866,2636,36201
8600000US36203,13825,6464,7361,54835,73223,8045,36203
8600000US36205,585,347,238,59375,80034,27924,36205
8600000US36206,8688,4222,4466,44226,57192,5153,36206
8600000US36207,15716,7117,8599,50809,77198,9369,36207
8600000US36250,3755,1696,2059,70606,73229,8524,36250
8600000US36251,4000,1777,2223,34362,56836,11858,36251
8600000US36255,602,324,278,44297,61880,21908,36255
8600000US36256,1278,677,601,46600,58441,7928,36256
8600000US36258,1118,543,575,56848,70197,11643,36258
8600000US36260,2961,1530,1431,41537,48181,7192,36260
8600000US36262,1035,613,422,36750,68037,29565,36262
8600000US36263,419,180,239,26154,34069,14218,36263
8600000US36264,6625,3147,3478,36169,51813,5842,36264
8600000US36265,16772,8206,8566,49356,62641,4044,36265
8600000US36266,3952,2007,1945,45720,55067,7038,36266
8600000US36267,12,12,0,,,,36267
8600000US36268,4428,1932,2496,52561,58535,6394,36268
8600000US36269,1053,442,611,55536,56622,9675,36269
8600000US36271,4770,2429,2341,53448,71405,10855,36271
8600000US36272,10153,4722,5431,38513,50687,4138,36272
8600000US36273,2378,1154,1224,45208,57205,6348,36273
8600000US36274,8876,4048,4828,40568,54791,7487,36274
8600000US36276,2092,1060,1032,31000,55874,16919,36276
8600000US36277,4127,1742,2385,54449,60417,5058,36277
8600000US36278,3671,1850,1821,39330,60315,9845,36278
8600000US36279,1957,1033,924,55913,107310,39857,36279
8600000US36280,2982,1438,1544,47847,54428,7054,36280
8600000US36301,28382,13181,15201,40702,56374,2441,36301
8600000US36303,23703,11097,12606,42724,64574,1918,36303
8600000US36305,11934,5387,6547,64987,90499,3685,36305
8600000US36310,5070,2498,2572,40641,53396,5351,36310
8600000US36311,2179,1131,1048,41484,56355,8516,36311
8600000US36312,4719,2236,2483,41429,59394,3428,36312
8600000US36313,166,91,75,83421,83564,21567,36313
8600000US36314,365,158,207,46902,63335,35713,36314
8600000US36316,1525,736,789,68229,76778,8449,36316
8600000US36317,533,224,309,34286,44255,12196,36317
8600000US36318,1140,569,571,36908,51594,9899,36318
8600000US36319,1544,747,797,40761,52975,6222,36319
8600000US36320,2917,1391,1526,39835,53742,4639,36320
8600000US36321,1298,636,662,41974,50671,4791,36321
8600000US36322,7043,3251,3792,43227,54675,5731,36322
8600000US36323,6318,3089,3229,42832,53519,3147,36323
8600000US36330,27542,13410,14132,57985,73569,3549,36330
8600000US36340,4464,2039,2425,31140,44108,7396,36340
8600000US36343,1127,518,609,41750,53996,6997,36343
8600000US36344,4580,2288,2292,43062,56842,6961,36344
8600000US36345,6595,3080,3515,57618,66490,4971,36345
8600000US36346,1110,540,570,45167,67056,12681,36346
8600000US36350,4853,2224,2629,41282,59327,7133,36350
8600000US36351,2677,1414,1263,48663,61740,5076,36351
8600000US36352,4283,2246,2037,55094,71886,7414,36352
8600000US36353,1354,620,734,43250,60790,9814,36353
8600000US36360,14995,6916,8079,43605,57744,3948,36360
8600000US36362,3377,2188,1189,63839,69809,7924,36362
8600000US36370,702,332,370,48333,66145,18363,36370
8600000US36371,491,222,269,34479,51072,11444,36371
8600000US36373,393,175,218,43103,42444,13563,36373
8600000US36374,607,321,286,58750,76723,15008,36374
8600000US36375,5561,2679,2882,41419,50662,3947,36375
8600000US36376,1813,877,936,42708,57096,4522,36376
8600000US36401,6403,2963,3440,33116,41639,4645,36401
8600000US36420,8157,3842,4315,44229,57614,3247,36420
8600000US36421,7522,3607,3915,41857,60042,5140,36421
8600000US36425,854,390,464,19567,36208,8684,36425
8600000US36426,12022,5605,6417,37910,49670,3610,36426
8600000US36432,1783,822,961,32321,41676,6945,36432
8600000US36435,302,146,156,25741,40114,14779,36435
8600000US36436,337,213,124,37014,58407,23678,36436
8600000US36439,501,202,299,46705,57880,14030,36439
8600000US36441,2996,1396,1600,37692,49697,6619,36441
8600000US36442,2444,1245,1199,31875,49589,9247,36442
8600000US36444,722,248,474,19728,45544,21833,36444
8600000US36445,3437,1735,1702,40417,47838,6698,36445
8600000US36446,358,146,212,17656,27890,8123,36446
8600000US36451,3394,1604,1790,48721,56823,6210,36451
8600000US36453,2010,1058,952,39881,52567,4354,36453
8600000US36454,39,26,13,,,,36454
8600000US36455,201,93,108,31250,42748,9357,36455
8600000US36456,1081,548,533,33125,45539,8665,36456
8600000US36460,7504,3248,4256,32048,49440,5710,36460
8600000US36467,7562,3516,4046,36847,53427,4520,36467
8600000US36470,178,54,124,,,,36470
8600000US36471,891,519,372,22031,32182,8989,36471
8600000US36473,14,8,6,,,,36473
8600000US36474,2448,1243,1205,42159,48548,6543,36474
8600000US36475,1685,888,797,28802,43835,10124,36475
8600000US36476,18,13,5,20250,17300,3753,36476
8600000US36477,2937,1365,1572,25109,39412,4417,36477
8600000US36480,1291,670,621,31912,46310,8463,36480
8600000US36481,420,176,244,15729,25491,7447,36481
8600000US36482,523,271,252,34922,46651,27658,36482
8600000US36483,342,182,160,34500,52806,20080,36483
8600000US36502,14144,8064,6080,31623,44808,3959,36502
8600000US36505,1341,644,697,58005,70062,17749,36505
8600000US36507,16653,8369,8284,43596,63268,6712,36507
8600000US36509,1580,743,837,37760,50573,7621,36509
8600000US36511,345,142,203,20159,20767,7878,36511
8600000US36512,47,24,23,,,,36512
8600000US36513,566,145,421,32670,32545,7766,36513
8600000US36518,2073,1184,889,47647,58965,8940,36518
8600000US36521,4363,1937,2426,52582,62488,5987,36521
8600000US36522,5687,2508,3179,44880,52157,5635,36522
8600000US36523,2312,1286,1026,46944,58055,8062,36523
8600000US36524,912,410,502,35588,43421,5954,36524
8600000US36525,1452,726,726,46250,60054,8498,36525
8600000US36526,25854,12407,13447,71632,84117,4341,36526
8600000US36527,10949,5223,5726,91235,109372,8920,36527
8600000US36528,1100,569,531,84861,96921,12278,36528
8600000US36529,188,84,104,,38774,26782,36529
8600000US36530,5549,2639,2910,47321,63384,5791,36530
8600000US36532,25261,11630,13631,67580,101202,5731,36532
8600000US36535,24537,11049,13488,45684,56253,4201,36535
8600000US36538,336,183,153,28722,32905,8370,36538
8600000US36539,638,241,397,33403,53584,16038,36539
8600000US36540,623,293,330,,42897,16225,36540
8600000US36541,11131,4772,6359,54037,63327,5859,36541
8600000US36542,12231,5602,6629,50787,72980,8486,36542
8600000US36543,154,48,106,93226,71418,31441,36543
8600000US36544,8662,4234,4428,43411,56324,6999,36544
8600000US36545,7606,3521,4085,30966,49074,5467,36545
8600000US36548,742,448,294,31953,58597,20361,36548
8600000US36549,4384,2056,2328,48904,71409,23706,36549
8600000US36550,489,288,201,,63698,35575,36550
8600000US36551,7222,3952,3270,54976,66554,4208,36551
8600000US36553,2559,1338,1221,41622,60372,25224,36553
8600000US36555,715,385,330,54792,71950,12065,36555
8600000US36556,388,205,183,,62760,50599,36556
8600000US36558,2669,1344,1325,45795,57450,6970,36558
8600000US36559,80,33,47,,399170,497135,36559
8600000US36560,2718,1264,1454,37931,50358,9006,36560
8600000US36561,5778,2766,3012,80057,105620,10444,36561
8600000US36562,1135,527,608,44737,59090,13461,36562
8600000US36564,52,10,42,,,,36564
8600000US36567,10528,5345,5183,46783,54357,4502,36567
8600000US36568,67,9,58,,59448,91701,36568
8600000US36569,582,262,320,41685,57971,18233,36569
8600000US36571,11375,5161,6214,60408,74755,6902,36571
8600000US36572,4856,2474,2382,63287,79029,12554,36572
8600000US36574,726,356,370,63839,70824,19211,36574
8600000US36575,15583,7382,8201,59016,69867,7336,36575
8600000US36576,3211,1660,1551,44744,67050,12894,36576
8600000US36578,937,470,467,58625,82422,15030,36578
8600000US36579,983,547,436,39306,54895,14872,36579
8600000US36580,4488,2462,2026,43393,62048,10128,36580
8600000US36581,113,55,58,50273,44526,8409,36581
8600000US36582,18150,8576,9574,52676,66140,3867,36582
8600000US36583,584,256,328,37361,45956,13123,36583
8600000US36584,592,353,239,68750,57475,14279,36584
8600000US36585,663,311,352,27672,38049,14082,36585
8600000US36587,7580,3688,3892,53177,69307,8389,36587
8600000US36590,0,0,0,,,,36590
8600000US36602,939,482,457,23958,49570,10743,36602
8600000US36603,8794,5388,3406,19203,33217,3931,36603
8600000US36604,7535,3588,3947,47695,70765,5212,36604
8600000US36605,19297,8635,10662,31834,46345,3796,36605
8600000US36606,14284,6600,7684,37837,53209,3549,36606
8600000US36607,5142,2449,2693,39813,61618,11449,36607
8600000US36608,28525,13301,15224,49068,72285,4045,36608
8600000US36609,18973,8587,10386,39778,58394,4642,36609
8600000US36610,8052,3342,4710,22639,30136,3165,36610
8600000US36611,3884,1556,2328,32855,42154,3256,36611
8600000US36612,3345,1578,1767,22531,37050,10286,36612
8600000US36613,10196,4826,5370,37911,53009,5556,36613
8600000US36615,0,0,0,,,,36615
8600000US36616,8,0,8,,,,36616
8600000US36617,10376,4649,5727,27626,41617,4008,36617
8600000US36618,13388,6285,7103,47049,56287,4351,36618
8600000US36619,11728,5869,5859,55516,71198,6683,36619
8600000US36688,209,56,153,,,,36688
8600000US36693,15968,7639,8329,60667,80619,6585,36693
8600000US36695,38325,17593,20732,69674,86421,4854,36695
8600000US36701,15979,7174,8805,34377,49394,2641,36701
8600000US36703,10106,4380,5726,27030,41367,3273,36703
8600000US36720,611,237,374,11875,18942,4247,36720
8600000US36722,252,138,114,,31899,11523,36722
8600000US36723,135,44,91,,27154,13672,36723
8600000US36726,3601,1652,1949,33365,48579,6146,36726
8600000US36727,6,6,0,,,,36727
8600000US36728,254,144,110,35556,39088,10668,36728
8600000US36732,6120,2440,3680,28750,49271,5937,36732
8600000US36736,848,455,393,36622,55691,18351,36736
8600000US36738,664,288,376,28654,36374,9756,36738
8600000US36740,1063,467,596,30750,44762,13448,36740
8600000US36742,1472,813,659,39219,55252,10459,36742
8600000US36744,5032,2234,2798,27600,43194,5411,36744
8600000US36748,2336,1067,1269,37694,50036,8768,36748
8600000US36749,704,387,317,37054,43209,14991,36749
8600000US36750,1974,1009,965,52600,72312,17066,36750
8600000US36751,399,168,231,,23666,5905,36751
8600000US36752,960,458,502,54167,63422,9197,36752
8600000US36753,8,0,8,,,,36753
8600000US36754,367,232,135,,199451,249534,36754
8600000US36756,4762,2248,2514,25483,33416,6670,36756
8600000US36758,1025,488,537,39861,62339,16336,36758
8600000US36759,1450,804,646,32569,48538,11758,36759
8600000US36761,681,319,362,27292,54165,19337,36761
8600000US36763,144,85,59,31250,35021,9091,36763
8600000US36765,1011,505,506,19342,27608,6678,36765
8600000US36766,18,9,9,,23069,17519,36766
8600000US36767,1170,486,684,22938,34221,5969,36767
8600000US36768,816,337,479,19255,28657,5879,36768
8600000US36769,2245,1130,1115,32326,44519,6063,36769
8600000US36773,274,120,154,25441,32591,9929,36773
8600000US36775,643,293,350,33465,49728,16141,36775
8600000US36776,1315,571,744,29808,48660,10236,36776
8600000US36782,2001,1114,887,38026,50640,7442,36782
8600000US36783,592,272,320,23514,40680,11392,36783
8600000US36784,5780,2632,3148,38108,55433,6474,36784
8600000US36785,860,308,552,24318,40821,11319,36785
8600000US36786,1830,731,1099,19141,31498,7008,36786
8600000US36790,253,147,106,40227,37881,13157,36790
8600000US36792,946,468,478,69253,74923,23206,36792
8600000US36793,201,48,153,26912,26104,7288,36793
8600000US36801,19255,8534,10721,40146,61399,5273,36801
8600000US36804,14241,6635,7606,48596,61298,5585,36804
8600000US36830,30721,15203,15518,53632,81022,4988,36830
8600000US36832,20636,11380,9256,27638,51593,6326,36832
8600000US36849,4088,1302,2786,,,,36849
8600000US36850,2247,980,1267,33363,42445,4904,36850
8600000US36852,1736,832,904,24847,36606,7451,36852
8600000US36853,6531,3006,3525,53470,64285,4917,36853
8600000US36854,11997,5853,6144,44914,62097,6468,36854
8600000US36855,1226,477,749,44412,54297,8345,36855
8600000US36856,5078,2590,2488,72715,80936,9292,36856
8600000US36858,229,130,99,28889,58490,31182,36858
8600000US36859,18,8,10,,,,36859
8600000US36860,1531,660,871,34872,45550,7297,36860
8600000US36861,2420,1248,1172,46364,64704,8069,36861
8600000US36862,4760,2108,2652,33096,47934,5707,36862
8600000US36863,9246,4397,4849,36884,53029,5149,36863
8600000US36865,28,16,12,,34600,23280,36865
8600000US36866,3012,1331,1681,40164,49836,6251,36866
8600000US36867,17253,8048,9205,43144,55945,2744,36867
8600000US36869,15659,7345,8314,35156,49415,5019,36869
8600000US36870,15743,8127,7616,51257,68758,6596,36870
8600000US36871,1215,561,654,35179,52858,17423,36871
8600000US36874,5908,2930,2978,53393,70511,7017,36874
8600000US36875,2756,1374,1382,54081,61252,9471,36875
8600000US36877,10129,4814,5315,55221,76678,10024,36877
8600000US36879,1527,804,723,81908,94050,16458,36879
8600000US36901,327,201,126,23167,24412,5362,36901
8600000US36904,2914,1248,1666,35632,50684,7673,36904
8600000US36907,1218,459,759,26875,36977,5379,36907
8600000US36908,1647,735,912,53371,64357,11558,36908
8600000US36910,11,11,0,,,,36910
8600000US36912,1894,926,968,31683,47858,7390,36912
8600000US36913,19,9,10,,,,36913
8600000US36915,565,258,307,,61216,41725,36915
8600000US36916,717,379,338,32500,54470,13470,36916
8600000US36919,1367,597,770,29254,43108,7137,36919
8600000US36921,698,312,386,25774,52747,17769,36921
8600000US36922,328,157,171,37823,43874,15344,36922
8600000US36925,2728,1216,1512,28583,39414,5630,36925
8600000US37010,3591,1833,1758,88403,103372,14284,37010
8600000US37012,1906,977,929,39722,52649,7865,37012
8600000US37013,71392,34040,37352,54811,68002,2856,37013
8600000US37014,2059,1007,1052,126926,170501,38228,37014
8600000US37015,13434,6755,6679,51420,60343,3596,37015
8600000US37016,820,439,381,58490,78415,22423,37016
8600000US37018,1532,755,777,39083,57621,9542,37018
8600000US37019,464,282,182,35083,52345,12713,37019
8600000US37020,4473,2267,2206,62301,74440,8983,37020
8600000US37022,4979,2498,2481,57159,61765,5073,37022
8600000US37023,1129,535,594,52396,53366,13489,37023
8600000US37025,4524,2459,2065,50384,65740,11754,37025
8600000US37026,1794,948,846,51250,57507,9339,37026
8600000US37027,40351,19570,20781,132364,187094,7158,37027
8600000US37028,722,417,305,70152,67286,10576,37028
8600000US37029,5373,2763,2610,76688,112429,26165,37029
8600000US37030,5470,2700,2770,44837,56573,6348,37030
8600000US37031,3338,1799,1539,59928,70849,6849,37031
8600000US37032,3725,1857,1868,63281,90660,19641,37032
8600000US37033,5968,2869,3099,38994,53139,4931,37033
8600000US37034,5496,2560,2936,55775,66858,6104,37034
8600000US37035,2620,1290,1330,56528,67600,6673,37035
8600000US37036,4638,2274,2364,41229,54621,7863,37036
8600000US37037,5627,2651,2976,70128,86632,10428,37037
8600000US37040,37737,18949,18788,53201,64259,3042,37040
8600000US37042,54978,26692,28286,50862,59517,2508,37042
8600000US37043,35687,17186,18501,68852,87642,4123,37043
8600000US37046,3752,1861,1891,106082,142664,27265,37046
8600000US37047,1692,811,881,55156,63761,8642,37047
8600000US37048,5041,2474,2567,67553,83586,7518,37048
8600000US37049,2735,1298,1437,68199,79122,9347,37049
8600000US37050,1121,619,502,50352,54323,9256,37050
8600000US37051,2636,1281,1355,49864,55891,7924,37051
8600000US37052,2245,1159,1086,70643,64959,7821,37052
8600000US37055,20551,9578,10973,45675,60858,3717,37055
8600000US37057,655,326,329,17057,31619,9147,37057
8600000US37058,5933,2872,3061,43545,54361,4239,37058
8600000US37059,962,475,487,33804,53299,11340,37059
8600000US37060,1711,862,849,62115,86152,12359,37060
8600000US37061,3723,1840,1883,46000,55987,6358,37061
8600000US37062,9010,4414,4596,66168,87476,9657,37062
8600000US37064,42791,20017,22774,96803,123059,4725,37064
8600000US37066,38474,18654,19820,60065,82692,4029,37066
8600000US37067,22561,10914,11647,106492,136530,10191,37067
8600000US37069,14592,6961,7631,126075,172287,10127,37069
8600000US37072,25089,12044,13045,64093,79042,6786,37072
8600000US37073,10593,5096,5497,58547,75245,5581,37073
8600000US37074,6931,3748,3183,47385,58542,5990,37074
8600000US37075,49323,23418,25905,72670,97456,4377,37075
8600000US37076,30852,14925,15927,62179,74815,2759,37076
8600000US37078,374,212,162,21925,33317,11119,37078
8600000US37079,1817,877,940,39139,51049,11683,37079
8600000US37080,6072,3132,2940,56798,74041,6649,37080
8600000US37082,5031,2448,2583,72260,80644,7902,37082
8600000US37083,11090,5443,5647,37646,54333,6884,37083
8600000US37085,3640,1955,1685,62261,70018,10248,37085
8600000US37086,23421,11648,11773,59409,71822,4346,37086
8600000US37087,35938,17110,18828,56457,75671,3938,37087
8600000US37090,11632,5920,5712,65467,83549,6817,37090
8600000US37091,16889,7967,8922,44325,59414,4698,37091
8600000US37095,1843,1014,829,49952,61311,9934,37095
8600000US37096,4369,2190,2179,36538,69370,23473,37096
8600000US37097,1771,863,908,31645,70333,31671,37097
8600000US37098,4765,2196,2569,47816,79846,38367,37098
8600000US37101,5169,2405,2764,47297,60919,8176,37101
8600000US37110,25405,12430,12975,36613,51201,2813,37110
8600000US37115,31144,14637,16507,43521,54934,2852,37115
8600000US37118,823,458,365,77611,83573,23020,37118
8600000US37122,42370,20614,21756,85276,100399,3229,37122
8600000US37127,13815,6807,7008,68295,81555,4952,37127
8600000US37128,37804,18770,19034,72719,87297,4738,37128
8600000US37129,43719,21063,22656,69238,84621,2942,37129
8600000US37130,44663,21126,23537,46907,69788,4265,37130
8600000US37132,2387,1164,1223,,,,37132
8600000US37134,2371,1262,1109,62813,71827,13194,37134
8600000US37135,8521,4215,4306,120230,134639,8834,37135
8600000US37137,2287,1103,1184,34985,47261,8528,37137
8600000US37138,18565,8802,9763,70492,80734,4618,37138
8600000US37140,1324,1297,27,35156,29204,7851,37140
8600000US37141,929,448,481,80625,82530,12195,37141
8600000US37142,1641,840,801,63269,68957,13685,37142
8600000US37143,3113,1571,1542,67862,79273,7136,37143
8600000US37144,2414,1224,1190,50172,59513,5629,37144
8600000US37145,1626,842,784,47702,107997,97223,37145
8600000US37146,5394,2558,2836,79200,91971,9936,37146
8600000US37148,17759,8432,9327,56778,66702,3678,37148
8600000US37149,2170,1088,1082,63070,68203,10147,37149
8600000US37150,3805,1712,2093,26329,41081,4791,37150
8600000US37151,325,152,173,43000,79804,42105,37151
8600000US37153,4875,2236,2639,84538,100537,11030,37153
8600000US37160,24947,12031,12916,46699,63579,4806,37160
8600000US37165,39,23,16,48125,45726,18995,37165
8600000US37166,11264,5351,5913,43200,64445,9718,37166
8600000US37167,44362,21731,22631,63319,74134,2506,37167
8600000US37171,513,290,223,,90129,44584,37171
8600000US37172,22556,11231,11325,55805,71168,4108,37172
8600000US37174,24271,11798,12473,88479,99959,8649,37174
8600000US37175,747,424,323,40556,78972,43014,37175
8600000US37178,1686,817,869,41271,45690,5118,37178
8600000US37179,10818,5424,5394,95354,115866,10306,37179
8600000US37180,2995,1443,1552,49326,63506,13816,37180
8600000US37181,1364,661,703,55441,62875,11739,37181
8600000US37183,2387,1190,1197,57675,84633,29434,37183
8600000US37184,4831,2400,2431,54959,70919,8551,37184
8600000US37185,6883,3242,3641,37209,49377,5342,37185
8600000US37186,7188,3526,3662,48983,67543,8217,37186
8600000US37187,5696,2718,2978,49417,63340,7934,37187
8600000US37188,11181,5313,5868,73081,78072,5019,37188
8600000US37189,3012,1307,1705,65224,83000,13099,37189
8600000US37190,6797,3173,3624,47710,62338,5684,37190
8600000US37191,2951,1496,1455,65286,75435,15338,37191
8600000US37201,1352,1100,252,76250,104773,28732,37201
8600000US37203,12882,6429,6453,53214,75979,9260,37203
8600000US37204,12139,5550,6589,78739,115983,7567,37204
8600000US37205,20439,9321,11118,103156,165259,10169,37205
8600000US37206,20474,9560,10914,54176,77292,5218,37206
8600000US37207,27999,12124,15875,37951,50993,2635,37207
8600000US37208,13614,6055,7559,34945,60178,8176,37208
8600000US37209,31366,14663,16703,53062,71647,3512,37209
8600000US37210,13524,6729,6795,34824,53145,5421,37210
8600000US37211,59799,30680,29119,53188,70293,2460,37211
8600000US37212,18509,8978,9531,61951,103401,11054,37212
8600000US37213,81,81,0,,,,37213
8600000US37214,24551,11216,13335,56910,68897,3692,37214
8600000US37215,18089,8027,10062,117105,187992,12099,37215
8600000US37216,15758,7848,7910,54807,79446,6523,37216
8600000US37217,24104,11871,12233,48875,61224,3435,37217
8600000US37218,11937,5316,6621,46904,62692,6800,37218
8600000US37219,1134,765,369,97417,101494,19429,37219
8600000US37220,4408,2070,2338,121532,194779,23810,37220
8600000US37221,32206,14789,17417,80564,101509,4387,37221
8600000US37228,1171,488,683,29119,38511,8413,37228
8600000US37240,778,336,442,,,,37240
8600000US37243,0,0,0,,,,37243
8600000US37246,0,0,0,,,,37246
8600000US37301,975,446,529,31500,56218,15818,37301
8600000US37302,3853,1877,1976,61016,91045,13233,37302
8600000US37303,18887,8709,10178,39111,59902,9614,37303
8600000US37305,686,356,330,31250,41492,7544,37305
8600000US37306,1803,918,885,51537,64909,9478,37306
8600000US37307,3853,1958,1895,42295,67596,18495,37307
8600000US37308,2332,1117,1215,55230,78885,10411,37308
8600000US37309,1961,928,1033,48467,58207,10045,37309
8600000US37310,3510,1795,1715,62158,64614,6928,37310
8600000US37311,21987,10461,11526,37519,52628,3748,37311
8600000US37312,26743,12555,14188,54597,83048,9516,37312
8600000US37313,1088,497,591,36786,47474,10100,37313
8600000US37315,1529,664,865,,,,37315
8600000US37317,2179,934,1245,37722,51917,10186,37317
8600000US37318,1243,594,649,33523,42548,5822,37318
8600000US37321,14819,7173,7646,37028,53316,4210,37321
8600000US37322,6630,3309,3321,42004,54019,3972,37322
8600000US37323,24033,11767,12266,49288,62052,3263,37323
8600000US37324,4341,1991,2350,39635,53227,5814,37324
8600000US37325,1217,626,591,43659,58018,6374,37325
8600000US37326,409,160,249,36250,49354,16247,37326
8600000US37327,9049,4343,4706,52839,59509,4055,37327
8600000US37328,1128,556,572,35663,45791,9083,37328
8600000US37329,4719,2334,2385,37567,51431,5734,37329
8600000US37330,5624,2790,2834,53468,59636,4562,37330
8600000US37331,5870,2828,3042,36470,61762,15130,37331
8600000US37332,1911,1050,861,50625,68573,11639,37332
8600000US37333,385,198,187,25208,47863,17182,37333
8600000US37334,17481,8369,9112,44657,59417,4068,37334
8600000US37335,2120,1011,1109,47083,60093,9299,37335
8600000US37336,3453,1622,1831,52150,58755,6124,37336
8600000US37337,1370,646,724,28700,41095,12929,37337
8600000US37338,2906,1558,1348,41536,53382,8299,37338
8600000US37339,1881,982,899,38945,49490,7024,37339
8600000US37340,443,182,261,50788,51700,24357,37340
8600000US37341,9015,4297,4718,61563,82082,8579,37341
8600000US37342,2900,1379,1521,48073,65179,15884,37342
8600000US37343,32863,15627,17236,62852,87171,7276,37343
8600000US37345,1917,905,1012,47708,63052,12193,37345
8600000US37347,6088,2760,3328,49244,61685,6807,37347
8600000US37348,705,468,237,60104,66311,18982,37348
8600000US37350,1458,668,790,135114,206969,21504,37350
8600000US37351,323,142,181,47368,59478,17911,37351
8600000US37352,2405,1175,1230,52077,77973,18481,37352
8600000US37353,4004,2094,1910,50120,76839,13017,37353
8600000US37354,13755,6971,6784,36262,52769,5870,37354
8600000US37355,20289,10045,10244,50496,66094,5601,37355
8600000US37356,2002,931,1071,45096,59847,12544,37356
8600000US37357,4123,2044,2079,47375,63228,7862,37357
8600000US37359,648,297,351,44828,64890,16031,37359
8600000US37360,1192,526,666,49704,80356,24339,37360
8600000US37361,1170,585,585,57019,78248,23893,37361
8600000US37362,2617,1373,1244,41049,59765,11501,37362
8600000US37363,30411,14961,15450,76602,95894,5207,37363
8600000US37365,859,419,440,30329,41409,9077,37365
8600000US37366,667,300,367,56250,69573,15918,37366
8600000US37367,10190,6120,4070,43211,61334,8476,37367
8600000US37369,762,381,381,71313,66930,12111,37369
8600000US37370,4076,1938,2138,46622,55857,6617,37370
8600000US37373,2388,1168,1220,47929,73884,12275,37373
8600000US37374,2036,999,1037,56375,61098,9283,37374
8600000US37375,3583,1594,1989,60000,89236,13723,37375
8600000US37376,313,178,135,39615,40824,11501,37376
8600000US37377,11538,5470,6068,94756,124430,8949,37377
8600000US37379,21889,10550,11339,54741,73804,4633,37379
8600000US37380,4929,2424,2505,42711,59789,7931,37380
8600000US37381,7121,3502,3619,39788,60252,7331,37381
8600000US37385,6436,2897,3539,35862,49931,5027,37385
8600000US37387,2530,1264,1266,38986,52554,9282,37387
8600000US37388,19514,9240,10274,46125,63861,4615,37388
8600000US37391,1144,555,589,31990,44661,7574,37391
8600000US37394,67,20,47,,38969,20101,37394
8600000US37396,198,75,123,,76576,31121,37396
8600000US37397,7505,3864,3641,44533,55662,4850,37397
8600000US37398,11330,5531,5799,49220,74516,10539,37398
8600000US37402,3381,1576,1805,13087,25565,3485,37402
8600000US37403,6983,2905,4078,33690,92149,24840,37403
8600000US37404,10144,5017,5127,31506,55992,7585,37404
8600000US37405,13438,6276,7162,57627,84216,6008,37405
8600000US37406,10905,4743,6162,30405,39408,3307,37406
8600000US37407,6999,3268,3731,26118,33371,4167,37407
8600000US37408,1444,641,803,53681,83128,12661,37408
8600000US37409,2231,1063,1168,50069,63901,8435,37409
8600000US37410,2586,1157,1429,20881,39074,13759,37410
8600000US37411,13182,6399,6783,42313,54992,3845,37411
8600000US37412,16603,8343,8260,44742,56978,5074,37412
8600000US37415,19729,9026,10703,48815,66388,4459,37415
8600000US37416,12639,5705,6934,45284,60419,5384,37416
8600000US37419,5206,2417,2789,59819,89576,11009,37419
8600000US37421,40801,19708,21093,60268,80059,3380,37421
8600000US37601,28293,13008,15285,38584,55374,4592,37601
8600000US37604,29959,14496,15463,39760,65399,4630,37604
8600000US37614,1919,898,1021,,,,37614
8600000US37615,17125,8222,8903,57276,79602,4667,37615
8600000US37616,3774,1872,1902,41438,54205,8920,37616
8600000US37617,11356,5813,5543,54569,77048,8496,37617
8600000US37618,10212,4949,5263,43563,61701,5274,37618
8600000US37620,31211,15131,16080,40019,55966,2441,37620
8600000US37640,2967,1506,1461,39543,59024,9819,37640
8600000US37641,7392,3583,3809,40811,48112,4116,37641
8600000US37642,12328,5864,6464,43151,55792,4141,37642
8600000US37643,26667,12739,13928,35988,48927,2579,37643
8600000US37645,3864,1962,1902,50558,61390,7469,37645
8600000US37650,9627,4616,5011,37650,49010,5040,37650
8600000US37656,3332,1711,1621,37152,54700,9184,37656
8600000US37657,781,390,391,41250,51698,11643,37657
8600000US37658,3524,1687,1837,35574,43635,4468,37658
8600000US37659,22327,11449,10878,54973,71116,4875,37659
8600000US37660,30990,13926,17064,36565,57274,4065,37660
8600000US37663,12044,5730,6314,54433,79696,7039,37663
8600000US37664,21782,10475,11307,48298,68671,4396,37664
8600000US37665,4645,2271,2374,32865,43092,5182,37665
8600000US37680,388,175,213,15208,27204,12330,37680
8600000US37681,4746,2214,2532,48438,54446,5040,37681
8600000US37682,687,286,401,,,,37682
8600000US37683,10953,6189,4764,30648,47793,5720,37683
8600000US37686,6600,3273,3327,50705,71421,7487,37686
8600000US37687,3828,2041,1787,32629,53778,11592,37687
8600000US37688,828,447,381,31848,41917,6992,37688
8600000US37690,3093,1587,1506,50353,58563,7561,37690
8600000US37691,572,264,308,40458,42742,11641,37691
8600000US37692,4033,2076,1957,42172,57054,10733,37692
8600000US37694,1659,827,832,43563,54349,10216,37694
8600000US37701,5775,2608,3167,42857,57273,5626,37701
8600000US37705,3359,1641,1718,48045,68332,12229,37705
8600000US37708,5258,2712,2546,42422,49428,4199,37708
8600000US37709,3265,1567,1698,49604,72476,18377,37709
8600000US37710,869,383,486,30313,41321,8302,37710
8600000US37711,3773,1972,1801,37926,47563,7914,37711
8600000US37713,1231,573,658,34479,40560,9512,37713
8600000US37714,3631,1900,1731,45417,63799,8788,37714
8600000US37715,580,241,339,27440,45478,9626,37715
8600000US37716,21202,10230,10972,49630,64616,3552,37716
8600000US37719,106,19,87,,35616,20534,37719
8600000US37721,10042,4684,5358,55411,67591,4025,37721
8600000US37722,4580,2246,2334,41005,50496,5893,37722
8600000US37723,712,303,409,33333,50148,12320,37723
8600000US37724,2085,991,1094,23503,36431,9325,37724
8600000US37725,14349,6867,7482,56591,73527,5806,37725
8600000US37726,1587,823,764,38713,46625,10267,37726
8600000US37727,1870,908,962,29406,47620,9570,37727
8600000US37729,1361,665,696,34028,41752,11528,37729
8600000US37730,0,0,0,,,,37730
8600000US37731,464,285,179,28347,56862,41977,37731
8600000US37732,158,106,52,,34432,18803,37732
8600000US37733,95,56,39,,62120,26273,37733
8600000US37737,4781,2417,2364,62692,81720,9550,37737
8600000US37738,4556,2292,2264,38008,55572,7000,37738
8600000US37742,4899,2386,2513,61101,72642,7370,37742
8600000US37743,21028,10083,10945,40796,59128,5769,37743
8600000US37745,14297,6794,7503,39697,62847,7513,37745
8600000US37748,13842,6645,7197,39771,59963,5937,37748
8600000US37752,5329,2460,2869,42012,56821,6901,37752
8600000US37753,665,340,325,36105,45422,16924,37753
8600000US37754,4234,2220,2014,48750,60120,7641,37754
8600000US37755,2902,1478,1424,33947,45549,8493,37755
8600000US37756,2406,1065,1341,28539,38597,6725,37756
8600000US37757,7536,3645,3891,48980,58396,4429,37757
8600000US37760,10475,5158,5317,45379,59509,5055,37760
8600000US37762,2288,1054,1234,25456,47344,10880,37762
8600000US37763,12704,6140,6564,59615,77961,7101,37763
8600000US37764,7385,3736,3649,53269,61571,5535,37764
8600000US37765,416,190,226,33667,40916,9977,37765
8600000US37766,14346,6750,7596,34583,53582,8622,37766
8600000US37769,4702,2235,2467,31898,56754,14534,37769
8600000US37770,2048,1067,981,41414,61868,16765,37770
8600000US37771,12720,6050,6670,42717,58926,5565,37771
8600000US37772,10171,4697,5474,67729,99614,10336,37772
8600000US37774,15092,7524,7568,57423,71663,8042,37774
8600000US37777,9531,4571,4960,53404,86172,10330,37777
8600000US37779,2566,1293,1273,38274,64312,21597,37779
8600000US37801,20519,9566,10953,48542,65316,6928,37801
8600000US37803,25894,12502,13392,62860,84975,5894,37803
8600000US37804,20003,9619,10384,53927,66493,3755,37804
8600000US37806,2265,1133,1132,45072,56378,8726,37806
8600000US37807,8062,4014,4048,40585,51637,4195,37807
8600000US37809,1716,785,931,54286,60391,9014,37809
8600000US37810,1155,585,570,44477,53720,8711,37810
8600000US37811,3023,1507,1516,46083,57464,11743,37811
8600000US37813,13047,6116,6931,36122,48890,7814,37813
8600000US37814,26590,13012,13578,43345,56284,3181,37814
8600000US37818,4601,2330,2271,34212,45547,5979,37818
8600000US37819,571,310,261,41548,52095,15313,37819
8600000US37820,6329,2912,3417,45615,58648,5722,37820
8600000US37821,17329,8107,9222,30781,47853,4976,37821
8600000US37825,6690,3240,3450,35220,47417,6019,37825
8600000US37826,4360,2235,2125,47619,58338,6624,37826
8600000US37828,1000,487,513,56667,86264,21700,37828
8600000US37829,1514,733,781,41161,55844,10917,37829
8600000US37830,23125,10995,12130,53695,76638,5992,37830
8600000US37840,8037,3964,4073,45000,60130,7245,37840
8600000US37841,6629,3146,3483,33136,49598,6713,37841
8600000US37843,3062,1516,1546,44455,54309,6802,37843
8600000US37845,429,177,252,29074,28494,9433,37845
8600000US37846,3772,1779,1993,49044,53135,6932,37846
8600000US37847,1876,932,944,42986,48291,7085,37847
8600000US37848,215,129,86,,62061,26816,37848
8600000US37849,20689,10087,10602,63612,71603,3579,37849
8600000US37851,46,25,21,20625,24536,11857,37851
8600000US37852,2113,1085,1028,50926,52529,4811,37852
8600000US37853,3074,1557,1517,43245,58688,8344,37853
8600000US37854,10362,5013,5349,39503,54282,5225,37854
8600000US37857,15605,7539,8066,37683,51338,4304,37857
8600000US37860,3328,1719,1609,49083,61402,11419,37860
8600000US37861,6692,3245,3447,43179,54401,5031,37861
8600000US37862,18428,8910,9518,42186,63651,6320,37862
8600000US37863,5647,2707,2940,41146,47941,6391,37863
8600000US37865,16966,7893,9073,52029,65576,7447,37865
8600000US37866,1346,633,713,56250,73081,13414,37866
8600000US37869,3779,1836,1943,30250,49051,8254,37869
8600000US37870,3822,1843,1979,33259,50802,6260,37870
8600000US37871,7331,3533,3798,51238,70069,12038,37871
8600000US37872,1271,566,705,36071,52130,6980,37872
8600000US37873,3661,1799,1862,38163,54356,9582,37873
8600000US37874,11284,5419,5865,39866,51531,3991,37874
8600000US37876,25940,12471,13469,51223,63404,3906,37876
8600000US37877,6912,3293,3619,47307,67185,11964,37877
8600000US37878,306,175,131,36154,53724,19027,37878
8600000US37879,8734,4362,4372,36708,48940,6531,37879
8600000US37880,2583,1340,1243,49000,67897,10602,37880
8600000US37881,1666,829,837,31250,42720,6609,37881
8600000US37882,2261,1064,1197,45952,60668,7154,37882
8600000US37885,4898,2584,2314,44468,64284,7109,37885
8600000US37886,3887,1872,2015,51911,66825,10412,37886
8600000US37887,6434,4537,1897,44200,55351,4923,37887
8600000US37888,2443,1215,1228,36990,50509,7134,37888
8600000US37890,5469,2732,2737,42535,56350,5939,37890
8600000US37891,2319,1166,1153,37284,55909,16816,37891
8600000US37892,1475,771,704,31886,42040,4858,37892
8600000US37902,2238,1336,902,30525,72279,23054,37902
8600000US37909,12950,6172,6778,42804,62074,4299,37909
8600000US37912,17600,8289,9311,36288,47057,2832,37912
8600000US37914,15762,7221,8541,36456,54874,2934,37914
8600000US37915,4029,1559,2470,16535,23193,3589,37915
8600000US37916,12721,7000,5721,20808,26887,4820,37916
8600000US37917,20001,9417,10584,31629,48352,4687,37917
8600000US37918,34805,16788,18017,52850,68285,3673,37918
8600000US37919,23184,10980,12204,57739,105380,5953,37919
8600000US37920,33873,16201,17672,41761,58894,4006,37920
8600000US37921,20347,9206,11141,45816,54755,3148,37921
8600000US37922,26890,13147,13743,108191,147995,7243,37922
8600000US37923,24208,11778,12430,62747,78798,3676,37923
8600000US37924,9162,4600,4562,46525,58244,3507,37924
8600000US37931,21785,10530,11255,76806,86521,4575,37931
8600000US37932,13482,6406,7076,85599,94599,4691,37932
8600000US37934,19669,9248,10421,99182,124406,7019,37934
8600000US37938,13195,6180,7015,73300,87364,6700,37938
8600000US38001,3559,1613,1946,36475,54347,7245,38001
8600000US38002,28245,13433,14812,95590,110398,5204,38002
8600000US38004,7538,3671,3867,90614,107679,12350,38004
8600000US38006,3725,1713,2012,50417,61226,6246,38006
8600000US38007,36,13,23,,34752,28592,38007
8600000US38008,6719,2909,3810,41159,51323,5751,38008
8600000US38011,7643,3713,3930,62902,75441,4770,38011
8600000US38012,10615,4622,5993,37370,53949,5107,38012
8600000US38015,1786,991,795,42143,56235,6509,38015
8600000US38016,36626,15939,20687,66272,82326,3380,38016
8600000US38017,40602,19615,20987,110983,134130,4921,38017
8600000US38018,27613,12738,14875,70204,87910,4076,38018
8600000US38019,12213,5784,6429,38449,60042,7244,38019
8600000US38021,20,4,16,,,,38021
8600000US38023,4775,2271,2504,66095,75488,8414,38023
8600000US38024,20985,9754,11231,40763,64487,6667,38024
8600000US38028,5719,2928,2791,100721,145021,24767,38028
8600000US38029,0,0,0,,,,38029
8600000US38030,387,176,211,,57768,19789,38030
8600000US38034,2073,990,1083,39926,58944,11639,38034
8600000US38036,388,120,268,14107,21324,5074,38036
8600000US38037,1217,511,706,38409,48518,6968,38037
8600000US38039,1226,571,655,35651,41453,6894,38039
8600000US38040,3601,1777,1824,38568,47685,4161,38040
8600000US38041,4344,3088,1256,35572,44787,4866,38041
8600000US38042,606,307,299,30288,38945,8367,38042
8600000US38044,584,256,328,68015,76455,15658,38044
8600000US38046,52,22,30,74250,100607,35973,38046
8600000US38047,73,38,35,,48549,33629,38047
8600000US38049,3379,1561,1818,47983,59038,6441,38049
8600000US38050,444,204,240,37383,50738,9667,38050
8600000US38052,3118,1579,1539,41618,49242,6346,38052
8600000US38053,21142,9926,11216,54682,70180,3925,38053
8600000US38054,238,178,60,,117666,82684,38054
8600000US38057,3027,1393,1634,45270,61614,7716,38057
8600000US38058,7235,3520,3715,65660,80512,12968,38058
8600000US38059,5583,2677,2906,52145,58534,5878,38059
8600000US38060,7358,3587,3771,70922,81679,6479,38060
8600000US38061,460,241,219,41917,42916,11292,38061
8600000US38063,12164,5550,6614,38667,50741,3196,38063
8600000US38066,2339,1204,1135,72591,102658,23280,38066
8600000US38067,1056,458,598,33333,43030,12046,38067
8600000US38068,8446,4223,4223,40313,59262,5272,38068
8600000US38069,1841,1047,794,40156,52448,6497,38069
8600000US38070,209,129,80,,66159,49976,38070
8600000US38075,5952,4807,1145,43866,54740,6097,38075
8600000US38076,732,372,360,53333,65256,10615,38076
8600000US38077,68,18,50,,28748,18232,38077
8600000US38079,4618,3314,1304,35536,50248,11938,38079
8600000US38080,2120,1073,1047,41458,65769,11586,38080
8600000US38103,13151,7888,5263,70688,96429,6659,38103
8600000US38104,20746,10303,10443,39433,66188,3995,38104
8600000US38105,5053,2212,2841,19987,36980,6484,38105
8600000US38106,18273,8451,9822,24007,31403,2544,38106
8600000US38107,12378,5545,6833,28346,40915,3225,38107
8600000US38108,12575,6150,6425,20747,31278,2829,38108
8600000US38109,34841,16238,18603,30103,42657,2624,38109
8600000US38111,33711,16343,17368,35932,69136,5275,38111
8600000US38112,13648,6427,7221,35644,64882,5463,38112
8600000US38114,20060,9001,11059,25431,38428,3158,38114
8600000US38115,28978,11842,17136,32204,41984,1619,38115
8600000US38116,29478,13684,15794,40353,52128,3992,38116
8600000US38117,20359,9322,11037,74102,116025,10889,38117
8600000US38118,26317,11630,14687,33523,42729,2256,38118
8600000US38119,17684,7687,9997,59505,87915,6843,38119
8600000US38120,11860,5469,6391,94212,153560,15667,38120
8600000US38122,17253,8522,8731,36384,46421,2873,38122
8600000US38125,28832,13582,15250,63687,85689,7660,38125
8600000US38126,4067,1633,2434,14548,26346,7463,38126
8600000US38127,29479,12368,17111,27589,37886,2106,38127
8600000US38128,31146,13837,17309,33353,46515,3278,38128
8600000US38131,0,0,0,,,,38131
8600000US38132,0,0,0,,,,38132
8600000US38133,16307,7696,8611,70632,85812,3765,38133
8600000US38134,34202,17805,16397,46613,58059,2922,38134
8600000US38135,23214,11013,12201,78966,92525,4698,38135
8600000US38138,19142,8872,10270,103446,134965,9006,38138
8600000US38139,11590,5536,6054,144450,201877,16231,38139
8600000US38141,15557,7100,8457,49085,61564,4196,38141
8600000US38152,969,319,650,,,,38152
8600000US38201,8392,3920,4472,38920,49204,3324,38201
8600000US38220,1303,649,654,36071,47327,10749,38220
8600000US38221,2789,1274,1515,35912,49563,7818,38221
8600000US38222,2517,1206,1311,41293,49033,9078,38222
8600000US38224,687,351,336,35000,54134,12721,38224
8600000US38225,4381,2040,2341,33922,54841,16232,38225
8600000US38226,245,124,121,33958,42026,9396,38226
8600000US38229,2245,1066,1179,44559,54493,4556,38229
8600000US38230,2952,1401,1551,37738,46363,5032,38230
8600000US38231,1261,629,632,39410,63072,14428,38231
8600000US38232,1485,708,777,42667,50871,6672,38232
8600000US38233,2019,995,1024,41369,50950,4774,38233
8600000US38235,284,139,145,37692,50225,10358,38235
8600000US38236,505,249,256,45956,64706,21313,38236
8600000US38237,13336,6421,6915,38098,53889,3479,38237
8600000US38240,1877,919,958,36838,44478,5301,38240
8600000US38241,765,400,365,41818,46383,6079,38241
8600000US38242,15840,7455,8385,40802,53875,4424,38242
8600000US38251,2134,1046,1088,37137,51783,6987,38251
8600000US38253,688,369,319,43958,59344,9992,38253
8600000US38254,36,17,19,24792,29289,6931,38254
8600000US38255,1801,906,895,41473,48390,4699,38255
8600000US38256,2371,1223,1148,45724,52882,7167,38256
8600000US38257,3561,1686,1875,41921,68303,10248,38257
8600000US38258,1103,551,552,41848,57318,16183,38258
8600000US38259,530,282,248,40398,52801,11515,38259
8600000US38260,2935,1491,1444,44046,55572,6152,38260
8600000US38261,12286,5659,6627,38778,53292,4492,38261
8600000US38301,25815,12034,13781,30952,45651,2508,38301
8600000US38305,40168,18032,22136,54433,74701,2944,38305
8600000US38310,4661,2344,2317,37418,48864,5099,38310
8600000US38311,733,350,383,53203,61499,15349,38311
8600000US38313,2334,1185,1149,47917,58600,8969,38313
8600000US38315,2888,1310,1578,31627,45681,5282,38315
8600000US38316,2313,1159,1154,48311,65952,12304,38316
8600000US38317,1919,892,1027,32031,46926,8109,38317
8600000US38318,264,149,115,30469,33222,10906,38318
8600000US38320,8321,4024,4297,31594,46449,3302,38320
8600000US38321,1854,919,935,35125,62023,23422,38321
8600000US38326,2188,1078,1110,43176,66728,16131,38326
8600000US38327,314,144,170,31000,38647,8616,38327
8600000US38328,528,330,198,35528,39100,7979,38328
8600000US38329,2745,1353,1392,48689,61241,8604,38329
8600000US38330,3347,1566,1781,36694,53372,7257,38330
8600000US38332,952,492,460,33697,46607,11339,38332
8600000US38333,176,111,65,39188,40852,13713,38333
8600000US38334,1622,720,902,34583,49650,9736,38334
8600000US38337,1054,536,518,42396,50794,7477,38337
8600000US38339,546,257,289,41765,44340,8662,38339
8600000US38340,10184,4861,5323,49012,62401,5103,38340
8600000US38341,1963,979,984,39653,50611,8496,38341
8600000US38342,1112,565,547,36193,44072,6052,38342
8600000US38343,11797,5400,6397,39105,55430,5622,38343
8600000US38344,6231,2919,3312,41013,58936,8341,38344
8600000US38345,1524,841,683,55240,73208,26589,38345
8600000US38347,220,100,120,32321,28717,5804,38347
8600000US38348,829,474,355,45511,57723,14301,38348
8600000US38351,13783,6322,7461,44467,54411,3427,38351
8600000US38352,530,243,287,57372,63183,14308,38352
8600000US38355,4624,2120,2504,78333,81597,9266,38355
8600000US38356,2167,1052,1115,43500,58310,7834,38356
8600000US38357,2216,1089,1127,40341,57521,8471,38357
8600000US38358,8860,4133,4727,44889,59465,5498,38358
8600000US38359,293,160,133,38516,41896,6476,38359
8600000US38361,797,326,471,36397,46220,10127,38361
8600000US38362,955,566,389,55441,66392,17702,38362
8600000US38363,4491,2205,2286,32340,61836,14456,38363
8600000US38365,23,10,13,,,,38365
8600000US38366,1417,678,739,49926,67217,10946,38366
8600000US38367,2323,1169,1154,45250,60198,11173,38367
8600000US38368,1590,626,964,43413,50067,6502,38368
8600000US38369,1343,673,670,38594,53545,6687,38369
8600000US38370,590,281,309,27314,38472,5372,38370
8600000US38371,808,380,428,30000,48488,9245,38371
8600000US38372,13532,6515,7017,39798,54902,3405,38372
8600000US38374,1583,679,904,33274,42160,6673,38374
8600000US38375,6849,3215,3634,31405,47280,6462,38375
8600000US38376,150,64,86,50114,51307,16539,38376
8600000US38379,1020,492,528,38454,48108,6320,38379
8600000US38380,361,210,151,32788,40136,8869,38380
8600000US38381,1199,708,491,31944,42481,7125,38381
8600000US38382,7385,3621,3764,38536,48121,5904,38382
8600000US38387,203,89,114,60417,95504,51940,38387
8600000US38388,1461,790,671,41250,50203,9866,38388
8600000US38390,891,388,503,53906,66521,18734,38390
8600000US38391,870,441,429,50769,49281,8213,38391
8600000US38392,494,286,208,42344,64947,18975,38392
8600000US38401,44561,20799,23762,51930,67207,2540,38401
8600000US38425,3305,2552,753,37132,61522,20498,38425
8600000US38449,2028,993,1035,40259,60436,8774,38449
8600000US38450,2264,1093,1171,35792,46828,6189,38450
8600000US38451,3506,1734,1772,53633,67800,8769,38451
8600000US38452,1038,517,521,40597,49396,11292,38452
8600000US38453,282,148,134,,52708,16906,38453
8600000US38454,853,399,454,65774,64782,15894,38454
8600000US38455,160,82,78,34643,54681,21884,38455
8600000US38456,3218,1482,1736,42289,55021,8250,38456
8600000US38457,631,298,333,47411,49946,6865,38457
8600000US38459,346,191,155,70329,67617,10242,38459
8600000US38460,1078,541,537,48393,55636,9515,38460
8600000US38461,930,492,438,44688,57999,12953,38461
8600000US38462,7780,3674,4106,37384,53809,5717,38462
8600000US38463,1912,995,917,33254,43188,6121,38463
8600000US38464,17429,8432,8997,38485,52073,3798,38464
8600000US38468,3896,1847,2049,43396,55983,8523,38468
8600000US38469,3248,1641,1607,50862,57958,4514,38469
8600000US38471,300,155,145,38529,38584,10669,38471
8600000US38472,2347,1024,1323,51754,66150,10186,38472
8600000US38473,898,462,436,44881,58977,9372,38473
8600000US38474,6811,3126,3685,41288,61755,9328,38474
8600000US38475,520,266,254,48333,57902,13663,38475
8600000US38476,938,512,426,92981,85489,18568,38476
8600000US38477,2258,1105,1153,50875,64595,6613,38477
8600000US38478,13869,6693,7176,47669,58461,4258,38478
8600000US38481,830,451,379,35893,50391,7920,38481
8600000US38482,1260,653,607,61200,74720,13888,38482
8600000US38483,3998,1820,2178,41350,52889,5758,38483
8600000US38485,5070,2461,2609,41514,55078,7472,38485
8600000US38486,613,258,355,31458,43818,8641,38486
8600000US38487,1041,565,476,43472,68347,23832,38487
8600000US38488,2167,1048,1119,65320,79197,13803,38488
8600000US38501,31198,15217,15981,35957,53622,2613,38501
8600000US38504,883,423,460,31103,39849,14577,38504
8600000US38505,2030,1196,834,,,,38505
8600000US38506,22151,10941,11210,50857,67431,5533,38506
8600000US38541,1303,598,705,35353,42803,8032,38541
8600000US38542,17,8,9,,,,38542
8600000US38543,483,200,283,34583,47506,15290,38543
8600000US38544,5327,2468,2859,38256,56372,7216,38544
8600000US38545,1190,558,632,31973,50339,10095,38545
8600000US38547,1540,780,760,57353,75946,10601,38547
8600000US38548,589,256,333,41125,49970,12265,38548
8600000US38549,3060,1420,1640,39093,52028,8784,38549
8600000US38551,3228,1609,1619,31389,41765,5393,38551
8600000US38552,180,106,74,74375,62991,12985,38552
8600000US38553,1929,984,945,38359,43059,6848,38553
8600000US38554,758,455,303,30278,35806,8880,38554
8600000US38555,15377,7312,8065,38060,55856,6163,38555
8600000US38556,9434,4541,4893,35409,46102,3620,38556
8600000US38558,8115,4029,4086,49859,60694,4244,38558
8600000US38559,913,424,489,44500,54643,7663,38559
8600000US38560,979,486,493,46250,54927,9162,38560
8600000US38562,5288,2485,2803,33877,41926,3070,38562
8600000US38563,2526,1178,1348,45074,59452,11471,38563
8600000US38564,329,183,146,19243,32392,8452,38564
8600000US38565,903,514,389,33882,48439,17409,38565
8600000US38567,346,151,195,58036,106940,70154,38567
8600000US38568,1666,891,775,31803,51671,18753,38568
8600000US38569,116,73,43,,54488,65327,38569
8600000US38570,7546,3535,4011,35870,50995,4796,38570
8600000US38571,11067,5689,5378,44038,56120,5582,38571
8600000US38572,9194,4264,4930,45148,55541,5056,38572
8600000US38573,1622,802,820,53333,63352,7824,38573
8600000US38574,6396,3134,3262,36363,49595,5318,38574
8600000US38575,889,469,420,39145,47924,9669,38575
8600000US38577,938,511,427,41557,53380,10543,38577
8600000US38578,152,56,96,40833,47097,11907,38578
8600000US38579,651,293,358,40144,53564,11094,38579
8600000US38580,1089,468,621,46311,55153,11489,38580
8600000US38581,3085,1489,1596,42217,76192,33324,38581
8600000US38582,1050,570,480,54707,92816,37045,38582
8600000US38583,18751,9054,9697,41363,53561,3638,38583
8600000US38585,3111,1505,1606,34245,42837,4168,38585
8600000US38587,1173,586,587,31250,43945,10731,38587
8600000US38588,661,371,290,44000,46662,9116,38588
8600000US38589,162,81,81,,38596,19867,38589
8600000US38601,1740,833,907,43917,57925,8783,38601
8600000US38603,2289,1146,1143,40543,45449,4698,38603
8600000US38606,11982,5556,6426,43534,61728,5093,38606
8600000US38610,2473,1330,1143,39484,50995,8222,38610
8600000US38611,11807,6184,5623,50634,66152,7244,38611
8600000US38614,13358,6068,7290,31733,47663,4283,38614
8600000US38617,459,206,253,20078,32805,8243,38617
8600000US38618,9131,4219,4912,43461,60027,5731,38618
8600000US38619,3979,1816,2163,29976,44452,7267,38619
8600000US38620,2459,1087,1372,38228,43143,6569,38620
8600000US38621,1072,468,604,25094,36390,9158,38621
8600000US38622,513,223,290,30179,35223,8635,38622
8600000US38623,209,137,72,29063,38135,10380,38623
8600000US38625,868,464,404,44531,47976,8860,38625
8600000US38626,822,383,439,38125,40985,9099,38626
8600000US38627,912,383,529,28750,41303,8191,38627
8600000US38629,1592,817,775,51117,62074,11169,38629
8600000US38630,238,90,148,38704,34008,10870,38630
8600000US38631,843,295,548,18381,22496,3958,38631
8600000US38632,20695,10246,10449,73914,94292,8752,38632
8600000US38633,1717,943,774,40625,56654,12147,38633
8600000US38635,13010,6125,6885,38607,51923,5345,38635
8600000US38637,19732,9493,10239,47319,58944,3562,38637
8600000US38639,807,357,450,19250,26926,4813,38639
8600000US38641,1800,917,883,58889,77773,9923,38641
8600000US38642,1908,874,1034,36250,47308,10273,38642
8600000US38643,1618,766,852,18533,31450,5998,38643
8600000US38644,186,96,90,29338,154457,152318,38644
8600000US38645,905,388,517,34495,44968,8160,38645
8600000US38646,2262,1009,1253,32750,42174,5086,38646
8600000US38647,602,295,307,28817,42269,14666,38647
8600000US38650,2845,1477,1368,33908,40627,4572,38650
8600000US38651,5871,2913,2958,78977,96575,14295,38651
8600000US38652,12954,6205,6749,44253,56455,4207,38652
8600000US38654,38159,17777,20382,77225,91753,4243,38654
8600000US38655,34297,16940,17357,45844,70306,4587,38655
8600000US38658,1727,941,786,37073,47697,8167,38658
8600000US38659,2268,1094,1174,42188,63273,14831,38659
8600000US38661,1478,678,800,34531,57118,15062,38661
8600000US38663,9207,4298,4909,40364,55589,6723,38663
8600000US38664,2287,1059,1228,40890,66190,32062,38664
8600000US38665,1646,850,796,42324,49027,10034,38665
8600000US38666,5253,2598,2655,32465,44964,9259,38666
8600000US38668,11364,5547,5817,55077,70969,6731,38668
8600000US38670,627,267,360,36250,37511,5241,38670
8600000US38671,27826,12480,15346,51127,62001,2689,38671
8600000US38672,9450,4614,4836,97480,103482,8139,38672
8600000US38673,590,282,308,79362,85057,18799,38673
8600000US38674,602,259,343,37760,43855,13426,38674
8600000US38676,4211,1901,2310,30932,43641,6453,38676
8600000US38677,4623,1887,2736,,,,38677
8600000US38680,4727,2243,2484,52124,62991,5820,38680
8600000US38683,4215,2104,2111,30341,41894,5346,38683
8600000US38685,1067,564,503,,51580,21421,38685
8600000US38701,16410,7461,8949,30495,48675,3350,38701
8600000US38702,30,14,16,,,,38702
8600000US38703,9564,4120,5444,29195,45902,4506,38703
8600000US38704,0,0,0,,,,38704
8600000US38720,493,239,254,,47651,26630,38720
8600000US38721,737,361,376,30417,58254,16170,38721
8600000US38722,287,121,166,15625,24173,11066,38722
8600000US38723,83,42,41,,,,38723
8600000US38725,567,238,329,26750,43462,9033,38725
8600000US38726,397,132,265,26477,34965,10002,38726
8600000US38730,1536,651,885,42760,54784,11348,38730
8600000US38731,188,57,131,51926,55867,7117,38731
8600000US38732,13414,6278,7136,32331,51241,5064,38732
8600000US38736,330,161,169,41500,56931,19920,38736
8600000US38737,1988,860,1128,27083,37032,5304,38737
8600000US38738,3608,3551,57,,59162,30481,38738
8600000US38740,326,163,163,31042,49851,26333,38740
8600000US38744,672,358,314,36463,63537,30715,38744
8600000US38745,84,52,32,,42970,20382,38745
8600000US38746,350,145,205,19375,29015,9858,38746
8600000US38748,2728,1323,1405,35797,52028,8327,38748
8600000US38749,19,9,10,,,,38749
8600000US38751,7953,3414,4539,30366,47029,4008,38751
8600000US38753,1004,446,558,43000,55850,8418,38753
8600000US38754,1008,461,547,26705,52923,11351,38754
8600000US38756,4422,2117,2305,33361,61696,14785,38756
8600000US38759,630,310,320,56563,66396,10987,38759
8600000US38760,640,281,359,19509,30537,6417,38760
8600000US38761,1741,767,974,24904,46038,11042,38761
8600000US38762,1781,679,1102,21661,27155,2946,38762
8600000US38764,236,144,92,,38435,11938,38764
8600000US38765,66,46,20,,,,38765
8600000US38767,26,13,13,,,,38767
8600000US38768,47,11,36,18664,28966,28434,38768
8600000US38769,1392,630,762,18071,27974,4426,38769
8600000US38771,2329,1085,1244,36200,53965,11291,38771
8600000US38772,45,4,41,,31237,24966,38772
8600000US38773,2355,1171,1184,27611,37999,4609,38773
8600000US38774,1513,682,831,30387,40534,8084,38774
8600000US38778,1044,423,621,28555,40958,10314,38778
8600000US38781,205,98,107,,30576,11497,38781
8600000US38801,22229,9797,12432,46645,63121,4361,38801
8600000US38804,12844,6014,6830,43096,65540,5937,38804
8600000US38821,9890,4573,5317,48132,59605,5278,38821
8600000US38824,6026,2827,3199,38209,52171,5305,38824
8600000US38826,3770,1832,1938,61307,76653,9994,38826
8600000US38827,2647,1226,1421,40017,54882,11133,38827
8600000US38828,3108,1436,1672,42638,56491,15524,38828
8600000US38829,14623,6907,7716,35983,49644,5091,38829
8600000US38833,1860,945,915,30181,41383,8167,38833
8600000US38834,21598,10128,11470,39347,52099,2967,38834
8600000US38838,769,412,357,21114,30947,7872,38838
8600000US38841,1916,895,1021,36250,52451,10591,38841
8600000US38843,9312,4400,4912,36981,55867,5149,38843
8600000US38844,188,95,93,36000,59072,43826,38844
8600000US38846,1894,937,957,46250,52620,6303,38846
8600000US38847,2602,1381,1221,42514,46035,6288,38847
8600000US38848,459,205,254,56250,48985,12555,38848
8600000US38849,4661,2277,2384,54375,62988,5037,38849
8600000US38850,2170,1069,1101,39817,50305,6419,38850
8600000US38851,5809,3091,2718,38839,49241,4806,38851
8600000US38852,7462,3575,3887,43041,53712,6007,38852
8600000US38855,3521,1709,1812,46522,55071,5507,38855
8600000US38856,1200,587,613,51767,55700,6951,38856
8600000US38857,2772,1301,1471,52891,61321,6894,38857
8600000US38858,5217,2656,2561,42230,54270,5703,38858
8600000US38859,743,381,362,52093,52090,11011,38859
8600000US38860,4810,2067,2743,34167,49183,7219,38860
8600000US38862,1842,928,914,42500,57692,12412,38862
8600000US38863,15346,7397,7949,40606,53620,4467,38863
8600000US38864,1516,762,754,51042,51526,7391,38864
8600000US38865,3813,1970,1843,44079,67000,17676,38865
8600000US38866,8777,4389,4388,62934,80477,11098,38866
8600000US38868,4055,1976,2079,36187,48870,5105,38868
8600000US38869,387,151,236,24583,46842,20528,38869
8600000US38870,2131,1052,1079,43480,53269,8188,38870
8600000US38871,1448,694,754,58125,79479,16120,38871
8600000US38873,2350,1011,1339,35528,40019,5348,38873
8600000US38876,1173,613,560,30481,46657,8587,38876
8600000US38878,2077,1091,986,38144,49684,6372,38878
8600000US38879,548,361,187,22180,33798,8259,38879
8600000US38901,14222,6633,7589,36198,54880,4845,38901
8600000US38913,273,131,142,45625,39713,8194,38913
8600000US38914,641,265,376,48438,53113,16410,38914
8600000US38915,3011,1429,1582,40625,47898,5417,38915
8600000US38916,3733,1660,2073,33125,42275,3437,38916
8600000US38917,2729,1483,1246,42665,57119,13033,38917
8600000US38920,474,274,200,34931,41678,13848,38920
8600000US38921,2964,1144,1820,31505,42995,6400,38921
8600000US38922,2296,1143,1153,37054,47703,6603,38922
8600000US38923,1107,591,516,58125,57934,13086,38923
8600000US38924,464,209,255,20571,36948,13175,38924
8600000US38925,2042,1005,1037,33646,41593,5096,38925
8600000US38927,994,543,451,35972,48585,14638,38927
8600000US38928,116,37,79,10494,9854,4683,38928
8600000US38929,1101,529,572,37672,39382,9158,38929
8600000US38930,16896,7601,9295,26643,46093,5519,38930
8600000US38940,1266,614,652,46875,75223,32301,38940
8600000US38941,3466,1540,1926,21442,34146,6299,38941
8600000US38943,61,19,42,,,,38943
8600000US38944,320,188,132,55978,55413,11418,38944
8600000US38945,36,9,27,,,,38945
8600000US38946,171,49,122,,26778,10236,38946
8600000US38947,283,110,173,,88238,47107,38947
8600000US38948,1795,845,950,37344,45159,8071,38948
8600000US38949,230,110,120,53750,66774,17304,38949
8600000US38950,330,136,194,17857,40803,22485,38950
8600000US38951,975,425,550,36682,47782,8629,38951
8600000US38952,344,164,180,38750,77241,31235,38952
8600000US38953,330,142,188,47426,68695,19913,38953
8600000US38954,909,351,558,30938,37301,8339,38954
8600000US38957,480,230,250,43333,50817,15283,38957
8600000US38958,0,0,0,,,,38958
8600000US38961,875,338,537,39511,48150,13922,38961
8600000US38962,87,42,45,,,,38962
8600000US38963,4311,3582,729,42659,66155,26287,38963
8600000US38964,99,33,66,65938,61215,14427,38964
8600000US38965,6561,3138,3423,43899,52950,4639,38965
8600000US38966,649,143,506,27250,31232,7158,38966
8600000US38967,5589,2611,2978,42734,59793,10098,38967
8600000US39038,4234,1817,2417,28956,39821,5199,39038
8600000US39039,1530,703,827,41750,50549,8251,39039
8600000US39040,2271,990,1281,32813,51000,8513,39040
8600000US39041,2888,1277,1611,46500,51869,7056,39041
8600000US39042,29329,13845,15484,68590,84153,5039,39042
8600000US39044,2938,1515,1423,41675,65485,16581,39044
8600000US39045,1186,587,599,33750,53117,12068,39045
8600000US39046,20361,9412,10949,46689,62364,5543,39046
8600000US39047,29709,13995,15714,85246,100080,3629,39047
8600000US39051,12194,5777,6417,35821,49201,4249,39051
8600000US39054,212,107,105,,26545,8022,39054
8600000US39056,19327,8615,10712,63597,76897,3616,39056
8600000US39057,1628,740,888,26206,41154,12375,39057
8600000US39059,8943,4072,4871,40826,52469,4715,39059
8600000US39061,0,0,0,,,,39061
8600000US39062,423,145,278,45625,56451,12330,39062
8600000US39063,2674,1162,1512,21997,32812,5772,39063
8600000US39066,3375,1677,1698,34279,53153,8006,39066
8600000US39067,1179,601,578,50139,57067,9797,39067
8600000US39069,4305,2118,2187,19520,30908,5094,39069
8600000US39071,4583,2176,2407,66027,85755,9391,39071
8600000US39073,14980,6720,8260,58669,68302,5347,39073
8600000US39074,11103,5310,5793,28978,47171,4329,39074
8600000US39078,709,320,389,44375,46456,8708,39078
8600000US39079,1450,712,738,22171,34945,5736,39079
8600000US39082,782,326,456,44167,54872,11853,39082
8600000US39083,7816,3798,4018,35882,47491,6303,39083
8600000US39086,980,398,582,19688,23395,3871,39086
8600000US39088,73,28,45,,101452,53559,39088
8600000US39090,9401,4322,5079,33488,56244,6688,39090
8600000US39092,1993,895,1098,28750,50525,12461,39092
8600000US39094,2947,1340,1607,31636,50191,9178,39094
8600000US39095,5248,2528,2720,21758,41076,7991,39095
8600000US39096,1532,683,849,18224,39133,16246,39096
8600000US39097,521,335,186,20625,38835,15289,39097
8600000US39108,1296,601,695,36683,46993,7517,39108
8600000US39110,31120,14923,16197,106437,138487,7390,39110
8600000US39111,7018,3566,3452,34628,54404,8015,39111
8600000US39113,577,427,150,16591,21445,4308,39113
8600000US39114,7167,3205,3962,38470,53151,6019,39114
8600000US39115,41,20,21,,,,39115
8600000US39116,1594,780,814,48189,66591,15658,39116
8600000US39117,7858,3833,4025,39876,72493,14849,39117
8600000US39119,4005,1920,2085,37551,56792,16866,39119
8600000US39120,24744,12649,12095,29206,46755,2850,39120
8600000US39140,1904,773,1131,33317,48857,9214,39140
8600000US39144,591,237,354,23438,46956,21903,39144
8600000US39145,3427,1738,1689,58047,76457,16536,39145
8600000US39146,1685,801,884,34563,43024,5174,39146
8600000US39149,1658,828,830,47831,54878,13924,39149
8600000US39150,4462,2221,2241,29643,36578,4269,39150
8600000US39152,984,500,484,41087,56023,18366,39152
8600000US39153,2905,1308,1597,33895,48221,7358,39153
8600000US39154,8700,4148,4552,64896,82323,10962,39154
8600000US39156,338,181,157,,70170,32888,39156
8600000US39157,18893,8629,10264,57570,90306,5616,39157
8600000US39159,2580,1092,1488,30366,42223,5241,39159
8600000US39160,2049,987,1062,28564,36797,6602,39160
8600000US39162,58,13,45,23750,22803,7342,39162
8600000US39166,374,184,190,19919,39338,14535,39166
8600000US39167,0,0,0,,,,39167
8600000US39168,4928,2212,2716,33164,48854,5041,39168
8600000US39169,1883,817,1066,15513,26516,4123,39169
8600000US39170,8243,3752,4491,61402,74479,7141,39170
8600000US39174,777,254,523,55150,45933,16601,39174
8600000US39175,3650,1563,2087,31280,47839,6263,39175
8600000US39176,1870,929,941,32150,48544,10908,39176
8600000US39177,102,46,56,,34984,11820,39177
8600000US39179,1091,459,632,38750,61431,18615,39179
8600000US39180,24693,11680,13013,42339,58271,3473,39180
8600000US39183,10535,4792,5743,43963,57620,4297,39183
8600000US39189,2728,1475,1253,33575,46189,9880,39189
8600000US39191,6376,3106,3270,50421,60149,6955,39191
8600000US39192,933,453,480,26806,39659,7502,39192
8600000US39193,850,457,393,,,,39193
8600000US39194,16261,9708,6553,27747,51742,8849,39194
8600000US39201,501,316,185,,61936,21177,39201
8600000US39202,6993,3529,3464,36737,63259,6418,39202
8600000US39203,5434,2645,2789,23884,34812,6968,39203
8600000US39204,11743,5270,6473,30186,39909,3524,39204
8600000US39206,18664,7646,11018,37710,51924,4767,39206
8600000US39208,24602,12282,12320,49015,58447,2700,39208
8600000US39209,20006,8962,11044,28409,40370,3398,39209
8600000US39211,19046,8391,10655,65508,91904,5189,39211
8600000US39212,23814,11146,12668,44996,55909,2688,39212
8600000US39213,15859,7345,8514,26719,38481,2542,39213
8600000US39216,3426,1593,1833,42581,85469,14714,39216
8600000US39217,1291,468,823,,,,39217
8600000US39218,5108,2409,2699,50519,57584,5207,39218
8600000US39232,6460,2851,3609,62005,83168,10391,39232
8600000US39269,0,0,0,,,,39269
8600000US39272,9443,4483,4960,63223,70007,6302,39272
8600000US39301,20018,9597,10421,36798,52524,4408,39301
8600000US39305,15516,7237,8279,56286,74858,6083,39305
8600000US39307,13413,6980,6433,29966,41475,3297,39307
8600000US39309,371,307,64,,,,39309
8600000US39320,996,492,504,76319,89261,26370,39320
8600000US39322,1025,456,569,,52406,15689,39322
8600000US39323,1187,609,578,31308,45838,13354,39323
8600000US39325,5131,2172,2959,50814,74744,14337,39325
8600000US39326,342,50,292,49875,49648,17625,39326
8600000US39327,3373,1570,1803,52171,65952,10883,39327
8600000US39328,4112,2288,1824,27265,38832,6895,39328
8600000US39330,2085,1005,1080,69793,76477,7417,39330
8600000US39332,1007,489,518,52250,68145,14661,39332
8600000US39335,2150,875,1275,41396,77037,26222,39335
8600000US39336,1000,539,461,35424,38438,5485,39336
8600000US39337,1527,756,771,43375,56723,10692,39337
8600000US39338,2804,1275,1529,32955,53598,12796,39338
8600000US39339,11126,5443,5683,35745,55209,5483,39339
8600000US39341,5063,2501,2562,35533,43383,5053,39341
8600000US39342,934,393,541,31875,41243,8252,39342
8600000US39345,4521,2077,2444,30164,57540,23406,39345
8600000US39346,1841,877,964,42554,67610,20877,39346
8600000US39347,1310,589,721,32361,45172,9216,39347
8600000US39348,428,179,249,,23854,10801,39348
8600000US39350,18066,8283,9783,37128,52973,3198,39350
8600000US39352,334,148,186,35395,55796,23204,39352
8600000US39354,2209,946,1263,31709,65790,37360,39354
8600000US39355,5258,2517,2741,37850,52303,6299,39355
8600000US39356,481,241,240,40625,53915,21011,39356
8600000US39358,1539,642,897,24931,39566,9579,39358
8600000US39359,287,145,142,54583,71950,16298,39359
8600000US39360,2466,1062,1404,31392,56233,15119,39360
8600000US39361,1042,468,574,34310,43411,8918,39361
8600000US39362,2648,1309,1339,35345,49365,8098,39362
8600000US39363,1085,540,545,32500,47867,9825,39363
8600000US39364,2163,1080,1083,36597,40090,11065,39364
8600000US39365,5437,2626,2811,33808,50064,6464,39365
8600000US39366,890,319,571,28220,52053,21758,39366
8600000US39367,11242,5375,5867,38625,58538,6015,39367
8600000US39401,33087,15667,17420,33118,48139,3320,39401
8600000US39402,31775,14622,17153,61058,83848,5980,39402
8600000US39406,1950,311,1639,,,,39406
8600000US39421,1981,1071,910,32318,43501,8426,39421
8600000US39422,3726,1657,2069,39236,54315,8250,39422
8600000US39423,2061,1048,1013,40030,52295,9278,39423
8600000US39425,1785,886,899,32237,51575,19195,39425
8600000US39426,13989,6960,7029,61041,69823,6741,39426
8600000US39427,1021,523,498,38750,64534,24522,39427
8600000US39428,7713,3698,4015,35118,48805,5705,39428
8600000US39429,12780,6155,6625,32402,47666,3497,39429
8600000US39437,10404,4761,5643,45173,62810,6445,39437
8600000US39439,3283,1624,1659,29786,46069,6793,39439
8600000US39440,15193,7422,7771,32757,51252,6136,39440
8600000US39443,16306,7482,8824,44659,64885,6082,39443
8600000US39451,5620,4330,1290,42500,54249,8574,39451
8600000US39452,20169,10339,9830,48174,61469,4805,39452
8600000US39455,6795,3341,3454,31797,49569,5572,39455
8600000US39456,736,375,361,48500,47146,14823,39456
8600000US39459,2755,1453,1302,47778,55504,6921,39459
8600000US39461,557,243,314,41750,51446,15400,39461
8600000US39462,971,487,484,40268,54414,10653,39462
8600000US39464,2130,1126,1004,47917,63131,13897,39464
8600000US39465,15246,7381,7865,58220,69403,5387,39465
8600000US39466,19838,9562,10276,42067,54164,3352,39466
8600000US39470,9710,4640,5070,41960,57444,5031,39470
8600000US39474,4455,1890,2565,24700,36041,5203,39474
8600000US39475,9814,4468,5346,55051,64585,5412,39475
8600000US39476,5815,2626,3189,48155,57463,6406,39476
8600000US39477,505,238,267,34375,53822,18130,39477
8600000US39478,1617,752,865,32048,45556,9774,39478
8600000US39479,4333,2193,2140,40993,51531,6634,39479
8600000US39480,2246,1155,1091,58936,71805,16508,39480
8600000US39481,1052,521,531,45654,60363,15231,39481
8600000US39482,8011,4128,3883,55742,67048,5498,39482
8600000US39483,4722,2240,2482,29507,50150,7371,39483
8600000US39501,17640,8505,9135,26971,37180,2854,39501
8600000US39503,39600,18733,20867,49895,65357,3711,39503
8600000US39507,12708,6031,6677,42348,59731,4721,39507
8600000US39520,13766,6354,7412,38755,53372,4671,39520
8600000US39525,6646,3225,3421,71411,87084,8949,39525
8600000US39530,5962,2998,2964,33653,45539,3615,39530
8600000US39531,13368,6877,6491,41687,58288,4950,39531
8600000US39532,28035,13348,14687,58008,68411,3182,39532
8600000US39534,2651,1973,678,,,,39534
8600000US39540,6777,3013,3764,41121,57082,16758,39540
8600000US39553,12755,6416,6339,46548,60180,4935,39553
8600000US39556,6722,3370,3352,50130,67300,16414,39556
8600000US39560,13474,6367,7107,49720,64112,4828,39560
8600000US39561,1832,947,885,55781,59924,11133,39561
8600000US39562,13564,6854,6710,48973,63830,7475,39562
8600000US39563,11218,5358,5860,38210,56236,6190,39563
8600000US39564,29939,13623,16316,59834,74109,4039,39564
8600000US39565,14640,7582,7058,63537,70805,3927,39565
8600000US39567,8611,4221,4390,42770,68717,8286,39567
8600000US39571,10799,5235,5564,50275,69040,5646,39571
8600000US39572,1106,528,578,43804,61342,13654,39572
8600000US39573,6428,3473,2955,53014,67528,13239,39573
8600000US39574,10671,5464,5207,53609,60568,5117,39574
8600000US39576,4341,2181,2160,47583,57929,8259,39576
8600000US39577,8247,3922,4325,38902,51034,4897,39577
8600000US39581,7957,3686,4271,38366,48014,3585,39581
8600000US39601,16727,7470,9257,39955,57894,4344,39601
8600000US39629,5565,2804,2761,45737,59955,10197,39629
8600000US39630,572,225,347,26331,40391,8102,39630
8600000US39631,2359,1026,1333,22069,37608,7836,39631
8600000US39633,880,404,476,22361,31484,6396,39633
8600000US39635,294,166,128,,26428,10826,39635
8600000US39638,2419,1077,1342,28458,47623,9572,39638
8600000US39641,2695,1245,1450,41303,52458,7110,39641
8600000US39643,882,385,497,29779,33471,8652,39643
8600000US39645,4026,2123,1903,34787,45216,6593,39645
8600000US39647,765,341,424,76957,92794,25528,39647
8600000US39648,14897,6627,8270,30374,43342,4453,39648
8600000US39652,6464,3038,3426,33256,42514,5065,39652
8600000US39653,1990,1066,924,49444,58186,8848,39653
8600000US39654,3871,1694,2177,34452,51240,5535,39654
8600000US39656,535,320,215,27083,50324,21453,39656
8600000US39657,1365,607,758,25188,40303,12295,39657
8600000US39661,2292,1115,1177,35137,47880,8827,39661
8600000US39662,1171,635,536,41154,51816,16129,39662
8600000US39663,2217,1073,1144,47973,49339,6024,39663
8600000US39664,1710,843,867,37179,52362,10179,39664
8600000US39665,1251,703,548,40250,48242,7557,39665
8600000US39666,7776,3761,4015,38684,59233,7715,39666
8600000US39667,9501,4631,4870,27147,47475,9058,39667
8600000US39668,636,261,375,38750,46233,16007,39668
8600000US39669,4346,2550,1796,26082,35978,4303,39669
8600000US39701,10648,5037,5611,29815,50616,5920,39701
8600000US39702,17123,7599,9524,43702,57858,4448,39702
8600000US39705,9997,4722,5275,57366,68546,5998,39705
8600000US39730,8733,4015,4718,37045,54424,5957,39730
8600000US39735,2873,1332,1541,36027,50485,6118,39735
8600000US39736,202,76,126,21964,32087,6852,39736
8600000US39737,159,50,109,45000,52291,26428,39737
8600000US39739,1821,745,1076,33824,47170,10783,39739
8600000US39740,3962,1956,2006,70585,76445,8273,39740
8600000US39741,1233,631,602,40938,53618,10725,39741
8600000US39743,1023,404,619,37262,53319,17293,39743
8600000US39744,4369,2067,2302,34847,47531,4761,39744
8600000US39745,593,272,321,39107,55372,8613,39745
8600000US39746,2613,1233,1380,57708,71285,13869,39746
8600000US39747,1313,650,663,32536,45203,8320,39747
8600000US39750,1627,800,827,40750,50437,9272,39750
8600000US39751,1101,559,542,41103,54433,16908,39751
8600000US39752,2212,1038,1174,40833,55597,9397,39752
8600000US39755,606,243,363,55875,62053,11016,39755
8600000US39756,1474,675,799,28793,35509,6651,39756
8600000US39759,35955,18753,17202,38872,59253,3031,39759
8600000US39760,11,0,11,,,,39760
8600000US39762,2971,876,2095,,,,39762
8600000US39766,2666,1450,1216,74236,73719,9659,39766
8600000US39767,538,267,271,41298,44487,10838,39767
8600000US39769,1309,645,664,47024,48595,8734,39769
8600000US39771,74,32,42,,66084,17723,39771
8600000US39772,1282,644,638,34063,44076,6483,39772
8600000US39773,11922,5317,6605,35551,53776,5831,39773
8600000US39776,1300,548,752,35045,49369,10762,39776
8600000US39813,1649,680,969,27277,43759,10477,39813
8600000US39815,1397,650,747,35417,43982,6343,39815
8600000US39817,7543,3742,3801,31627,45084,5760,39817
8600000US39819,8251,3872,4379,44890,62127,6420,39819
8600000US39823,5783,2656,3127,32123,44845,3517,39823
8600000US39824,418,244,174,,47440,14676,39824
8600000US39825,930,425,505,45208,60897,16794,39825
8600000US39826,306,131,175,28500,38417,7823,39826
8600000US39827,2953,1366,1587,47635,68400,16026,39827
8600000US39828,11004,5286,5718,39090,56265,4912,39828
8600000US39834,1896,807,1089,38015,44402,8045,39834
8600000US39836,259,118,141,,63162,27107,39836
8600000US39837,4746,2287,2459,40716,50444,4727,39837
8600000US39840,3712,1844,1868,30300,48165,19645,39840
8600000US39841,574,284,290,29875,43520,11776,39841
8600000US39842,6103,2861,3242,38824,51430,4206,39842
8600000US39845,6072,2864,3208,35111,62738,16256,39845
8600000US39846,1290,541,749,26397,36944,6086,39846
8600000US39851,1689,853,836,25325,34856,5009,39851
8600000US39854,1923,937,986,33352,45212,6391,39854
8600000US39859,818,329,489,34886,47744,10973,39859
8600000US39861,871,372,499,28438,32519,5876,39861
8600000US39862,1108,510,598,45885,54103,9488,39862
8600000US39866,2169,1946,223,36382,55313,22341,39866
8600000US39867,405,241,164,,31815,9409,39867
8600000US39870,1544,679,865,31528,47052,8828,39870
8600000US39877,298,118,180,30417,38925,8287,39877
8600000US39885,64,26,38,57500,58010,15894,39885
8600000US39886,1366,578,788,32083,48908,8510,39886
8600000US39897,2970,1331,1639,46469,63300,11516,39897
8600000US40003,1563,810,753,66250,71177,10323,40003
8600000US40004,22561,10940,11621,58496,80373,13378,40004
8600000US40006,3816,1794,2022,50055,57617,7383,40006
8600000US40007,85,45,40,,65766,25803,40007
8600000US40008,2774,1426,1348,51184,64868,8282,40008
8600000US40009,744,417,327,41625,54635,15522,40009
8600000US40010,336,167,169,108636,98074,25183,40010
8600000US40011,1943,901,1042,55510,67582,8639,40011
8600000US40012,366,155,211,50820,52036,13337,40012
8600000US40013,3913,1897,2016,64127,103170,57304,40013
8600000US40014,15655,7836,7819,106860,125849,7888,40014
8600000US40019,2989,1468,1521,40250,61549,13029,40019
8600000US40020,107,52,55,36417,54830,23616,40020
8600000US40022,835,351,484,90000,104745,18895,40022
8600000US40023,3885,1974,1911,109688,127690,11556,40023
8600000US40025,38,16,22,,475730,140539,40025
8600000US40026,4523,2294,2229,116165,158611,14028,40026
8600000US40031,19589,11306,8283,73775,86117,4699,40031
8600000US40033,9535,4545,4990,37058,54218,4303,40033
8600000US40036,154,71,83,61563,65673,21894,40036
8600000US40037,2110,982,1128,41019,50251,4908,40037
8600000US40040,229,93,136,34500,47675,12738,40040
8600000US40041,385,84,301,21458,51919,23446,40041
8600000US40045,2613,1350,1263,45417,67344,12114,40045
8600000US40046,1189,647,542,72031,75158,12632,40046
8600000US40047,14944,7458,7486,68076,76818,3157,40047
8600000US40048,129,0,129,,,,40048
8600000US40049,112,39,73,,,,40049
8600000US40050,1350,558,792,36313,49377,8781,40050
8600000US40051,3317,1736,1581,45224,59002,6086,40051
8600000US40052,451,239,212,44125,57849,18864,40052
8600000US40055,1446,602,844,72722,79628,14716,40055
8600000US40056,2591,1212,1379,78611,117391,23411,40056
8600000US40057,2800,1487,1313,48438,57686,5277,40057
8600000US40058,76,37,39,27361,42258,17798,40058
8600000US40059,14437,6967,7470,142354,198700,17797,40059
8600000US40060,847,438,409,44583,57185,8678,40060
8600000US40062,200,92,108,36250,45062,15476,40062
8600000US40063,291,291,0,,,,40063
8600000US40065,23074,10933,12141,60227,75848,5498,40065
8600000US40067,4684,2283,2401,87417,124003,15451,40067
8600000US40068,1691,866,825,59427,77835,17764,40068
8600000US40069,6452,3004,3448,52750,63092,4529,40069
8600000US40070,441,217,224,78534,90796,23910,40070
8600000US40071,11888,5913,5975,74255,90030,6169,40071
8600000US40075,778,422,356,56477,59456,9927,40075
8600000US40076,1994,1008,986,56838,72189,10889,40076
8600000US40077,344,192,152,51500,75218,22145,40077
8600000US40078,1799,949,850,47083,63761,11463,40078
8600000US40104,785,448,337,53750,68303,14085,40104
8600000US40107,1891,904,987,64137,75680,13949,40107
8600000US40108,9172,4522,4650,61537,75235,7432,40108
8600000US40109,1657,960,697,56856,71421,11904,40109
8600000US40110,22,0,22,,,,40110
8600000US40111,1045,492,553,35625,44978,5390,40111
8600000US40115,395,193,202,51250,60356,12309,40115
8600000US40117,2020,1043,977,51908,69064,12418,40117
8600000US40118,7542,3369,4173,52848,57404,4158,40118
8600000US40119,1532,751,781,62188,72685,11409,40119
8600000US40121,6292,3722,2570,60367,71271,4460,40121
8600000US40140,449,227,222,31964,39328,8198,40140
8600000US40142,1815,920,895,63659,80477,15554,40142
8600000US40143,4555,2265,2290,45196,59769,5557,40143
8600000US40144,1229,590,639,62008,65550,9621,40144
8600000US40145,497,297,200,105938,107699,27969,40145
8600000US40146,3220,1611,1609,45530,51624,5415,40146
8600000US40150,3465,1785,1680,59792,66431,6338,40150
8600000US40152,845,440,405,43393,62745,16894,40152
8600000US40155,838,401,437,35978,42520,6992,40155
8600000US40157,630,317,313,64375,70806,13034,40157
8600000US40160,17375,8022,9353,45944,58588,7048,40160
8600000US40161,153,71,82,56250,56763,18195,40161
8600000US40162,5123,2587,2536,77620,83662,12155,40162
8600000US40165,28359,13998,14361,59855,72380,3247,40165
8600000US40170,395,214,181,60709,56977,14726,40170
8600000US40171,115,13,102,13466,21114,12723,40171
8600000US40175,10493,5363,5130,59107,77665,8049,40175
8600000US40176,690,377,313,52792,56230,11977,40176
8600000US40177,1114,581,533,41860,53539,10801,40177
8600000US40178,427,180,247,66786,92686,31157,40178
8600000US40202,6529,3897,2632,17940,47989,14507,40202
8600000US40203,13526,6323,7203,16862,28926,2542,40203
8600000US40204,12281,6166,6115,52179,77537,5179,40204
8600000US40205,20372,9521,10851,76802,104883,5027,40205
8600000US40206,16916,8003,8913,55156,76916,3401,40206
8600000US40207,24473,11757,12716,78750,119278,4558,40207
8600000US40208,15006,7378,7628,28026,40473,3238,40208
8600000US40209,177,72,105,32500,36938,11994,40209
8600000US40210,9654,4065,5589,23330,34004,2952,40210
8600000US40211,16142,6304,9838,27565,38677,3207,40211
8600000US40212,12498,5783,6715,24957,34476,1579,40212
8600000US40213,12992,6208,6784,42437,61834,3949,40213
8600000US40214,34622,16896,17726,41449,56693,2935,40214
8600000US40215,15086,6922,8164,32306,41203,2096,40215
8600000US40216,32542,15135,17407,43358,53395,2058,40216
8600000US40217,10830,5197,5633,50498,61517,3755,40217
8600000US40218,25914,12632,13282,44587,58043,3085,40218
8600000US40219,30560,15056,15504,46931,57608,2741,40219
8600000US40220,26585,12137,14448,62366,77555,3517,40220
8600000US40222,17851,8354,9497,73220,109916,5790,40222
8600000US40223,17763,8446,9317,78076,109179,4714,40223
8600000US40228,13157,6441,6716,66687,79558,6682,40228
8600000US40229,29360,14358,15002,58685,65900,2563,40229
8600000US40231,0,0,0,,,,40231
8600000US40241,23765,11550,12215,78331,107448,3966,40241
8600000US40242,8715,4087,4628,68004,83575,3976,40242
8600000US40243,8217,3695,4522,73448,86998,7478,40243
8600000US40245,24920,11891,13029,114092,142420,7403,40245
8600000US40258,20538,9814,10724,51184,61781,2816,40258
8600000US40272,28991,13565,15426,55052,67846,2911,40272
8600000US40280,565,338,227,,64874,25285,40280
8600000US40291,28840,13589,15251,70234,82553,2614,40291
8600000US40299,30771,14932,15839,76587,92926,3139,40299
8600000US40310,269,122,147,38516,41735,8959,40310
8600000US40311,5481,2631,2850,42872,60373,7589,40311
8600000US40312,3772,1750,2022,29982,44529,5255,40312
8600000US40313,2423,1280,1143,30583,35519,7827,40313
8600000US40316,238,115,123,,50912,15816,40316
8600000US40322,2548,1291,1257,42228,46679,4686,40322
8600000US40324,34942,17030,17912,67160,83008,2679,40324
8600000US40328,915,538,377,32813,55165,20735,40328
8600000US40330,15627,7543,8084,48760,62176,3840,40330
8600000US40334,36,21,15,,,,40334
8600000US40336,9850,4794,5056,30518,43489,4186,40336
8600000US40337,3924,1855,2069,33544,46340,4681,40337
8600000US40339,0,0,0,,,,40339
8600000US40342,16650,7906,8744,54365,66633,3847,40342
8600000US40346,625,341,284,,37275,10930,40346
8600000US40347,2345,1045,1300,64474,98703,11903,40347
8600000US40348,432,257,175,31250,44425,10030,40348
8600000US40350,143,63,80,,38257,18311,40350
8600000US40351,17459,8192,9267,40422,56583,5518,40351
8600000US40353,17127,8219,8908,43540,58530,4865,40353
8600000US40356,32679,15438,17241,56399,83855,5132,40356
8600000US40358,688,414,274,40525,40798,12731,40358
8600000US40359,4970,2378,2592,46901,59662,8876,40359
8600000US40360,4913,2239,2674,47931,64158,10046,40360
8600000US40361,14304,6733,7571,51858,68193,4738,40361
8600000US40363,19,19,0,,,,40363
8600000US40370,2285,1170,1115,64265,75665,7648,40370
8600000US40371,2434,1164,1270,34668,44775,6306,40371
8600000US40372,1515,712,803,68400,75949,7649,40372
8600000US40374,1369,751,618,38214,46099,6058,40374
8600000US40376,48,17,31,,,,40376
8600000US40379,2587,1351,1236,54091,71606,9860,40379
8600000US40380,5374,2659,2715,45614,55360,7960,40380
8600000US40383,18128,8803,9325,63555,77943,3875,40383
8600000US40385,2259,1187,1072,43106,52409,7011,40385
8600000US40387,1640,915,725,39219,49158,7628,40387
8600000US40390,6126,2966,3160,54417,71679,10288,40390
8600000US40391,27488,13164,14324,52834,67644,3292,40391
8600000US40402,2029,1060,969,34496,45282,9023,40402
8600000US40403,18405,8973,9432,48870,60160,4257,40403
8600000US40404,842,340,502,,,,40404
8600000US40409,2981,1461,1520,36250,47397,6049,40409
8600000US40419,2916,1372,1544,33011,50127,9584,40419
8600000US40422,20076,9882,10194,42400,65301,3754,40422
8600000US40434,0,0,0,,,,40434
8600000US40437,4123,2040,2083,40032,47524,5301,40437
8600000US40440,1777,873,904,39621,51685,7537,40440
8600000US40442,950,430,520,34833,48083,13872,40442
8600000US40444,11197,5303,5894,50344,66049,5149,40444
8600000US40445,662,290,372,21971,35563,8326,40445
8600000US40447,6401,3097,3304,30781,40484,5400,40447
8600000US40448,34,17,17,,,,40448
8600000US40456,7805,3725,4080,36888,51817,4142,40456
8600000US40460,888,460,428,52940,54798,12039,40460
8600000US40461,2831,1409,1422,56280,61556,5459,40461
8600000US40464,1182,611,571,48750,58647,9450,40464
8600000US40468,1476,665,811,50972,57730,6934,40468
8600000US40472,1479,811,668,35469,42600,6291,40472
8600000US40475,49229,23526,25703,48079,65247,2819,40475
8600000US40481,97,44,53,,32615,19348,40481
8600000US40484,8754,4272,4482,41790,53756,4522,40484
8600000US40486,1864,885,979,41417,49718,12765,40486
8600000US40489,3215,1592,1623,47913,53562,7558,40489
8600000US40502,22369,10971,11398,65748,114830,8069,40502
8600000US40503,23857,11214,12643,63165,78988,3005,40503
8600000US40504,22046,11228,10818,34555,46785,2594,40504
8600000US40505,20026,9766,10260,36729,50787,3639,40505
8600000US40506,2530,1061,1469,,,,40506
8600000US40507,1664,873,791,26148,65173,13038,40507
8600000US40508,22941,11043,11898,25199,40258,3018,40508
8600000US40509,30244,14442,15802,74560,102027,5727,40509
8600000US40510,1859,1319,540,96071,138303,32262,40510
8600000US40511,25522,13255,12267,60774,71915,2817,40511
8600000US40513,8416,4084,4332,105356,144756,14633,40513
8600000US40514,11895,5863,6032,86118,108980,8432,40514
8600000US40515,28425,13528,14897,72099,100678,5492,40515
8600000US40516,2606,1313,1293,67583,95565,17995,40516
8600000US40517,28241,12680,15561,40954,53907,3154,40517
8600000US40601,40389,19165,21224,55322,67433,2407,40601
8600000US40604,126,126,0,,,,40604
8600000US40701,22609,10812,11797,37616,53115,5039,40701
8600000US40729,3918,2005,1913,33237,45951,8416,40729
8600000US40734,2979,1358,1621,34107,38625,5170,40734
8600000US40737,723,390,333,42368,68469,33148,40737
8600000US40740,2259,1134,1125,36867,48361,8042,40740
8600000US40741,18530,8860,9670,40917,56518,4174,40741
8600000US40743,184,102,82,43750,51779,15440,40743
8600000US40744,13937,6532,7405,43600,56415,4107,40744
8600000US40759,1723,865,858,27690,43453,13393,40759
8600000US40763,361,201,160,18869,30676,11657,40763
8600000US40769,13893,6703,7190,30470,43763,3992,40769
8600000US40771,1041,498,543,42250,41087,9293,40771
8600000US40801,378,175,203,26488,39488,16048,40801
8600000US40806,1799,823,976,30456,47645,7458,40806
8600000US40807,307,147,160,49107,52275,8468,40807
8600000US40808,62,28,34,40500,51608,20287,40808
8600000US40810,924,510,414,21875,31253,6259,40810
8600000US40813,404,194,210,31912,44494,12860,40813
8600000US40815,994,493,501,23026,37602,14015,40815
8600000US40816,15,15,0,,,,40816
8600000US40818,41,18,23,26250,28991,5956,40818
8600000US40819,426,182,244,35972,57625,24416,40819
8600000US40820,677,353,324,28500,36522,9290,40820
8600000US40823,2744,1289,1455,26475,37376,4509,40823
8600000US40824,281,156,125,22340,41319,23062,40824
8600000US40826,474,224,250,32946,32746,6030,40826
8600000US40827,831,302,529,47404,55802,21084,40827
8600000US40828,2784,1367,1417,24966,31554,3674,40828
8600000US40829,151,101,50,,33190,19125,40829
8600000US40830,106,43,63,10938,18106,9517,40830
8600000US40831,4046,1742,2304,23519,39344,4375,40831
8600000US40840,176,78,98,,29655,19779,40840
8600000US40843,268,140,128,22222,28623,6739,40843
8600000US40844,99,41,58,29333,32907,9532,40844
8600000US40845,480,215,265,19534,24609,4617,40845
8600000US40847,276,150,126,27763,39232,15644,40847
8600000US40849,326,173,153,25769,36066,9610,40849
8600000US40854,787,337,450,25625,34025,5767,40854
8600000US40855,595,289,306,40139,41835,5973,40855
8600000US40856,592,292,300,43092,39826,7805,40856
8600000US40858,245,108,137,25515,37970,15750,40858
8600000US40862,374,173,201,36375,47397,18824,40862
8600000US40863,421,226,195,18352,21106,6732,40863
8600000US40865,349,172,177,25208,37750,11527,40865
8600000US40868,809,393,416,22400,25422,7918,40868
8600000US40870,299,155,144,28000,37227,12480,40870
8600000US40873,1690,834,856,38538,38637,5913,40873
8600000US40874,394,224,170,49896,54809,14252,40874
8600000US40902,989,485,504,20592,24738,5080,40902
8600000US40903,340,188,152,21250,33991,13660,40903
8600000US40906,9241,4379,4862,30516,50127,8967,40906
8600000US40913,297,149,148,37981,36128,12922,40913
8600000US40914,175,63,112,,54785,28633,40914
8600000US40915,630,345,285,29320,45111,15032,40915
8600000US40921,187,116,71,34643,39791,15742,40921
8600000US40923,352,114,238,43913,42224,12428,40923
8600000US40927,243,114,129,38553,46393,13903,40927
8600000US40935,2230,1091,1139,19075,28308,5395,40935
8600000US40939,139,102,37,,14320,10139,40939
8600000US40940,373,209,164,19500,32201,11985,40940
8600000US40941,265,135,130,,27816,15291,40941
8600000US40943,504,247,257,26989,28668,8097,40943
8600000US40946,236,95,141,23381,29341,12713,40946
8600000US40949,633,343,290,38450,40034,8548,40949
8600000US40953,465,267,198,30667,28753,7959,40953
8600000US40958,262,126,136,,32078,15749,40958
8600000US40962,14209,7626,6583,26383,39332,3435,40962
8600000US40964,42,19,23,,70082,52205,40964
8600000US40965,9637,4429,5208,24556,38560,5965,40965
8600000US40972,882,423,459,,33631,7207,40972
8600000US40977,8226,4149,4077,25720,36736,3331,40977
8600000US40979,20,20,0,,,,40979
8600000US40982,264,116,148,,26924,8576,40982
8600000US40983,328,172,156,,27974,11674,40983
8600000US40988,355,167,188,22750,25065,7077,40988
8600000US40995,113,62,51,19167,22739,12214,40995
8600000US40997,236,133,103,,12996,7590,40997
8600000US41001,13018,6281,6737,80033,91839,5540,41001
8600000US41002,1957,976,981,45000,59732,6228,41002
8600000US41003,1894,949,945,42756,52375,7910,41003
8600000US41004,3011,1411,1600,44243,57368,6922,41004
8600000US41005,17939,9078,8861,81608,86936,4513,41005
8600000US41006,3352,1599,1753,62734,66144,8992,41006
8600000US41007,3414,1767,1647,69886,86398,8163,41007
8600000US41008,5224,2664,2560,42896,61602,8071,41008
8600000US41010,2935,1420,1515,44475,56419,9345,41010
8600000US41011,20539,10299,10240,45532,68720,3731,41011
8600000US41014,5496,2596,2900,40153,50669,3254,41014
8600000US41015,15662,7480,8182,51084,67426,5194,41015
8600000US41016,4566,2282,2284,47250,58276,6558,41016
8600000US41017,30797,15219,15578,77559,107112,5996,41017
8600000US41018,21264,10419,10845,55535,71202,3380,41018
8600000US41030,4491,2056,2435,54250,65919,5528,41030
8600000US41031,12194,5860,6334,50574,61599,4514,41031
8600000US41033,1349,727,622,59063,66571,12974,41033
8600000US41034,698,356,342,61700,68873,11884,41034
8600000US41035,8051,4006,4045,43653,58802,5505,41035
8600000US41039,2150,1062,1088,45357,56686,7855,41039
8600000US41040,5610,2834,2776,39032,52644,4939,41040
8600000US41041,5250,2554,2696,39688,59260,6968,41041
8600000US41042,39674,18860,20814,59018,76451,3159,41042
8600000US41043,1326,713,613,57150,72379,9238,41043
8600000US41044,602,309,293,56071,73278,29823,41044
8600000US41045,1156,630,526,51298,66527,10173,41045
8600000US41046,828,444,384,38472,47188,7471,41046
8600000US41048,10697,5015,5682,98304,121128,10626,41048
8600000US41049,1750,881,869,40511,53361,8765,41049
8600000US41051,21267,10211,11056,80295,85792,3302,41051
8600000US41052,80,47,33,,89105,94882,41052
8600000US41055,1608,856,752,58125,74486,8902,41055
8600000US41056,10853,5172,5681,37484,60322,6061,41056
8600000US41059,2089,956,1133,81509,87633,8523,41059
8600000US41062,0,0,0,,,,41062
8600000US41063,2508,1223,1285,61574,69714,8456,41063
8600000US41064,1507,827,680,38906,47579,5526,41064
8600000US41071,16691,8454,8237,42037,61725,4452,41071
8600000US41073,4700,2168,2532,57374,81871,10473,41073
8600000US41074,4265,2162,2103,49032,63082,5612,41074
8600000US41075,12455,5939,6516,74182,101784,8119,41075
8600000US41076,14187,6554,7633,57539,73494,4899,41076
8600000US41080,1780,952,828,74877,84577,12433,41080
8600000US41083,1051,567,484,39231,56203,11014,41083
8600000US41085,653,333,320,48125,49616,6693,41085
8600000US41086,2086,998,1088,54257,64017,10762,41086
8600000US41091,14178,7306,6872,106146,129892,9010,41091
8600000US41092,2898,1472,1426,69676,83806,9827,41092
8600000US41093,2217,1049,1168,42978,51582,6167,41093
8600000US41094,11083,5401,5682,73948,97695,11349,41094
8600000US41095,2742,1404,1338,42656,53923,4842,41095
8600000US41097,5402,2930,2472,44964,59422,6636,41097
8600000US41098,1259,679,580,34063,59028,18212,41098
8600000US41099,1070,449,621,,,,41099
8600000US41101,14287,6700,7587,38256,60059,4357,41101
8600000US41102,16326,8423,7903,50881,69347,6460,41102
8600000US41121,943,441,502,31458,77586,34602,41121
8600000US41124,718,412,306,39875,40572,7761,41124
8600000US41129,8205,3972,4233,54987,70965,8133,41129
8600000US41132,235,108,127,,48883,26843,41132
8600000US41135,84,53,31,24931,26883,5993,41135
8600000US41139,6326,2888,3438,50927,65855,6358,41139
8600000US41141,1388,708,680,27031,44863,12653,41141
8600000US41142,76,38,38,,,,41142
8600000US41143,11278,5558,5720,34565,49977,3975,41143
8600000US41144,7940,3859,4081,38116,55742,4225,41144
8600000US41146,352,156,196,,28346,12869,41146
8600000US41149,467,244,223,30132,27892,5598,41149
8600000US41159,405,196,209,14964,36699,16133,41159
8600000US41164,9856,4656,5200,30844,41806,3198,41164
8600000US41166,966,503,463,49477,59542,13348,41166
8600000US41168,1906,934,972,52591,59842,10821,41168
8600000US41169,4242,2023,2219,58103,68458,5652,41169
8600000US41171,4289,2703,1586,40536,45284,4443,41171
8600000US41174,906,470,436,46319,46462,10001,41174
8600000US41175,4024,1924,2100,47159,63369,8588,41175
8600000US41179,6128,2972,3156,28819,48212,7394,41179
8600000US41180,758,422,336,34688,44665,8653,41180
8600000US41183,1348,637,711,48681,55754,5543,41183
8600000US41189,1584,825,759,34042,46369,9216,41189
8600000US41201,151,80,71,37833,34785,19764,41201
8600000US41203,614,308,306,22566,38090,15733,41203
8600000US41204,430,211,219,,52809,21630,41204
8600000US41214,471,261,210,,36313,15801,41214
8600000US41216,943,467,476,59000,75050,22669,41216
8600000US41219,1489,770,719,32000,45633,9828,41219
8600000US41222,1955,939,1016,38393,53989,8836,41222
8600000US41224,4928,3032,1896,35896,41527,4917,41224
8600000US41226,259,142,117,18472,22852,7553,41226
8600000US41230,9291,4520,4771,33852,48385,5222,41230
8600000US41231,901,481,420,28750,47267,15153,41231
8600000US41232,690,309,381,27891,32044,9357,41232
8600000US41234,467,209,258,,64111,28929,41234
8600000US41238,430,204,226,41726,54217,13625,41238
8600000US41240,5158,2574,2584,38829,50521,8481,41240
8600000US41250,932,482,450,41250,43716,7203,41250
8600000US41254,231,85,146,35865,50113,18575,41254
8600000US41255,798,407,391,37414,50300,13850,41255
8600000US41256,2480,1087,1393,39581,87611,38104,41256
8600000US41257,448,181,267,36771,59878,27543,41257
8600000US41260,749,350,399,22639,35938,12091,41260
8600000US41262,713,245,468,42031,47243,13045,41262
8600000US41263,308,127,181,,44932,17271,41263
8600000US41264,334,190,144,,39960,17777,41264
8600000US41265,1115,578,537,45000,51536,9463,41265
8600000US41267,616,300,316,27656,42809,13785,41267
8600000US41268,440,237,203,25982,28734,9091,41268
8600000US41271,170,91,79,29018,38472,23940,41271
8600000US41274,414,210,204,12321,32301,17510,41274
8600000US41301,4856,2309,2547,24869,38464,6324,41301
8600000US41311,5110,2589,2521,23586,36160,4374,41311
8600000US41314,3800,1639,2161,24044,43522,7330,41314
8600000US41317,58,26,32,,52546,36714,41317
8600000US41332,789,416,373,28068,35947,7928,41332
8600000US41339,8462,4185,4277,27050,45186,4158,41339
8600000US41348,803,435,368,18393,32983,8199,41348
8600000US41352,564,311,253,36667,37288,6580,41352
8600000US41360,437,290,147,,51296,23761,41360
8600000US41365,217,92,125,16159,25143,9537,41365
8600000US41366,27,27,0,,,,41366
8600000US41367,151,88,63,,45995,25071,41367
8600000US41385,439,189,250,43036,40253,11075,41385
8600000US41390,22,16,6,,,,41390
8600000US41397,33,13,20,,,,41397
8600000US41408,365,166,199,20650,44819,26066,41408
8600000US41421,299,98,201,32863,35742,11497,41421
8600000US41425,860,398,462,38889,52579,10295,41425
8600000US41464,472,285,187,21083,32949,12499,41464
8600000US41465,8868,4332,4536,30123,44981,5575,41465
8600000US41472,8447,4940,3507,34049,46590,4747,41472
8600000US41501,18397,8873,9524,35291,59919,5839,41501
8600000US41503,482,210,272,57813,75263,37695,41503
8600000US41512,703,392,311,33875,45379,11591,41512
8600000US41513,278,144,134,42813,46869,12772,41513
8600000US41514,2514,1140,1374,29980,40982,6447,41514
8600000US41517,140,81,59,53162,54255,10460,41517
8600000US41519,867,471,396,29760,46251,9212,41519
8600000US41522,4088,2039,2049,27446,38930,4866,41522
8600000US41524,138,55,83,27935,25597,7708,41524
8600000US41526,79,27,52,,35769,22989,41526
8600000US41527,641,328,313,53345,56652,12159,41527
8600000US41528,587,295,292,19265,26184,14296,41528
8600000US41531,714,350,364,34048,44179,10127,41531
8600000US41534,229,98,131,,25136,15314,41534
8600000US41535,324,143,181,55577,56445,22477,41535
8600000US41537,3866,1782,2084,31620,47521,6462,41537
8600000US41538,49,31,18,,,,41538
8600000US41539,1135,617,518,42899,52555,9096,41539
8600000US41540,192,105,87,49125,53410,19585,41540
8600000US41543,185,72,113,37778,35372,12157,41543
8600000US41544,619,333,286,36125,53902,11713,41544
8600000US41547,449,171,278,18147,21988,7296,41547
8600000US41548,653,314,339,26250,45792,16912,41548
8600000US41553,1723,833,890,38938,49590,8473,41553
8600000US41554,744,395,349,31447,44114,11158,41554
8600000US41555,456,239,217,19167,31018,12165,41555
8600000US41557,1287,707,580,38472,51205,10089,41557
8600000US41558,640,307,333,38041,42938,8176,41558
8600000US41559,122,48,74,,35069,19094,41559
8600000US41560,175,76,99,33450,35528,10760,41560
8600000US41562,2312,1000,1312,42005,52638,11380,41562
8600000US41563,347,153,194,,34011,8699,41563
8600000US41564,685,313,372,35833,56301,25857,41564
8600000US41566,651,290,361,,42228,12115,41566
8600000US41567,126,59,67,,27884,14451,41567
8600000US41568,616,201,415,16128,26615,11106,41568
8600000US41571,372,172,200,54063,51109,11428,41571
8600000US41572,2638,1246,1392,36754,46242,6347,41572
8600000US41601,532,245,287,34156,51952,15889,41601
8600000US41602,821,363,458,48179,48258,10389,41602
8600000US41603,1281,650,631,27692,44457,11175,41603
8600000US41604,328,127,201,29646,41780,11210,41604
8600000US41605,512,286,226,45217,49580,18124,41605
8600000US41606,843,310,533,24813,37270,12456,41606
8600000US41607,394,181,213,26458,51374,31051,41607
8600000US41612,132,62,70,,21522,15805,41612
8600000US41615,563,327,236,,28259,15377,41615
8600000US41616,504,246,258,20625,28520,7401,41616
8600000US41619,138,73,65,40250,40900,11470,41619
8600000US41621,134,83,51,,47313,22149,41621
8600000US41622,155,68,87,60556,56385,14448,41622
8600000US41630,1158,547,611,20587,58261,35106,41630
8600000US41631,896,432,464,35649,37188,6189,41631
8600000US41632,449,234,215,28750,35424,9871,41632
8600000US41635,2098,963,1135,25030,37330,8199,41635
8600000US41636,680,351,329,26136,37142,15224,41636
8600000US41640,818,427,391,29758,33346,5779,41640
8600000US41642,417,216,201,23170,32951,11872,41642
8600000US41643,56,29,27,,30511,18320,41643
8600000US41645,988,537,451,36250,55213,13972,41645
8600000US41647,1287,625,662,28144,41361,13968,41647
8600000US41649,1934,858,1076,24038,57384,36717,41649
8600000US41650,278,131,147,23611,28151,8021,41650
8600000US41653,8306,3967,4339,33892,48055,4859,41653
8600000US41655,675,387,288,20275,26756,8819,41655
8600000US41659,371,168,203,28125,42603,20845,41659
8600000US41660,454,164,290,46379,45986,13390,41660
8600000US41663,517,276,241,,39852,23319,41663
8600000US41666,717,312,405,23011,38301,10507,41666
8600000US41667,498,228,270,42917,53269,19116,41667
8600000US41669,597,256,341,19167,29177,8686,41669
8600000US41701,12802,6025,6777,38000,52898,5174,41701
8600000US41712,296,151,145,71761,73095,22827,41712
8600000US41713,58,0,58,,,,41713
8600000US41714,291,170,121,,28658,15729,41714
8600000US41719,889,491,398,27962,43409,14038,41719
8600000US41721,414,208,206,16745,29471,7975,41721
8600000US41722,920,504,416,21603,35341,10572,41722
8600000US41723,880,384,496,15147,32515,11350,41723
8600000US41725,116,44,72,23083,36448,48148,41725
8600000US41727,615,310,305,,57992,42236,41727
8600000US41729,42,23,19,,,,41729
8600000US41731,935,431,504,26685,39303,8854,41731
8600000US41735,126,59,67,29408,42659,19508,41735
8600000US41739,82,52,30,,24778,13216,41739
8600000US41740,798,453,345,56774,66337,13870,41740
8600000US41745,305,140,165,30402,41677,12209,41745
8600000US41746,327,170,157,18077,37328,17436,41746
8600000US41749,2691,1382,1309,38138,44757,8963,41749
8600000US41751,173,73,100,53125,63247,32420,41751
8600000US41754,257,113,144,,56500,18517,41754
8600000US41759,190,106,84,32969,37619,13742,41759
8600000US41760,5,5,0,,,,41760
8600000US41762,0,0,0,,,,41762
8600000US41763,459,229,230,17449,31471,7778,41763
8600000US41764,520,223,297,36630,40472,15494,41764
8600000US41766,137,56,81,32885,34569,10078,41766
8600000US41772,166,70,96,42885,47202,25979,41772
8600000US41773,1108,511,597,19857,28925,5075,41773
8600000US41774,1826,920,906,34615,48254,6647,41774
8600000US41775,44,24,20,,,,41775
8600000US41776,962,520,442,29892,44436,12541,41776
8600000US41777,735,332,403,27143,28150,4595,41777
8600000US41804,401,201,200,34203,46660,24329,41804
8600000US41810,305,141,164,40719,43769,14723,41810
8600000US41812,223,122,101,31167,44178,14734,41812
8600000US41815,747,339,408,,24736,8339,41815
8600000US41817,154,40,114,34833,47849,19054,41817
8600000US41819,267,108,159,,32178,16764,41819
8600000US41821,330,164,166,,41908,18330,41821
8600000US41822,1585,781,804,30395,42914,7200,41822
8600000US41824,945,489,456,19524,30633,14209,41824
8600000US41825,579,254,325,28997,41494,16556,41825
8600000US41826,558,305,253,47105,47408,14266,41826
8600000US41828,566,282,284,27692,41040,8046,41828
8600000US41831,700,356,344,34375,56391,12332,41831
8600000US41832,301,149,152,60521,55827,24617,41832
8600000US41833,443,290,153,32250,33976,14026,41833
8600000US41834,289,148,141,24750,31107,9449,41834
8600000US41835,750,382,368,27500,42593,20163,41835
8600000US41836,1018,523,495,42017,45711,10131,41836
8600000US41837,1020,549,471,29970,41399,10516,41837
8600000US41838,433,233,200,32500,43037,14907,41838
8600000US41839,1222,686,536,29615,37564,5738,41839
8600000US41840,716,323,393,29405,43976,11327,41840
8600000US41843,518,204,314,16076,38234,17108,41843
8600000US41844,1334,567,767,26563,41536,8519,41844
8600000US41845,142,47,95,,31733,20902,41845
8600000US41847,409,196,213,,41891,20198,41847
8600000US41848,0,0,0,,,,41848
8600000US41849,43,15,28,,,,41849
8600000US41855,506,284,222,48906,57336,21023,41855
8600000US41858,5633,2620,3013,28404,46171,6347,41858
8600000US41859,327,152,175,19643,28238,8508,41859
8600000US41861,82,48,34,44833,46305,19788,41861
8600000US41862,779,400,379,27330,37188,9607,41862
8600000US42001,22105,10065,12040,46778,79630,6814,42001
8600000US42003,22680,10606,12074,39778,58253,4774,42003
8600000US42020,1399,699,700,57348,68650,10806,42020
8600000US42021,1260,577,683,31917,50638,12807,42021
8600000US42022,185,106,79,71467,74999,24614,42022
8600000US42023,1806,840,966,41875,58427,5524,42023
8600000US42024,908,398,510,41979,65283,11697,42024
8600000US42025,15212,7355,7857,53707,67382,4697,42025
8600000US42027,1578,852,726,42244,64959,13146,42027
8600000US42028,525,278,247,41357,51843,12426,42028
8600000US42029,4887,2475,2412,50194,65926,6882,42029
8600000US42031,2353,1066,1287,34651,56108,14186,42031
8600000US42032,187,84,103,36563,39243,9324,42032
8600000US42035,746,381,365,50500,81916,32386,42035
8600000US42036,969,500,469,66944,84825,35041,42036
8600000US42037,78,44,34,37500,37168,7109,42037
8600000US42038,4691,2674,2017,49375,63603,7848,42038
8600000US42039,1478,672,806,59943,67439,9924,42039
8600000US42040,657,327,330,57500,96483,44095,42040
8600000US42041,3416,1619,1797,32527,48241,4965,42041
8600000US42044,2813,1274,1539,50034,68874,10401,42044
8600000US42045,1864,955,909,63542,84633,25509,42045
8600000US42047,213,112,101,,42043,19357,42047
8600000US42048,1527,727,800,31250,39150,8269,42048
8600000US42049,1295,717,578,44662,57655,9125,42049
8600000US42050,2327,1266,1061,31184,43280,5689,42050
8600000US42051,2699,1444,1255,47344,65686,18626,42051
8600000US42053,4050,2079,1971,50599,93369,39906,42053
8600000US42054,724,359,365,85238,83968,15600,42054
8600000US42055,2049,1086,963,51042,68568,12217,42055
8600000US42056,1495,729,766,46979,64102,8825,42056
8600000US42058,1832,870,962,58873,60603,8815,42058
8600000US42060,0,0,0,,,,42060
8600000US42061,26,12,14,,,,42061
8600000US42064,6480,3244,3236,43409,58452,5863,42064
8600000US42066,17641,8291,9350,39213,52047,3894,42066
8600000US42069,493,245,248,60852,64955,11692,42069
8600000US42071,26262,12471,13791,38092,53497,3084,42071
8600000US42076,852,432,420,28824,39630,7428,42076
8600000US42078,1235,568,667,32750,48556,7587,42078
8600000US42079,1241,586,655,50750,70181,14690,42079
8600000US42081,1498,730,768,31406,67309,29893,42081
8600000US42082,1295,667,628,69965,81855,16776,42082
8600000US42083,274,134,140,51333,60852,24179,42083
8600000US42084,52,23,29,,30555,15084,42084
8600000US42085,705,351,354,40034,42183,8044,42085
8600000US42086,3194,1672,1522,62442,84890,22382,42086
8600000US42087,1890,943,947,39375,51709,7121,42087
8600000US42088,1850,894,956,43110,51483,5441,42088
8600000US42101,48146,23571,24575,41015,52305,2451,42101
8600000US42102,43,8,35,,22379,12447,42102
8600000US42103,15500,7629,7871,63178,93384,7219,42103
8600000US42104,25520,12019,13501,58323,81251,6542,42104
8600000US42120,2001,1030,971,37194,55094,16689,42120
8600000US42122,3922,1854,2068,80896,116063,23725,42122
8600000US42123,507,294,213,44500,57379,13323,42123
8600000US42124,9,0,9,,,,42124
8600000US42127,5162,2662,2500,37120,49496,5088,42127
8600000US42129,5405,2614,2791,35363,46035,4150,42129
8600000US42130,211,92,119,29046,50000,25098,42130
8600000US42133,1192,647,545,58393,67897,9399,42133
8600000US42134,13176,6343,6833,48337,60070,4123,42134
8600000US42140,725,353,372,37813,66255,16059,42140
8600000US42141,23653,11029,12624,40173,51241,2880,42141
8600000US42151,156,82,74,,16535,14371,42151
8600000US42153,347,189,158,58125,52825,14734,42153
8600000US42154,359,167,192,42917,49108,13588,42154
8600000US42156,230,120,110,74821,83845,24722,42156
8600000US42157,379,203,176,41932,108466,79404,42157
8600000US42159,1317,590,727,68375,78931,13557,42159
8600000US42160,1366,749,617,45333,52191,8970,42160
8600000US42163,47,0,47,,,,42163
8600000US42164,12718,6155,6563,41753,54572,4423,42164
8600000US42166,2134,1068,1066,37889,47592,6560,42166
8600000US42167,6412,3132,3280,32477,51393,7011,42167
8600000US42170,1391,675,716,52083,63658,9274,42170
8600000US42171,5551,2652,2899,55737,66410,6961,42171
8600000US42202,1797,871,926,40379,57828,18633,42202
8600000US42204,438,219,219,57500,68745,25950,42204
8600000US42206,4614,2325,2289,49519,67726,15543,42206
8600000US42207,993,426,567,35968,41665,9023,42207
8600000US42210,3488,1745,1743,32034,47530,6137,42210
8600000US42211,10436,5032,5404,53047,63650,5044,42211
8600000US42214,487,212,275,,77221,28081,42214
8600000US42215,939,500,439,44440,65089,16980,42215
8600000US42217,2485,1302,1183,43783,52444,4470,42217
8600000US42220,5171,2493,2678,43718,63675,18849,42220
8600000US42223,14066,9933,4133,42494,49217,2660,42223
8600000US42232,611,331,280,70074,78689,19888,42232
8600000US42234,1861,897,964,31531,54326,9212,42234
8600000US42236,481,274,207,47037,63795,14394,42236
8600000US42240,30847,14653,16194,40306,56645,4051,42240
8600000US42254,192,101,91,,47042,13144,42254
8600000US42256,3494,1820,1674,47813,58593,5559,42256
8600000US42259,1118,647,471,48398,50321,6773,42259
8600000US42261,8419,4198,4221,38646,54397,4772,42261
8600000US42262,6073,3271,2802,45588,52888,6187,42262
8600000US42265,497,286,211,47875,75519,21477,42265
8600000US42266,1549,816,733,62639,68511,7381,42266
8600000US42273,414,208,206,48913,83985,41883,42273
8600000US42274,1743,1019,724,52866,57993,10529,42274
8600000US42275,492,223,269,40750,52109,11193,42275
8600000US42276,10973,5083,5890,41878,51661,3158,42276
8600000US42280,278,165,113,55833,50409,14926,42280
8600000US42285,215,87,128,49271,42632,11795,42285
8600000US42286,815,430,385,56141,65808,8548,42286
8600000US42301,32511,15258,17253,45405,63105,3822,42301
8600000US42303,31244,14950,16294,49505,70327,4264,42303
8600000US42320,6468,3190,3278,41128,69949,25398,42320
8600000US42321,166,69,97,,33512,15756,42321
8600000US42322,11,0,11,,,,42322
8600000US42323,699,369,330,34602,45709,13747,42323
8600000US42324,846,447,399,55208,64898,12115,42324
8600000US42325,1981,1076,905,38750,49158,8463,42325
8600000US42326,367,245,122,66389,73729,37587,42326
8600000US42327,3070,1499,1571,60761,69564,6475,42327
8600000US42328,1025,552,473,40428,51523,7510,42328
8600000US42330,7119,3282,3837,43614,54957,6566,42330
8600000US42332,149,96,53,13173,23949,9328,42332
8600000US42333,1070,554,516,50568,58816,14250,42333
8600000US42337,1958,941,1017,43073,55217,9277,42337
8600000US42338,11,0,11,,,,42338
8600000US42339,605,318,287,49423,60972,13039,42339
8600000US42343,1199,561,638,28680,41684,7973,42343
8600000US42344,714,285,429,,54374,17363,42344
8600000US42345,8668,4273,4395,41708,54326,3964,42345
8600000US42347,4914,2390,2524,44724,61825,7136,42347
8600000US42348,3599,1880,1719,53831,62735,4010,42348
8600000US42349,901,461,440,32824,41326,6488,42349
8600000US42350,1130,570,560,51765,65704,9431,42350
8600000US42351,3113,1551,1562,54669,70522,10701,42351
8600000US42352,1557,752,805,46500,52531,6404,42352
8600000US42354,192,96,96,44792,57128,15805,42354
8600000US42355,1558,738,820,61865,72072,10355,42355
8600000US42356,92,0,92,,,,42356
8600000US42361,349,162,187,63438,61603,18105,42361
8600000US42366,4434,2223,2211,72443,85047,11244,42366
8600000US42367,671,346,325,41146,48643,7750,42367
8600000US42368,1071,575,496,56076,60394,9256,42368
8600000US42369,194,113,81,40250,47248,9743,42369
8600000US42370,0,0,0,,,,42370
8600000US42371,263,103,160,27857,43262,12447,42371
8600000US42372,1334,611,723,45268,53843,5737,42372
8600000US42374,378,200,178,89115,75516,19758,42374
8600000US42376,4345,2259,2086,62250,74791,7550,42376
8600000US42378,2194,1097,1097,57321,72454,11716,42378
8600000US42404,2044,1018,1026,47528,57250,7928,42404
8600000US42406,2331,1165,1166,52647,62119,5979,42406
8600000US42408,5114,2369,2745,35625,46695,6686,42408
8600000US42409,2146,1186,960,49784,60626,6173,42409
8600000US42410,1131,572,559,41445,52253,9429,42410
8600000US42411,1453,740,713,55221,71278,15163,42411
8600000US42413,2559,1356,1203,60264,76786,8866,42413
8600000US42420,29644,14064,15580,43178,59317,3584,42420
8600000US42431,19838,9433,10405,47517,61222,3648,42431
8600000US42436,802,375,427,54306,59022,12583,42436
8600000US42437,7009,3751,3258,42318,57576,5570,42437
8600000US42440,796,373,423,37500,42738,5610,42440
8600000US42441,1203,659,544,44773,61286,14572,42441
8600000US42442,2344,1083,1261,47888,55260,6820,42442
8600000US42445,8325,3886,4439,45208,66751,9602,42445
8600000US42450,2996,1369,1627,32183,50530,6617,42450
8600000US42451,641,301,340,34128,34826,7127,42451
8600000US42452,1887,933,954,58717,93140,36697,42452
8600000US42453,461,219,242,41250,41876,7873,42453
8600000US42455,2247,1086,1161,41107,57823,9098,42455
8600000US42456,1144,527,617,37162,59846,21674,42456
8600000US42458,909,459,450,68525,84039,28821,42458
8600000US42459,3256,1495,1761,47743,55020,5948,42459
8600000US42461,911,481,430,30929,44723,8493,42461
8600000US42462,879,424,455,65662,83592,21959,42462
8600000US42463,54,12,42,,22864,15970,42463
8600000US42464,1205,570,635,49125,58645,8019,42464
8600000US42501,13624,6444,7180,26989,40559,3374,42501
8600000US42503,18270,8769,9501,47664,66898,5299,42503
8600000US42516,377,184,193,,56455,18035,42516
8600000US42518,2128,1055,1073,37569,65844,27283,42518
8600000US42519,2893,1565,1328,30446,40581,5389,42519
8600000US42528,1118,539,579,32981,46626,9790,42528
8600000US42533,605,298,307,36172,65353,18647,42533
8600000US42539,7545,3555,3990,35183,45523,4214,42539
8600000US42541,478,238,240,,34208,10666,42541
8600000US42544,4280,2083,2197,38795,52330,7810,42544
8600000US42553,4315,2267,2048,39390,51185,7341,42553
8600000US42565,391,212,179,24583,30788,7128,42565
8600000US42566,358,188,170,,42063,11951,42566
8600000US42567,4553,2153,2400,35750,46430,5475,42567
8600000US42602,7745,3832,3913,30964,49092,5560,42602
8600000US42603,65,25,40,,,,42603
8600000US42629,4163,2171,1992,37260,49293,5531,42629
8600000US42631,140,57,83,,,,42631
8600000US42633,15736,7637,8099,33869,44751,3503,42633
8600000US42634,1269,599,670,33846,55402,23202,42634
8600000US42635,3885,2632,1253,22283,38500,10670,42635
8600000US42638,0,0,0,,,,42638
8600000US42642,9608,4542,5066,36250,44981,2672,42642
8600000US42647,2574,1403,1171,25701,34764,6680,42647
8600000US42649,1892,966,926,25568,28538,7443,42649
8600000US42653,3920,1876,2044,18455,29176,5654,42653
8600000US42701,38264,18484,19780,55314,71357,3142,42701
8600000US42712,1390,700,690,49145,63975,18353,42712
8600000US42713,1527,754,773,30707,46553,7569,42713
8600000US42715,212,113,99,,26350,17410,42715
8600000US42716,1211,541,670,41367,59119,11418,42716
8600000US42717,5214,2568,2646,32531,42284,3738,42717
8600000US42718,19767,9605,10162,38904,53464,4326,42718
8600000US42721,2791,1371,1420,38830,45832,4402,42721
8600000US42722,393,198,195,32917,46683,13684,42722
8600000US42724,3871,1964,1907,65560,73577,10121,42724
8600000US42726,3788,1930,1858,42971,56756,5501,42726
8600000US42728,13554,6541,7013,40300,52961,5644,42728
8600000US42729,1144,617,527,34844,40998,7334,42729
8600000US42731,79,31,48,39531,40547,7548,42731
8600000US42732,1529,811,718,46833,67085,16941,42732
8600000US42733,860,389,471,37593,41677,6413,42733
8600000US42740,1621,801,820,57212,68113,14216,42740
8600000US42741,266,130,136,36375,62417,25936,42741
8600000US42743,7225,3578,3647,38096,58797,11042,42743
8600000US42746,1258,647,611,37750,47727,9299,42746
8600000US42748,6801,3302,3499,40601,53853,6697,42748
8600000US42749,3923,1883,2040,36728,53618,11565,42749
8600000US42753,546,279,267,34583,43822,8067,42753
8600000US42754,12120,5960,6160,34863,50371,4493,42754
8600000US42757,2281,1174,1107,47426,55669,6295,42757
8600000US42758,102,48,54,86964,96384,31505,42758
8600000US42762,171,45,126,,60271,42345,42762
8600000US42764,420,234,186,,29944,9944,42764
8600000US42765,4646,2223,2423,39400,50413,5739,42765
8600000US42776,1926,925,1001,42344,51735,6324,42776
8600000US42782,815,333,482,37404,54427,11775,42782
8600000US42784,1643,809,834,35652,63702,18691,42784
8600000US42788,222,123,99,71964,79168,28598,42788
8600000US43001,2142,973,1169,73343,86336,13379,43001
8600000US43002,3564,1837,1727,69266,77816,8990,43002
8600000US43003,2317,1240,1077,51768,65051,6871,43003
8600000US43004,19511,9078,10433,76729,99730,5819,43004
8600000US43005,179,86,93,87813,77644,31631,43005
8600000US43006,546,271,275,58750,76874,27660,43006
8600000US43008,2010,998,1012,46854,64689,14628,43008
8600000US43009,1796,914,882,92524,89004,9372,43009
8600000US43010,190,100,90,53571,63146,22441,43010
8600000US43011,5939,3104,2835,71774,78797,6344,43011
8600000US43013,638,340,298,56563,80843,30961,43013
8600000US43014,2610,1282,1328,58750,62381,6517,43014
8600000US43015,41511,20182,21329,75359,90901,2764,43015
8600000US43016,27457,13346,14111,94552,126161,8357,43016
8600000US43017,29397,14446,14951,104566,148446,6682,43017
8600000US43019,6453,3161,3292,53558,68956,7431,43019
8600000US43021,8720,4370,4350,135833,163047,12696,43021
8600000US43022,3837,1842,1995,66750,81221,9168,43022
8600000US43023,10619,5253,5366,106208,131656,11853,43023
8600000US43025,4076,2088,1988,68200,94361,14575,43025
8600000US43026,45324,22327,22997,86032,102645,3724,43026
8600000US43028,6306,2991,3315,59080,73343,6203,43028
8600000US43029,467,249,218,55885,65389,14021,43029
8600000US43030,113,57,56,,,,43030
8600000US43031,10292,5181,5111,71577,88012,7028,43031
8600000US43032,9,9,0,,,,43032
8600000US43033,258,117,141,52813,64652,27276,43033
8600000US43035,18358,8668,9690,118216,137595,5840,43035
8600000US43036,209,111,98,49444,48148,7331,43036
8600000US43037,213,104,109,44286,54733,10436,43037
8600000US43040,26060,11736,14324,75238,87606,3446,43040
8600000US43044,3858,2053,1805,65893,79401,11023,43044
8600000US43045,1533,696,837,81463,93594,15343,43045
8600000US43046,3136,1546,1590,67218,88909,12843,43046
8600000US43050,22587,10570,12017,49602,60669,2948,43050
8600000US43054,19021,9223,9798,118640,170078,10521,43054
8600000US43055,47905,22373,25532,46030,61025,2561,43055
8600000US43056,14835,7063,7772,57802,74039,5621,43056
8600000US43060,2004,977,1027,63409,86283,22382,43060
8600000US43061,3353,1789,1564,94615,103013,10141,43061
8600000US43062,21735,10764,10971,82926,93759,5302,43062
8600000US43064,9922,5036,4886,97869,115380,7313,43064
8600000US43065,30276,14795,15481,133496,162424,6630,43065
8600000US43066,1053,548,505,84333,102362,21298,43066
8600000US43067,1088,598,490,81029,80588,13960,43067
8600000US43068,41099,19132,21967,62562,74353,2525,43068
8600000US43070,143,90,53,,65116,33182,43070
8600000US43071,1596,833,763,63086,69548,9191,43071
8600000US43072,4540,2348,2192,64526,70112,5279,43072
8600000US43074,9784,4699,5085,83704,106289,7065,43074
8600000US43076,6755,3182,3573,65103,73016,5975,43076
8600000US43077,296,155,141,49257,60295,10298,43077
8600000US43078,15788,7480,8308,51927,59502,2944,43078
8600000US43080,3849,1973,1876,58426,74322,11770,43080
8600000US43081,48293,22292,26001,81813,92265,2931,43081
8600000US43082,25037,12385,12652,120896,154361,8182,43082
8600000US43084,607,284,323,63667,83412,17177,43084
8600000US43085,19244,9232,10012,83524,110989,5169,43085
8600000US43101,207,110,97,34167,40372,7706,43101
8600000US43102,3552,1853,1699,67708,76561,8854,43102
8600000US43103,8249,4274,3975,79588,87875,6973,43103
8600000US43105,5877,2891,2986,59604,82490,8093,43105
8600000US43106,1187,584,603,36159,53291,9302,43106
8600000US43107,2615,1335,1280,65761,74401,8658,43107
8600000US43109,73,28,45,53750,59512,26816,43109
8600000US43110,28226,13150,15076,67119,81744,5583,43110
8600000US43111,208,80,128,,50493,23137,43111
8600000US43112,3914,1910,2004,95302,101629,8791,43112
8600000US43113,19110,9110,10000,52396,64650,3250,43113
8600000US43115,1047,473,574,49118,63056,10186,43115
8600000US43116,1052,472,580,84643,89973,9383,43116
8600000US43117,145,86,59,,53553,47219,43117
8600000US43119,21111,10233,10878,68179,80947,5299,43119
8600000US43123,49138,23195,25943,67872,82618,3081,43123
8600000US43125,10805,5002,5803,62336,70852,4363,43125
8600000US43126,380,155,225,64432,72275,19099,43126
8600000US43127,197,100,97,37865,38061,8898,43127
8600000US43128,1833,932,901,50345,56389,5238,43128
8600000US43130,48020,24079,23941,51609,64960,2421,43130
8600000US43135,3159,1566,1593,40653,56041,6058,43135
8600000US43136,512,264,248,66058,82210,9664,43136
8600000US43137,1836,793,1043,53468,65113,10977,43137
8600000US43138,13778,6646,7132,48855,57228,3184,43138
8600000US43140,20171,12438,7733,64529,78319,4330,43140
8600000US43142,84,50,34,32500,36252,15907,43142
8600000US43143,4460,2065,2395,65859,79397,8181,43143
8600000US43144,340,146,194,31667,38745,6340,43144
8600000US43145,1678,772,906,51896,61185,6784,43145
8600000US43146,10307,6900,3407,78510,86635,7683,43146
8600000US43147,29440,14077,15363,99602,111114,4901,43147
8600000US43148,1859,925,934,65362,83645,12404,43148
8600000US43149,1976,985,991,73092,78568,10081,43149
8600000US43150,1686,907,779,59375,69605,8648,43150
8600000US43151,245,111,134,60833,69208,9452,43151
8600000US43152,632,300,332,39722,60857,16429,43152
8600000US43153,636,354,282,51989,72711,12322,43153
8600000US43154,2480,1229,1251,61892,71831,9691,43154
8600000US43155,2138,1008,1130,65292,76746,11130,43155
8600000US43156,174,82,92,60000,67291,19968,43156
8600000US43157,424,186,238,46250,53917,6145,43157
8600000US43158,235,112,123,50313,57486,16812,43158
8600000US43160,16621,7858,8763,45550,59753,3274,43160
8600000US43162,5557,2524,3033,62568,79640,7772,43162
8600000US43164,1682,827,855,48148,68116,11825,43164
8600000US43201,31208,17374,13834,31891,54701,3321,43201
8600000US43202,18813,10512,8301,53331,66328,5352,43202
8600000US43203,6047,2918,3129,28072,37960,3700,43203
8600000US43204,33223,16174,17049,46013,57891,2587,43204
8600000US43205,10161,5267,4894,36032,52470,4129,43205
8600000US43206,18032,8912,9120,52029,76047,5218,43206
8600000US43207,36301,18084,18217,43839,53407,1635,43207
8600000US43209,22312,10050,12262,59464,101215,6544,43209
8600000US43210,12261,6228,6033,17179,27239,7475,43210
8600000US43211,15920,7237,8683,26257,37452,3138,43211
8600000US43212,18467,9223,9244,65199,98877,5014,43212
8600000US43213,24849,11384,13465,39950,51851,2595,43213
8600000US43214,22269,11087,11182,70885,90070,3715,43214
8600000US43215,14195,7704,6491,61332,88879,6949,43215
8600000US43217,1472,677,795,40634,45138,4376,43217
8600000US43219,21768,10145,11623,36813,49644,3102,43219
8600000US43220,21151,9920,11231,69571,108859,5095,43220
8600000US43221,24913,12191,12722,93878,133403,7486,43221
8600000US43222,3366,1816,1550,24967,35663,7076,43222
8600000US43223,19355,9618,9737,35975,45603,3600,43223
8600000US43224,33046,16059,16987,37160,46528,2129,43224
8600000US43227,17906,8153,9753,37376,48126,3217,43227
8600000US43228,39589,18944,20645,46677,58787,2749,43228
8600000US43229,39169,18500,20669,44053,52071,1687,43229
8600000US43230,44561,20653,23908,77377,92213,3201,43230
8600000US43231,15456,7201,8255,49295,62242,3587,43231
8600000US43232,33057,14946,18111,39806,47642,1826,43232
8600000US43235,33909,15977,17932,76250,99399,4362,43235
8600000US43240,3465,1721,1744,71705,83439,6615,43240
8600000US43302,42730,23504,19226,42813,56393,2584,43302
8600000US43310,2223,1128,1095,63036,68613,5536,43310
8600000US43311,14227,6550,7677,55232,65847,3838,43311
8600000US43314,2383,1197,1186,66674,69362,7736,43314
8600000US43315,5592,2885,2707,56272,66513,7466,43315
8600000US43316,4471,2200,2271,57431,67640,6222,43316
8600000US43317,124,48,76,55417,53300,10997,43317
8600000US43318,3118,1586,1532,52967,64065,8456,43318
8600000US43319,774,419,355,70613,63134,12387,43319
8600000US43320,1293,684,609,51667,64906,14325,43320
8600000US43321,196,100,96,40250,43337,9702,43321
8600000US43322,285,143,142,37500,52562,12210,43322
8600000US43323,563,317,246,70147,69580,10063,43323
8600000US43324,2394,1186,1208,70286,86095,10071,43324
8600000US43326,10404,4844,5560,47141,56929,2943,43326
8600000US43330,81,40,41,52083,57066,17432,43330
8600000US43331,3792,1987,1805,40339,58819,8738,43331
8600000US43332,1350,640,710,49508,68165,17079,43332
8600000US43333,368,191,177,28594,46267,14927,43333
8600000US43334,4807,2510,2297,69665,96991,18283,43334
8600000US43336,0,0,0,,,,43336
8600000US43337,964,433,531,55625,66406,12880,43337
8600000US43338,7653,3709,3944,53271,67829,5130,43338
8600000US43340,1346,720,626,54762,62636,7306,43340
8600000US43341,792,410,382,54509,77607,29765,43341
8600000US43342,2165,999,1166,59858,69487,6239,43342
8600000US43343,810,431,379,60543,59320,10273,43343
8600000US43344,4479,2209,2270,61181,72052,5011,43344
8600000US43345,568,313,255,71161,79497,9986,43345
8600000US43347,1143,585,558,58571,64917,8892,43347
8600000US43348,1396,673,723,28264,60908,20125,43348
8600000US43351,7825,3628,4197,46770,64520,5768,43351
8600000US43356,1063,477,586,56106,71359,11297,43356
8600000US43357,3126,1457,1669,55714,74080,7650,43357
8600000US43358,2017,1036,981,75913,74741,9131,43358
8600000US43359,645,340,305,47917,62743,13629,43359
8600000US43360,1183,613,570,68158,72071,7187,43360
8600000US43402,27197,13256,13941,44008,63670,3194,43402
8600000US43403,5488,2440,3048,,,,43403
8600000US43406,1389,639,750,49940,54456,6782,43406
8600000US43407,540,253,287,58214,64602,12934,43407
8600000US43408,197,96,101,52813,59539,13727,43408
8600000US43410,7578,4037,3541,56615,65404,5557,43410
8600000US43412,3507,1809,1698,73361,89506,8031,43412
8600000US43413,1095,555,540,61335,64299,7047,43413
8600000US43416,2345,1219,1126,64191,75851,8530,43416
8600000US43420,23336,11095,12241,46759,59077,2995,43420
8600000US43430,3497,1714,1783,66181,76230,6849,43430
8600000US43431,3711,1817,1894,60759,65773,4229,43431
8600000US43432,1024,586,438,95464,94965,16685,43432
8600000US43433,61,16,45,46116,45194,3934,43433
8600000US43434,49,27,22,59167,69088,21110,43434
8600000US43435,1115,536,579,75893,82786,11454,43435
8600000US43437,391,201,190,64375,64296,9765,43437
8600000US43438,198,114,84,59219,74517,15370,43438
8600000US43439,53,44,9,31296,37000,9840,43439
8600000US43440,4244,2200,2044,52868,70905,5629,43440
8600000US43442,836,429,407,56382,62412,12058,43442
8600000US43443,1431,739,692,66762,76709,8849,43443
8600000US43445,1004,474,530,84219,89293,12802,43445
8600000US43446,80,37,43,52188,91428,23441,43446
8600000US43447,2739,1238,1501,59375,76638,8474,43447
8600000US43449,6382,3134,3248,53237,67722,4837,43449
8600000US43450,2852,1388,1464,64122,80101,9213,43450
8600000US43451,969,519,450,75625,79797,9589,43451
8600000US43452,11213,5214,5999,51839,75646,6422,43452
8600000US43456,262,150,112,66488,82572,19728,43456
8600000US43457,1187,562,625,51912,65078,8402,43457
8600000US43458,366,183,183,38036,57714,9199,43458
8600000US43460,4977,2584,2393,61326,76306,5780,43460
8600000US43462,935,510,425,40875,60004,10876,43462
8600000US43463,19,9,10,,,,43463
8600000US43464,958,420,538,70417,73166,16412,43464
8600000US43465,4260,1924,2336,49245,61205,5526,43465
8600000US43466,1630,801,829,60913,71918,8332,43466
8600000US43467,54,22,32,40625,51326,19706,43467
8600000US43468,359,184,175,65455,64377,14303,43468
8600000US43469,2179,1018,1161,66522,79838,8355,43469
8600000US43501,586,283,303,47841,49907,11192,43501
8600000US43502,4826,2395,2431,61615,82025,13054,43502
8600000US43504,1019,522,497,85136,106101,21738,43504
8600000US43505,46,21,25,35938,40616,12690,43505
8600000US43506,10785,5032,5753,44732,59311,4906,43506
8600000US43511,839,458,381,57386,66436,13229,43511
8600000US43512,21713,10816,10897,56546,71209,3545,43512
8600000US43515,6376,2996,3380,62778,74647,5482,43515
8600000US43516,2037,993,1044,53114,62036,5219,43516
8600000US43517,3131,1474,1657,52527,66836,6288,43517
8600000US43518,1878,959,919,60833,75311,10195,43518
8600000US43519,207,77,130,64602,150823,135137,43519
8600000US43521,2041,990,1051,50433,59547,6914,43521
8600000US43522,2539,1267,1272,70662,82955,8029,43522
8600000US43523,20,10,10,,,,43523
8600000US43524,1038,533,505,65469,68106,6487,43524
8600000US43525,793,384,409,83906,88668,6541,43525
8600000US43526,4461,2097,2364,58185,60804,4030,43526
8600000US43527,1509,753,756,57063,63226,5791,43527
8600000US43528,12499,6240,6259,76717,92176,5166,43528
8600000US43529,248,127,121,43750,54931,12347,43529
8600000US43531,269,121,148,18654,27332,12795,43531
8600000US43532,3077,1572,1505,69258,75238,6077,43532
8600000US43533,1311,705,606,56821,73559,9537,43533
8600000US43534,1263,645,618,61125,63228,6268,43534
8600000US43535,549,273,276,64643,71259,13568,43535
8600000US43536,146,69,77,67692,59025,14193,43536
8600000US43537,21235,10392,10843,75270,98803,7192,43537
8600000US43540,1033,488,545,56250,70466,9245,43540
8600000US43541,113,60,53,55000,68588,23399,43541
8600000US43542,2780,1453,1327,125375,116257,15870,43542
8600000US43543,6080,3140,2940,52296,60569,5698,43543
8600000US43545,10774,5177,5597,57646,72116,5539,43545
8600000US43547,170,87,83,85089,84275,18422,43547
8600000US43548,431,215,216,52115,57167,7280,43548
8600000US43549,956,501,455,54531,66414,9934,43549
8600000US43551,29590,14137,15453,80543,102442,5149,43551
8600000US43553,98,39,59,56875,50965,11956,43553
8600000US43554,1867,910,957,49725,58900,5829,43554
8600000US43555,217,113,104,62625,59059,21051,43555
8600000US43556,1354,630,724,56792,66376,8087,43556
8600000US43557,2716,1573,1143,56042,66331,4740,43557
8600000US43558,10180,5101,5079,65555,79180,8728,43558
8600000US43560,24584,11405,13179,85148,109165,5860,43560
8600000US43565,382,191,191,67813,68120,7226,43565
8600000US43566,6016,2933,3083,84606,96501,7923,43566
8600000US43567,10234,4851,5383,57617,69865,4488,43567
8600000US43569,2107,1061,1046,54224,67907,7027,43569
8600000US43570,2382,1164,1218,50000,60876,5324,43570
8600000US43571,5577,2737,2840,86406,112237,12242,43571
8600000US43604,6778,3441,3337,14260,29057,3183,43604
8600000US43605,18807,8745,10062,28788,35685,1727,43605
8600000US43606,20405,9310,11095,41820,69443,6036,43606
8600000US43607,16751,8073,8678,28130,39286,2622,43607
8600000US43608,10494,5358,5136,26469,39080,5710,43608
8600000US43609,15278,7731,7547,28721,37436,2683,43609
8600000US43610,3020,1389,1631,25753,41259,5182,43610
8600000US43611,14085,6752,7333,43078,55461,2746,43611
8600000US43612,21571,10183,11388,42761,50371,2151,43612
8600000US43613,25183,12205,12978,51466,60657,2134,43613
8600000US43614,25082,11218,13864,47232,63627,3435,43614
8600000US43615,31658,14708,16950,42272,63346,3300,43615
8600000US43616,16405,8276,8129,57897,72060,3141,43616
8600000US43617,5719,2789,2930,86009,122550,16509,43617
8600000US43619,5728,3035,2693,64688,80465,11267,43619
8600000US43620,4589,1963,2626,26193,43883,5763,43620
8600000US43623,15884,7172,8712,53750,74974,5459,43623
8600000US43701,43073,20084,22989,41898,56976,3759,43701
8600000US43711,62,23,39,40952,36214,9937,43711
8600000US43713,5278,2489,2789,46208,60663,6503,43713
8600000US43716,1524,742,782,37109,50609,7414,43716
8600000US43717,129,80,49,56667,60675,21016,43717
8600000US43718,2373,1147,1226,60583,82967,14207,43718
8600000US43719,2153,1099,1054,55179,69177,10794,43719
8600000US43720,949,448,501,54848,54520,8232,43720
8600000US43721,55,27,28,,,,43721
8600000US43722,233,99,134,33333,52102,18627,43722
8600000US43723,3827,1945,1882,37452,48060,4042,43723
8600000US43724,7844,5074,2770,52480,68716,14502,43724
8600000US43725,15286,7319,7967,39859,54619,3724,43725
8600000US43727,982,490,492,62109,66756,11382,43727
8600000US43728,1069,540,529,33224,43373,7767,43728
8600000US43730,1773,933,840,55078,57111,5747,43730
8600000US43731,4230,2080,2150,39006,53952,10799,43731
8600000US43732,1261,690,571,59464,66440,10233,43732
8600000US43733,0,0,0,,,,43733
8600000US43734,1296,589,707,54125,62841,13660,43734
8600000US43735,372,171,201,49674,56431,9194,43735
8600000US43736,31,11,20,36250,34529,9323,43736
8600000US43738,69,37,32,56250,48633,14683,43738
8600000US43739,1688,918,770,75833,91733,18718,43739
8600000US43740,202,88,114,54250,57324,7729,43740
8600000US43746,976,526,450,49041,56616,9588,43746
8600000US43747,711,417,294,36379,50744,13145,43747
8600000US43748,1988,977,1011,34663,50695,7154,43748
8600000US43749,1942,962,980,48789,56593,7659,43749
8600000US43750,106,65,41,,72084,38056,43750
8600000US43754,1287,611,676,47614,77339,22960,43754
8600000US43755,1452,719,733,49450,61101,7500,43755
8600000US43756,4036,1923,2113,39419,50840,4033,43756
8600000US43758,2446,1191,1255,39158,50758,8602,43758
8600000US43759,52,24,28,26250,24781,5001,43759
8600000US43760,1529,800,729,54330,60201,11312,43760
8600000US43761,49,23,26,,,,43761
8600000US43762,4661,2176,2485,60191,65841,6095,43762
8600000US43764,6601,3271,3330,42264,53913,6529,43764
8600000US43766,1109,533,576,47596,53391,9007,43766
8600000US43767,774,426,348,67356,68106,9865,43767
8600000US43768,347,118,229,34722,52940,19499,43768
8600000US43771,1384,727,657,51719,60369,8473,43771
8600000US43772,1498,877,621,55143,61026,8103,43772
8600000US43773,2695,1379,1316,51815,61953,8057,43773
8600000US43777,3651,1849,1802,39304,50183,6302,43777
8600000US43778,822,425,397,53000,66859,18321,43778
8600000US43779,700,388,312,42500,40407,7631,43779
8600000US43780,1392,722,670,47361,58703,7795,43780
8600000US43782,474,268,206,33571,43217,11905,43782
8600000US43783,3695,1828,1867,66855,68517,6969,43783
8600000US43786,29,19,10,21250,27669,9506,43786
8600000US43787,2395,1183,1212,43641,52942,6693,43787
8600000US43788,517,266,251,39821,77667,48363,43788
8600000US43793,3912,1895,2017,35706,52031,7222,43793
8600000US43802,729,377,352,53929,64225,12962,43802
8600000US43804,2360,1162,1198,60733,75747,11507,43804
8600000US43805,81,73,8,,,,43805
8600000US43811,640,343,297,48409,54942,10022,43811
8600000US43812,14602,7019,7583,40747,53104,3023,43812
8600000US43821,3297,1729,1568,57396,69531,8111,43821
8600000US43822,3723,1913,1810,47736,58366,6564,43822
8600000US43824,2786,1439,1347,55694,72582,8718,43824
8600000US43830,4430,2266,2164,59333,75746,9865,43830
8600000US43832,5399,2475,2924,46484,54586,4751,43832
8600000US43836,86,40,46,53125,59055,13905,43836
8600000US43837,1288,622,666,58542,60611,7489,43837
8600000US43840,1010,499,511,57022,75189,17022,43840
8600000US43842,273,97,176,31071,35733,9667,43842
8600000US43843,815,415,400,59405,56136,7601,43843
8600000US43844,2760,1373,1387,45583,55474,7316,43844
8600000US43845,3581,1630,1951,45800,51531,4040,43845
8600000US43901,1606,783,823,55598,70056,14565,43901
8600000US43902,55,27,28,,,,43902
8600000US43903,1625,795,830,46087,69250,10631,43903
8600000US43905,107,51,56,,43009,27431,43905
8600000US43906,6707,3108,3599,38692,58293,7164,43906
8600000US43907,4732,2338,2394,52050,68830,8612,43907
8600000US43908,1157,499,658,46875,61757,11138,43908
8600000US43910,2638,1243,1395,56563,84388,20939,43910
8600000US43912,5085,2526,2559,42331,55327,9139,43912
8600000US43913,1213,541,672,44063,56286,12253,43913
8600000US43914,194,130,64,58804,51434,10937,43914
8600000US43915,954,514,440,44032,54919,7568,43915
8600000US43917,2802,1371,1431,53447,79156,20135,43917
8600000US43920,17381,8218,9163,39417,52195,4005,43920
8600000US43925,202,157,45,,27444,25212,43925
8600000US43926,192,123,69,41875,50808,12352,43926
8600000US43927,104,39,65,45735,48212,19061,43927
8600000US43928,21,21,0,,,,43928
8600000US43930,586,331,255,52917,76602,24366,43930
8600000US43931,291,102,189,,80244,50822,43931
8600000US43932,709,378,331,58229,70231,22284,43932
8600000US43933,1509,708,801,44388,53640,6928,43933
8600000US43934,361,158,203,37071,48380,20355,43934
8600000US43935,7245,3536,3709,41690,55515,5333,43935
8600000US43938,4476,2239,2237,48011,64155,7965,43938
8600000US43939,343,169,174,58929,65198,10828,43939
8600000US43940,102,35,67,47344,34842,19320,43940
8600000US43942,2330,989,1341,43359,65604,10954,43942
8600000US43943,2525,1263,1262,45833,56876,5491,43943
8600000US43944,1790,910,880,62821,77675,9693,43944
8600000US43945,2328,1189,1139,37463,48195,6059,43945
8600000US43946,1645,814,831,50913,58657,6898,43946
8600000US43947,4390,2190,2200,55444,66848,6721,43947
8600000US43948,405,201,204,55573,73459,25396,43948
8600000US43950,14017,8308,5709,65533,79947,5053,43950
8600000US43951,53,37,16,83438,82422,4591,43951
8600000US43952,15076,6794,8282,34139,50441,3760,43952
8600000US43953,9515,4622,4893,49922,65581,7153,43953
8600000US43961,287,115,172,27222,38837,8234,43961
8600000US43962,70,30,40,,66841,26992,43962
8600000US43963,1122,501,621,33125,49147,5650,43963
8600000US43964,6822,3299,3523,42826,54372,4308,43964
8600000US43967,0,0,0,,,,43967
8600000US43968,4769,2413,2356,40015,51001,8926,43968
8600000US43970,65,26,39,,,,43970
8600000US43971,899,435,464,39076,52054,7442,43971
8600000US43972,115,46,69,64531,53849,14339,43972
8600000US43973,1812,947,865,45227,53803,6445,43973
8600000US43974,62,31,31,,74231,30217,43974
8600000US43976,1345,588,757,48690,61739,6329,43976
8600000US43977,1670,902,768,51750,60352,8332,43977
8600000US43983,417,257,160,72917,60244,9279,43983
8600000US43985,71,35,36,47188,62009,29166,43985
8600000US43986,1635,821,814,46875,52352,7494,43986
8600000US43988,1793,877,916,43939,55323,8483,43988
8600000US44001,17106,8058,9048,65328,77252,3550,44001
8600000US44003,3205,1664,1541,42883,50007,6728,44003
8600000US44004,24465,11131,13334,37933,50578,2429,44004
8600000US44010,1223,582,641,45492,59269,11965,44010
8600000US44011,15954,7737,8217,104125,124233,8722,44011
8600000US44012,17752,8300,9452,87525,114610,7456,44012
8600000US44017,15515,7393,8122,59170,72859,4375,44017
8600000US44021,4884,2402,2482,63387,80121,9188,44021
8600000US44022,12784,5938,6846,120454,204658,17828,44022
8600000US44023,13217,6559,6658,118462,157862,12522,44023
8600000US44024,18750,9204,9546,79894,103542,8251,44024
8600000US44026,8824,4363,4461,77305,98854,9782,44026
8600000US44028,7204,3565,3639,79691,101862,10568,44028
8600000US44030,13040,7220,5820,46705,55649,3309,44030
8600000US44032,1137,647,490,34033,48705,9915,44032
8600000US44035,49419,23668,25751,46110,58087,2042,44035
8600000US44039,24973,12098,12875,74247,89567,5941,44039
8600000US44040,2362,1136,1226,153971,230251,31238,44040
8600000US44041,11625,5951,5674,40431,56892,5002,44041
8600000US44044,13341,8634,4707,74480,92297,7475,44044
8600000US44045,385,178,207,64375,66582,10677,44045
8600000US44046,1770,849,921,56875,70162,15964,44046
8600000US44047,7079,3555,3524,55783,66638,6678,44047
8600000US44048,1814,756,1058,51469,59732,8177,44048
8600000US44049,185,87,98,58333,66572,12369,44049
8600000US44050,4790,2304,2486,71194,77562,5600,44050
8600000US44052,21237,9942,11295,34734,44879,2600,44052
8600000US44053,14959,6689,8270,47606,64188,6167,44053
8600000US44054,10022,4887,5135,64934,76455,3884,44054
8600000US44055,14763,6785,7978,31502,41895,2276,44055
8600000US44056,9358,4473,4885,92217,107719,9389,44056
8600000US44057,14874,7565,7309,63440,72072,3876,44057
8600000US44060,49028,23151,25877,69125,85108,2222,44060
8600000US44062,9050,4468,4582,54175,68816,6515,44062
8600000US44064,1333,724,609,77019,76884,8389,44064
8600000US44065,3699,1700,1999,74634,104218,23437,44065
8600000US44067,16615,8288,8327,76846,94037,5017,44067
8600000US44070,25642,12539,13103,63745,76945,2846,44070
8600000US44072,3614,1733,1881,92366,136488,20279,44072
8600000US44074,9817,4649,5168,58454,71956,5117,44074
8600000US44076,3491,1587,1904,48658,55827,5778,44076
8600000US44077,43106,20915,22191,63381,85264,4326,44077
8600000US44080,92,56,36,,54215,19003,44080
8600000US44081,5365,2612,2753,70518,85682,5814,44081
8600000US44082,1362,668,694,50500,62509,19816,44082
8600000US44084,2980,1614,1366,62438,78571,7743,44084
8600000US44085,2740,1579,1161,63523,72974,9461,44085
8600000US44086,2058,1023,1035,70130,78113,8723,44086
8600000US44087,15616,7007,8609,75976,90395,3984,44087
8600000US44089,12753,6232,6521,60521,80933,7526,44089
8600000US44090,9651,4854,4797,59722,69689,4829,44090
8600000US44092,13988,6925,7063,51982,67590,3732,44092
8600000US44093,983,505,478,81964,76778,8861,44093
8600000US44094,29049,13882,15167,66139,85518,3270,44094
8600000US44095,26700,12842,13858,55371,65708,2566,44095
8600000US44099,1623,786,837,47973,66351,17517,44099
8600000US44101,457,3,454,,,,44101
8600000US44102,34355,16826,17529,30538,46391,3629,44102
8600000US44103,12786,6325,6461,19540,32628,2505,44103
8600000US44104,12934,4947,7987,15813,24060,1850,44104
8600000US44105,27587,12523,15064,25750,35912,1339,44105
8600000US44106,22367,10391,11976,26310,56785,4946,44106
8600000US44107,41758,20190,21568,51405,69867,2092,44107
8600000US44108,16582,7444,9138,25119,44930,2907,44108
8600000US44109,30768,14967,15801,31555,43657,2290,44109
8600000US44110,14953,6461,8492,22344,32865,2493,44110
8600000US44111,33026,15970,17056,41944,55764,2918,44111
8600000US44112,17180,7659,9521,22586,35051,2779,44112
8600000US44113,17361,10312,7049,50293,76642,4884,44113
8600000US44114,6337,3683,2654,25757,50695,9111,44114
8600000US44115,5824,2657,3167,12800,35736,6584,44115
8600000US44116,16099,7291,8808,70096,112388,8453,44116
8600000US44117,8104,3368,4736,31243,45335,4443,44117
8600000US44118,30243,14309,15934,62622,90912,3444,44118
8600000US44119,10260,5169,5091,37863,54098,7706,44119
8600000US44120,26757,11969,14788,36728,65828,2917,44120
8600000US44121,25647,11163,14484,52312,64001,3242,44121
8600000US44122,25471,11064,14407,80475,133733,7266,44122
8600000US44123,12939,5647,7292,40583,49802,2374,44123
8600000US44124,30590,13468,17122,67451,101834,7578,44124
8600000US44125,21686,9534,12152,45474,57125,2831,44125
8600000US44126,13223,6473,6750,58004,80642,4427,44126
8600000US44127,3192,1515,1677,22521,31280,3047,44127
8600000US44128,22325,9170,13155,32411,43039,1632,44128
8600000US44129,22713,10915,11798,55740,66230,2928,44129
8600000US44130,40642,19269,21373,55182,65898,1821,44130
8600000US44131,16871,8133,8738,85625,102129,6263,44131
8600000US44132,11277,4879,6398,38031,47263,2431,44132
8600000US44133,24390,11800,12590,70212,94133,5531,44133
8600000US44134,30796,14887,15909,54113,64750,2214,44134
8600000US44135,21505,10200,11305,37582,50499,5306,44135
8600000US44136,20544,9849,10695,80148,103434,5999,44136
8600000US44137,17600,7906,9694,41058,48889,2358,44137
8600000US44138,17341,8067,9274,71365,88912,6602,44138
8600000US44139,17820,8346,9474,103821,136769,6865,44139
8600000US44140,11467,5626,5841,102917,137083,8405,44140
8600000US44141,10777,5158,5619,105398,123923,8522,44141
8600000US44142,14961,6988,7973,51547,61866,2241,44142
8600000US44143,20051,9351,10700,62196,88018,4041,44143
8600000US44144,17596,8782,8814,46873,55309,3044,44144
8600000US44145,25779,12423,13356,83434,115604,5803,44145
8600000US44146,24155,10526,13629,46523,57061,2685,44146
8600000US44147,15103,7175,7928,88750,119973,7926,44147
8600000US44149,14955,7162,7793,95304,116391,5410,44149
8600000US44201,5550,2694,2856,66964,83294,10111,44201
8600000US44202,15649,7431,8218,92633,117454,8752,44202
8600000US44203,31780,15256,16524,49555,60655,2402,44203
8600000US44212,34176,16516,17660,70818,83281,2622,44212
8600000US44214,1764,956,808,65563,72087,8247,44214
8600000US44215,1774,907,867,53750,66433,7271,44215
8600000US44216,7723,3732,3991,76500,83995,5096,44216
8600000US44217,2948,1411,1537,63451,65988,3427,44217
8600000US44221,23241,10999,12242,52921,59414,2106,44221
8600000US44223,14343,6874,7469,62233,78914,5333,44223
8600000US44224,31169,14873,16296,72122,87996,3909,44224
8600000US44230,6654,3165,3489,63182,78757,6906,44230
8600000US44231,7133,3611,3522,53259,66737,4495,44231
8600000US44233,6239,3340,2899,96250,130761,17385,44233
8600000US44234,3568,1765,1803,79621,96387,7399,44234
8600000US44235,1316,644,672,67153,76407,11753,44235
8600000US44236,18860,9349,9511,125450,161847,8337,44236
8600000US44240,32198,16065,16133,46715,66330,3447,44240
8600000US44241,13161,6309,6852,63836,72259,3931,44241
8600000US44243,4701,1811,2890,,,,44243
8600000US44250,1003,584,419,45095,45272,12082,44250
8600000US44251,755,396,359,94432,117741,14176,44251
8600000US44253,2621,1367,1254,92766,92706,8775,44253
8600000US44254,4020,1915,2105,48028,62962,8467,44254
8600000US44255,6728,3319,3409,53868,66611,4888,44255
8600000US44256,48135,23417,24718,78924,97757,3248,44256
8600000US44260,10567,5015,5552,65481,79020,7932,44260
8600000US44262,4206,1981,2225,66495,85717,7939,44262
8600000US44264,2316,1094,1222,78421,117207,16225,44264
8600000US44265,0,0,0,,,,44265
8600000US44266,27285,13281,14004,49389,64432,3028,44266
8600000US44270,6742,3371,3371,50066,59402,3809,44270
8600000US44272,4122,2073,2049,64706,74046,6447,44272
8600000US44273,5708,2800,2908,65306,82474,8145,44273
8600000US44274,191,44,147,,64515,65140,44274
8600000US44275,2676,1374,1302,75636,85969,10950,44275
8600000US44276,1323,674,649,73750,134103,49193,44276
8600000US44278,14323,6864,7459,69657,82143,4038,44278
8600000US44280,3833,1987,1846,83958,93067,11080,44280
8600000US44281,24311,11606,12705,73609,92010,4522,44281
8600000US44285,25,13,12,,,,44285
8600000US44286,4980,2427,2553,112794,170952,23975,44286
8600000US44287,5596,2779,2817,55786,67033,5460,44287
8600000US44288,2700,1338,1362,42007,49457,4194,44288
8600000US44301,11314,5570,5744,42936,52945,3740,44301
8600000US44302,4103,1951,2152,27577,39429,3508,44302
8600000US44303,6575,3124,3451,58007,86706,8215,44303
8600000US44304,4362,2247,2115,19336,36212,12282,44304
8600000US44305,17303,8154,9149,37644,47654,2977,44305
8600000US44306,14743,6616,8127,30703,39206,2342,44306
8600000US44307,4956,2074,2882,20063,29153,2828,44307
8600000US44308,896,567,329,11667,34624,14448,44308
8600000US44310,20810,10196,10614,36496,46814,3116,44310
8600000US44311,6906,3554,3352,21410,33880,8034,44311
8600000US44312,25136,11889,13247,49665,59716,2385,44312
8600000US44313,20346,9329,11017,58457,80586,5677,44313
8600000US44314,15019,7156,7863,35823,46793,4780,44314
8600000US44319,18675,9240,9435,64645,77256,3547,44319
8600000US44320,15529,6843,8686,32677,47895,3975,44320
8600000US44321,12181,6039,6142,90791,114839,8074,44321
8600000US44333,14917,7207,7710,84428,123613,11612,44333
8600000US44401,2395,1285,1110,57019,72436,9484,44401
8600000US44402,2610,1170,1440,62823,66285,5454,44402
8600000US44403,3226,1477,1749,55797,75958,11010,44403
8600000US44404,1114,462,652,72619,81287,13418,44404
8600000US44405,6010,2882,3128,30448,43760,6310,44405
8600000US44406,17520,8281,9239,76353,107355,9407,44406
8600000US44408,8004,3817,4187,53776,70095,6165,44408
8600000US44410,14125,7044,7081,61012,74998,6586,44410
8600000US44411,1711,815,896,58476,71286,8515,44411
8600000US44412,2115,1092,1023,61488,70225,6326,44412
8600000US44413,5664,2653,3011,46611,56966,4718,44413
8600000US44417,1277,663,614,44375,57530,9293,44417
8600000US44418,1300,653,647,60833,76720,13032,44418
8600000US44420,11745,5619,6126,41687,61665,5797,44420
8600000US44423,1975,899,1076,61719,66002,9619,44423
8600000US44425,11540,5730,5810,52475,66470,4233,44425
8600000US44427,1013,508,505,49219,73161,11745,44427
8600000US44428,2468,1212,1256,48719,63737,11603,44428
8600000US44429,2126,1039,1087,43984,62924,9069,44429
8600000US44430,4097,2623,1474,42773,51464,4901,44430
8600000US44431,3628,1812,1816,57096,69461,6493,44431
8600000US44432,11245,6820,4425,43276,59726,5993,44432
8600000US44436,3036,1548,1488,60488,73133,11066,44436
8600000US44437,3499,1562,1937,51058,58788,4407,44437
8600000US44438,3427,1625,1802,31367,43398,6022,44438
8600000US44439,144,87,57,,55137,34337,44439
8600000US44440,4131,1964,2167,56120,67577,6941,44440
8600000US44441,1332,630,702,55982,100453,45086,44441
8600000US44442,3095,1477,1618,55988,79687,14338,44442
8600000US44443,1196,576,620,78802,90087,19593,44443
8600000US44444,7785,3797,3988,49284,61127,6221,44444
8600000US44445,2865,1462,1403,53125,74211,10175,44445
8600000US44446,16194,7780,8414,42121,53967,3708,44446
8600000US44449,1007,555,452,59766,68849,11272,44449
8600000US44450,1371,692,679,58750,65897,7582,44450
8600000US44451,2413,1214,1199,53352,66348,6984,44451
8600000US44452,3037,1563,1474,63938,75731,10281,44452
8600000US44454,708,352,356,50862,66324,16420,44454
8600000US44455,1407,700,707,49194,61609,9905,44455
8600000US44460,20044,9785,10259,47844,68534,5943,44460
8600000US44470,3066,1504,1562,61895,70370,7583,44470
8600000US44471,8324,3918,4406,39657,52083,3555,44471
8600000US44473,2997,1490,1507,53980,67387,7423,44473
8600000US44481,7863,4133,3730,52041,64491,4924,44481
8600000US44483,19312,8633,10679,37478,51095,2876,44483
8600000US44484,17180,7900,9280,49991,73086,6900,44484
8600000US44485,12056,5759,6297,25271,34608,2718,44485
8600000US44490,744,373,371,38700,42534,6561,44490
8600000US44491,2124,1118,1006,61719,72419,7057,44491
8600000US44493,29,15,14,,,,44493
8600000US44502,7197,3434,3763,26606,32167,1840,44502
8600000US44503,1122,758,364,9570,13154,3399,44503
8600000US44504,4144,1881,2263,36097,57646,10904,44504
8600000US44505,14323,7119,7204,28348,45185,3918,44505
8600000US44506,2155,1108,1047,30036,38197,10187,44506
8600000US44507,3816,1942,1874,19300,29833,3401,44507
8600000US44509,8925,4102,4823,27521,45042,7062,44509
8600000US44510,1861,834,1027,17385,24151,4687,44510
8600000US44511,15969,7528,8441,40463,55831,4875,44511
8600000US44512,26743,12482,14261,53955,69472,2655,44512
8600000US44514,17618,8329,9289,67358,83426,5280,44514
8600000US44515,21463,10372,11091,46661,57178,3163,44515
8600000US44601,27267,13103,14164,44083,57065,2962,44601
8600000US44606,5145,2639,2506,60676,73565,7534,44606
8600000US44607,100,47,53,64688,65310,28738,44607
8600000US44608,1795,918,877,52443,78339,25174,44608
8600000US44609,3076,1397,1679,49338,64931,7626,44609
8600000US44610,160,66,94,60694,57686,11121,44610
8600000US44611,1605,808,797,63393,67905,11526,44611
8600000US44612,4385,2133,2252,72192,79992,5644,44612
8600000US44613,1546,722,824,44882,53730,5091,44613
8600000US44614,10006,4738,5268,67855,80859,5384,44614
8600000US44615,8260,3940,4320,53574,64933,4450,44615
8600000US44618,4853,2322,2531,60095,72467,4827,44618
8600000US44620,1498,741,757,65278,87008,16833,44620
8600000US44621,3313,1628,1685,44758,51504,3967,44621
8600000US44622,14084,6818,7266,52694,67707,4702,44622
8600000US44624,3479,1902,1577,63393,80901,9624,44624
8600000US44625,1340,736,604,62396,72091,12035,44625
8600000US44626,2385,1158,1227,72882,76401,6448,44626
8600000US44627,4058,1912,2146,62344,80879,10969,44627
8600000US44628,746,399,347,52368,69939,17824,44628
8600000US44629,1971,902,1069,49194,56797,5372,44629
8600000US44632,7676,3745,3931,64746,82186,7919,44632
8600000US44633,1948,1096,852,70599,94696,22047,44633
8600000US44634,1896,1019,877,71176,90027,24042,44634
8600000US44637,2274,1160,1114,38859,50145,7297,44637
8600000US44638,1050,601,449,41250,74263,31797,44638
8600000US44640,179,104,75,60000,64756,17520,44640
8600000US44641,16003,7675,8328,63481,71855,3267,44641
8600000US44643,2653,1329,1324,50625,67355,10105,44643
8600000US44644,3864,1945,1919,46641,77506,11702,44644
8600000US44645,1860,958,902,68182,81035,7839,44645
8600000US44646,36327,17717,18610,54946,72685,2710,44646
8600000US44647,14953,7234,7719,50966,61164,2983,44647
8600000US44651,483,266,217,52050,64137,22266,44651
8600000US44652,32,16,16,,,,44652
8600000US44653,522,217,305,44375,52968,8355,44653
8600000US44654,14386,6964,7422,62500,77970,5204,44654
8600000US44656,2379,1199,1180,64308,77782,8625,44656
8600000US44657,7538,3674,3864,52449,63286,5888,44657
8600000US44659,102,48,54,57000,56914,11554,44659
8600000US44661,106,55,51,42188,49809,9459,44661
8600000US44662,7717,3901,3816,59608,72589,5174,44662
8600000US44663,19446,9490,9956,46816,60262,3290,44663
8600000US44666,2076,1145,931,70662,80746,6395,44666
8600000US44667,10338,5160,5178,55676,70905,5588,44667
8600000US44669,1018,490,528,55313,66143,11736,44669
8600000US44670,124,63,61,54167,57910,7863,44670
8600000US44671,202,95,107,,49416,23547,44671
8600000US44672,3871,1845,2026,39444,55271,6842,44672
8600000US44675,1620,825,795,46875,55038,6223,44675
8600000US44676,3253,1554,1699,62653,69594,6871,44676
8600000US44677,1884,946,938,53156,65909,7353,44677
8600000US44678,264,132,132,97317,87562,24817,44678
8600000US44680,3499,1675,1824,61250,74707,9068,44680
8600000US44681,5300,2490,2810,59801,73407,6339,44681
8600000US44682,793,384,409,63333,65309,7975,44682
8600000US44683,6730,3351,3379,44225,52085,3742,44683
8600000US44685,20964,10448,10516,81070,94977,4830,44685
8600000US44687,275,130,145,,,,44687
8600000US44688,2355,1247,1108,56875,74144,24390,44688
8600000US44689,547,313,234,57404,69059,11505,44689
8600000US44690,213,104,109,95444,87865,29444,44690
8600000US44691,35920,17200,18720,53322,68571,3026,44691
8600000US44693,36,14,22,44063,44242,19289,44693
8600000US44695,1312,659,653,56510,64246,11410,44695
8600000US44697,172,85,87,43750,70241,21108,44697
8600000US44699,642,307,335,41964,53557,14695,44699
8600000US44702,938,556,382,10554,15734,3146,44702
8600000US44703,6021,2928,3093,27293,39337,3477,44703
8600000US44704,2590,1096,1494,19599,37842,12403,44704
8600000US44705,13903,6388,7515,31843,44624,4592,44705
8600000US44706,13604,6475,7129,46413,57050,2855,44706
8600000US44707,6395,2941,3454,25091,39181,5067,44707
8600000US44708,20344,9799,10545,52607,74499,4407,44708
8600000US44709,15796,7652,8144,47827,58856,3783,44709
8600000US44710,7090,3079,4011,40445,48314,5016,44710
8600000US44714,6982,3109,3873,39486,47935,3663,44714
8600000US44718,9644,4641,5003,69882,99858,10015,44718
8600000US44720,30341,14095,16246,66683,86724,4234,44720
8600000US44721,11388,5371,6017,75368,89935,6402,44721
8600000US44730,4665,2309,2356,51451,60325,3959,44730
8600000US44802,709,352,357,63417,76649,10752,44802
8600000US44804,771,395,376,52279,66525,8162,44804
8600000US44805,25458,12190,13268,51875,66105,3118,44805
8600000US44807,1679,872,807,59063,61600,4912,44807
8600000US44809,272,116,156,57688,62603,18546,44809
8600000US44811,9793,4790,5003,63137,68658,3525,44811
8600000US44813,6766,3264,3502,60919,67336,4314,44813
8600000US44814,2318,1182,1136,64632,87555,13296,44814
8600000US44815,501,251,250,52500,61173,9617,44815
8600000US44816,16,16,0,,,,44816
8600000US44817,1142,570,572,72250,79599,9013,44817
8600000US44818,1874,912,962,54427,65290,7469,44818
8600000US44820,13913,6738,7175,42092,56846,3919,44820
8600000US44822,2016,1037,979,55313,63200,7386,44822
8600000US44824,3079,1561,1518,53719,72282,9969,44824
8600000US44825,67,31,36,34125,34162,9148,44825
8600000US44826,1411,731,680,63906,70542,8880,44826
8600000US44827,5356,2711,2645,47357,60334,6375,44827
8600000US44828,61,24,37,,,,44828
8600000US44830,14049,6759,7290,40508,57643,5532,44830
8600000US44833,13065,6104,6961,41744,58259,7958,44833
8600000US44836,1832,939,893,53650,63232,6244,44836
8600000US44837,3188,1674,1514,53194,62721,5490,44837
8600000US44838,203,90,113,59583,69007,20659,44838
8600000US44839,10096,4836,5260,63193,93681,10573,44839
8600000US44840,1984,974,1010,70833,75225,6716,44840
8600000US44841,501,277,224,60125,94466,40860,44841
8600000US44842,4248,1919,2329,46667,60614,4926,44842
8600000US44843,1535,705,830,54821,66024,10771,44843
8600000US44844,375,200,175,48714,80612,39218,44844
8600000US44846,2721,1329,1392,75032,95803,13796,44846
8600000US44847,2592,1361,1231,63563,71819,7286,44847
8600000US44849,1890,932,958,60000,64517,6368,44849
8600000US44850,35,13,22,46071,46850,6311,44850
8600000US44851,3441,1777,1664,44046,63953,9926,44851
8600000US44853,1091,526,565,67000,73745,7279,44853
8600000US44854,1268,609,659,48148,62065,7036,44854
8600000US44855,947,501,446,42458,51094,6275,44855
8600000US44856,221,117,104,34063,38791,8938,44856
8600000US44857,17919,8450,9469,50609,64178,3418,44857
8600000US44859,1550,684,866,63654,61928,11789,44859
8600000US44861,65,22,43,,56029,43151,44861
8600000US44864,2973,1390,1583,59277,68925,5407,44864
8600000US44865,2463,1317,1146,51667,63662,7317,44865
8600000US44866,1370,706,664,49375,62129,16585,44866
8600000US44867,1966,970,996,70625,76733,8247,44867
8600000US44870,30902,14951,15951,42873,59283,2833,44870
8600000US44874,231,109,122,45000,53093,8793,44874
8600000US44875,10740,5045,5695,50061,60027,4269,44875
8600000US44878,2106,1054,1052,62552,75797,15613,44878
8600000US44880,2154,1135,1019,71579,77937,12476,44880
8600000US44881,0,0,0,,,,44881
8600000US44882,2236,1188,1048,61798,70701,6489,44882
8600000US44883,22567,10983,11584,48010,63567,4425,44883
8600000US44887,640,294,346,65739,86960,27403,44887
8600000US44889,5437,2645,2792,60602,72510,5608,44889
8600000US44890,8513,4210,4303,53125,64807,5397,44890
8600000US44901,2627,2627,0,,,,44901
8600000US44902,3456,1796,1660,23446,31426,4854,44902
8600000US44903,18429,9068,9361,51776,64364,4932,44903
8600000US44904,10328,4716,5612,60366,73178,6591,44904
8600000US44905,11111,6646,4465,43324,51840,3227,44905
8600000US44906,13363,6307,7056,43315,60911,4687,44906
8600000US44907,11915,5464,6451,40819,51129,3861,44907
8600000US45001,580,285,295,42264,57993,11158,45001
8600000US45002,10065,4894,5171,78222,98210,8506,45002
8600000US45003,395,190,205,49107,51888,6949,45003
8600000US45005,24603,12251,12352,59631,75559,6229,45005
8600000US45011,52514,25416,27098,66887,84237,2849,45011
8600000US45013,40995,19509,21486,59291,73108,2768,45013
8600000US45014,34236,16562,17674,60962,75359,3253,45014
8600000US45015,8773,4395,4378,43699,50374,3139,45015
8600000US45030,14562,7088,7474,63475,76041,3452,45030
8600000US45032,242,104,138,44643,56793,10730,45032
8600000US45033,192,92,100,,42944,15849,45033
8600000US45034,1030,604,426,90250,103252,22601,45034
8600000US45036,30122,17379,12743,75504,96579,4850,45036
8600000US45039,17789,8636,9153,92808,119224,8922,45039
8600000US45040,39552,18686,20866,99867,133649,7423,45040
8600000US45041,43,17,26,,,,45041
8600000US45042,20911,10404,10507,55883,70542,3355,45042
8600000US45044,39216,18820,20396,52007,74520,2725,45044
8600000US45050,6411,3055,3356,79375,94926,8527,45050
8600000US45051,174,0,174,,,,45051
8600000US45052,2979,1413,1566,82837,100200,9340,45052
8600000US45053,2617,1297,1320,98482,106248,13594,45053
8600000US45054,2292,1079,1213,73678,102012,18314,45054
8600000US45056,25562,11849,13713,41792,65349,5797,45056
8600000US45062,501,269,232,53750,68245,10910,45062
8600000US45064,2502,1294,1208,67396,75285,7540,45064
8600000US45065,3885,2012,1873,63571,107912,29019,45065
8600000US45066,17464,8268,9196,108867,123269,7550,45066
8600000US45067,10771,5286,5485,71214,78081,4393,45067
8600000US45068,8551,3974,4577,80865,105328,12428,45068
8600000US45069,38754,19016,19738,95106,117009,3709,45069
8600000US45070,123,64,59,35000,45885,12253,45070
8600000US45101,1823,837,986,31594,54224,15703,45101
8600000US45102,17406,8315,9091,62686,74695,5873,45102
8600000US45103,25092,12260,12832,63679,78903,3950,45103
8600000US45106,9461,4587,4874,57012,66875,7153,45106
8600000US45107,7457,3595,3862,59303,71645,6699,45107
8600000US45111,261,105,156,75000,85648,19983,45111
8600000US45112,73,31,42,,86631,27411,45112
8600000US45113,2695,1327,1368,68081,78878,8808,45113
8600000US45115,110,69,41,,141099,83775,45115
8600000US45118,2863,1482,1381,62219,74339,11589,45118
8600000US45120,2198,1188,1010,50885,58874,8500,45120
8600000US45121,7021,3517,3504,51772,60888,6159,45121
8600000US45122,8026,4156,3870,53032,68857,6918,45122
8600000US45123,6800,3333,3467,42730,49464,4176,45123
8600000US45130,3262,1711,1551,54188,61371,6339,45130
8600000US45131,166,74,92,35882,47069,9841,45131
8600000US45132,267,137,130,38472,41923,7126,45132
8600000US45133,17981,8653,9328,41387,56276,4113,45133
8600000US45135,3691,1797,1894,64453,72564,10766,45135
8600000US45140,42202,21167,21035,90248,116350,3882,45140
8600000US45142,2715,1211,1504,50500,65002,15070,45142
8600000US45144,3229,1537,1692,30335,51505,9492,45144
8600000US45145,19,9,10,,,,45145
8600000US45146,1045,567,478,61964,68468,9184,45146
8600000US45147,154,57,97,49267,52339,10714,45147
8600000US45148,1068,620,448,46755,59902,9484,45148
8600000US45150,24726,11752,12974,64580,84147,4579,45150
8600000US45152,8502,4106,4396,73482,93018,7036,45152
8600000US45153,1486,747,739,52891,67513,11890,45153
8600000US45154,6522,3156,3366,58802,65950,5638,45154
8600000US45155,267,136,131,35625,45681,10870,45155
8600000US45156,70,38,32,34583,64493,38396,45156
8600000US45157,7596,3795,3801,62232,82641,5729,45157
8600000US45158,295,154,141,52292,59131,11691,45158
8600000US45159,2604,1302,1302,56800,70240,11893,45159
8600000US45160,713,361,352,27688,39853,8235,45160
8600000US45162,2154,1058,1096,85294,87266,9519,45162
8600000US45164,180,84,96,39063,50669,17059,45164
8600000US45166,38,24,14,48235,47587,18601,45166
8600000US45167,2989,1461,1528,46250,58568,6165,45167
8600000US45168,1275,649,626,48214,54115,7080,45168
8600000US45169,3545,1694,1851,51607,60445,8638,45169
8600000US45171,4387,2094,2293,55575,75617,11274,45171
8600000US45172,149,68,81,,50510,16388,45172
8600000US45174,1556,774,782,163958,220573,23703,45174
8600000US45176,7248,3597,3651,58979,67903,5441,45176
8600000US45177,17464,8602,8862,48809,69734,6514,45177
8600000US45202,12140,6680,5460,63502,99888,5377,45202
8600000US45203,1936,761,1175,17005,35778,5272,45203
8600000US45204,4539,2333,2206,33132,45470,5479,45204
8600000US45205,12592,6475,6117,28724,39337,2289,45205
8600000US45206,9123,4339,4784,35662,66170,6343,45206
8600000US45207,5728,2520,3208,27355,42617,7283,45207
8600000US45208,14742,6761,7981,95438,147670,11694,45208
8600000US45209,9912,4841,5071,67431,85610,5852,45209
8600000US45211,27877,13291,14586,42024,54689,2785,45211
8600000US45212,18344,9180,9164,44770,61815,3484,45212
8600000US45213,9879,4940,4939,56782,72259,4555,45213
8600000US45214,5520,2546,2974,21142,30397,2208,45214
8600000US45215,23186,10596,12590,51570,80776,7960,45215
8600000US45216,6727,3314,3413,33359,44954,3631,45216
8600000US45217,5282,2309,2973,45125,64006,6837,45217
8600000US45218,2901,1265,1636,63920,72381,7820,45218
8600000US45219,16775,9410,7365,26939,36252,2415,45219
8600000US45220,12161,5941,6220,41359,71066,6717,45220
8600000US45223,8964,4308,4656,40947,54459,3463,45223
8600000US45224,16850,7108,9742,47184,61156,3430,45224
8600000US45225,5886,2508,3378,13614,22662,1968,45225
8600000US45226,4350,2065,2285,85056,133792,17982,45226
8600000US45227,14527,6598,7929,52996,76334,5344,45227
8600000US45229,9794,4396,5398,20874,40480,4800,45229
8600000US45230,20941,9983,10958,69198,90517,5147,45230
8600000US45231,30206,13356,16850,53863,66033,3235,45231
8600000US45232,3838,1269,2569,16341,30725,4064,45232
8600000US45233,12706,5960,6746,79789,97428,5625,45233
8600000US45236,19627,9385,10242,60722,80496,5133,45236
8600000US45237,15622,6870,8752,35239,51864,3786,45237
8600000US45238,34351,15946,18405,50147,64372,2771,45238
8600000US45239,22439,10077,12362,51492,61509,3415,45239
8600000US45240,19837,9393,10444,59281,71766,5272,45240
8600000US45241,19481,9959,9522,83568,105928,5029,45241
8600000US45242,16977,7951,9026,96545,137923,8549,45242
8600000US45243,11292,5388,5904,132980,193720,19604,45243
8600000US45244,20719,10198,10521,90468,121424,5434,45244
8600000US45245,16527,7689,8838,63841,85111,6837,45245
8600000US45246,10647,4989,5658,56086,80119,7129,45246
8600000US45247,18244,8949,9295,71790,94812,4587,45247
8600000US45248,19004,9028,9976,74694,93382,4488,45248
8600000US45249,9897,4972,4925,81212,121925,10025,45249
8600000US45251,17164,7957,9207,62691,75663,4750,45251
8600000US45252,3731,1937,1794,74792,109336,10151,45252
8600000US45255,16505,7765,8740,73061,101533,5302,45255
8600000US45301,74,29,45,,,,45301
8600000US45302,2958,1583,1375,83333,95591,9848,45302
8600000US45303,1877,979,898,61432,64234,6408,45303
8600000US45304,5455,2672,2783,63723,73685,4730,45304
8600000US45305,8387,4134,4253,91794,110978,7949,45305
8600000US45306,1777,953,824,62292,76958,6540,45306
8600000US45307,243,119,124,37500,43413,9265,45307
8600000US45308,3205,1620,1585,56296,68700,5508,45308
8600000US45309,9780,4630,5150,56896,75590,7156,45309
8600000US45310,198,105,93,66827,101694,42801,45310
8600000US45311,4798,2294,2504,56992,70812,5900,45311
8600000US45312,1145,531,614,76705,85022,12812,45312
8600000US45314,5283,2489,2794,61339,92108,13865,45314
8600000US45315,3137,1623,1514,81676,87782,9101,45315
8600000US45316,90,48,42,60417,64389,20059,45316
8600000US45317,804,346,458,65219,62049,10314,45317
8600000US45318,4140,2108,2032,52136,65229,5994,45318
8600000US45319,290,141,149,61563,73727,11057,45319
8600000US45320,11530,5500,6030,51672,65284,4578,45320
8600000US45321,676,321,355,53672,65569,11495,45321
8600000US45322,16418,7814,8604,64695,76412,4684,45322
8600000US45323,4011,1975,2036,60432,79113,11371,45323
8600000US45324,33559,16269,17290,49569,61857,2101,45324
8600000US45325,1831,832,999,62222,73067,8726,45325
8600000US45326,717,342,375,73125,78619,13225,45326
8600000US45327,6959,3355,3604,64771,77773,6090,45327
8600000US45328,409,219,190,40500,47596,5734,45328
8600000US45330,677,362,315,62981,73991,12690,45330
8600000US45331,17561,8337,9224,44566,57553,3061,45331
8600000US45332,577,303,274,43864,73755,27827,45332
8600000US45333,1052,632,420,83971,76645,12576,45333
8600000US45334,1595,781,814,57936,66278,6989,45334
8600000US45335,5319,2562,2757,61926,74852,8213,45335
8600000US45336,125,61,64,64464,72252,16462,45336
8600000US45337,1483,767,716,64861,75309,10450,45337
8600000US45338,3859,1927,1932,61840,71034,5353,45338
8600000US45339,1077,588,489,56480,67000,9823,45339
8600000US45340,484,256,228,62250,68692,9363,45340
8600000US45341,2962,1440,1522,45093,51590,4101,45341
8600000US45342,28356,13634,14722,60478,76880,5028,45342
8600000US45344,11951,5802,6149,51013,68610,5648,45344
8600000US45345,4830,2217,2613,51613,61681,7344,45345
8600000US45346,1523,769,754,55887,66596,9048,45346
8600000US45347,3457,1581,1876,49625,64393,7543,45347
8600000US45348,728,359,369,51625,62565,10934,45348
8600000US45349,285,144,141,65804,66944,11697,45349
8600000US45350,66,35,31,82500,92400,21607,45350
8600000US45351,158,84,74,71250,71637,12469,45351
8600000US45352,165,73,92,40000,56027,18052,45352
8600000US45353,121,55,66,53594,53224,10932,45353
8600000US45354,370,187,183,45417,50253,6335,45354
8600000US45356,19548,9388,10160,48720,58269,2373,45356
8600000US45358,264,121,143,56875,76959,24331,45358
8600000US45359,1474,763,711,59500,67017,6119,45359
8600000US45360,329,184,145,32039,50651,22049,45360
8600000US45361,256,142,114,55833,55236,7078,45361
8600000US45362,877,474,403,55676,64485,8392,45362
8600000US45363,1198,664,534,79000,97427,21410,45363
8600000US45365,22602,10858,11744,56513,70526,4219,45365
8600000US45368,3714,1849,1865,50313,65808,4831,45368
8600000US45369,2725,1336,1389,55417,76643,8707,45369
8600000US45370,1880,903,977,78875,100165,15468,45370
8600000US45371,15267,7463,7804,71945,90000,5667,45371
8600000US45372,254,122,132,46528,57858,7979,45372
8600000US45373,27263,13144,14119,59233,77255,4158,45373
8600000US45377,12319,5933,6386,58516,72731,3987,45377
8600000US45378,278,142,136,47411,56734,7526,45378
8600000US45380,3831,1845,1986,69362,85537,8150,45380
8600000US45381,4212,2155,2057,56506,65845,4217,45381
8600000US45382,917,494,423,57619,76391,26617,45382
8600000US45383,5562,2709,2853,50238,60810,6408,45383
8600000US45384,1908,894,1014,63929,74480,32816,45384
8600000US45385,30145,14147,15998,54266,74078,3437,45385
8600000US45387,4469,2199,2270,76786,92740,9490,45387
8600000US45388,539,276,263,95689,114258,33648,45388
8600000US45389,374,188,186,51944,52068,6169,45389
8600000US45390,2331,1198,1133,41067,51072,4736,45390
8600000US45402,7986,4068,3918,26894,42502,5478,45402
8600000US45403,10580,5256,5324,27381,36301,2109,45403
8600000US45404,7574,3619,3955,33500,39486,3883,45404
8600000US45405,13233,6067,7166,28079,39937,2992,45405
8600000US45406,15133,6809,8324,27590,40394,3342,45406
8600000US45409,14415,7582,6833,63810,82669,8438,45409
8600000US45410,12501,6327,6174,35612,45282,3070,45410
8600000US45414,15612,7091,8521,41316,61310,4111,45414
8600000US45415,10460,5058,5402,60867,73836,5481,45415
8600000US45416,4950,1976,2974,45022,56281,6731,45416
8600000US45417,22161,9568,12593,25550,35062,1511,45417
8600000US45418,1349,624,725,60750,67900,7305,45418
8600000US45419,11280,5269,6011,75462,105644,6692,45419
8600000US45420,19666,9618,10048,40940,51678,3127,45420
8600000US45424,38426,18371,20055,64071,74648,2440,45424
8600000US45426,12056,5115,6941,33417,46136,3487,45426
8600000US45428,335,325,10,,,,45428
8600000US45429,20746,9792,10954,64461,87782,4910,45429
8600000US45430,5666,2785,2881,92831,103844,8804,45430
8600000US45431,21937,10572,11365,63263,82274,5012,45431
8600000US45432,11760,5707,6053,60304,74459,4416,45432
8600000US45433,1992,1298,694,82875,106992,20877,45433
8600000US45434,9163,4570,4593,106638,118832,8255,45434
8600000US45439,7735,3743,3992,46094,56727,5280,45439
8600000US45440,16230,7825,8405,71950,92604,5548,45440
8600000US45449,14041,6623,7418,44651,52667,2038,45449
8600000US45458,23945,11206,12739,86056,113438,6227,45458
8600000US45459,22120,10176,11944,72292,99620,4479,45459
8600000US45502,12625,6205,6420,69804,83106,3771,45502
8600000US45503,25488,11871,13617,46227,58892,2888,45503
8600000US45504,14012,6675,7337,52435,70497,5320,45504
8600000US45505,15151,7079,8072,32980,45249,2239,45505
8600000US45506,10001,4626,5375,39798,50986,3464,45506
8600000US45601,45012,24306,20706,47427,62385,2684,45601
8600000US45612,3696,1831,1865,42500,46808,4358,45612
8600000US45613,2266,1080,1186,46278,57378,7022,45613
8600000US45614,3575,1617,1958,37267,52720,7582,45614
8600000US45616,1109,611,498,25938,35857,7494,45616
8600000US45617,197,54,143,,,,45617
8600000US45618,8,6,2,,,,45618
8600000US45619,5981,2823,3158,54795,72191,21857,45619
8600000US45620,740,382,358,38438,52989,7916,45620
8600000US45621,265,98,167,42609,47161,18341,45621
8600000US45622,119,28,91,,53357,30656,45622
8600000US45623,2342,1105,1237,43854,51336,5181,45623
8600000US45624,0,0,0,,,,45624
8600000US45628,3865,1848,2017,58068,67064,7507,45628
8600000US45629,2364,1246,1118,38493,53154,8202,45629
8600000US45630,80,63,17,36520,40107,8014,45630
8600000US45631,11637,5691,5946,44019,61113,4779,45631
8600000US45634,1381,742,639,34205,42762,7099,45634
8600000US45636,100,60,40,,106395,106804,45636
8600000US45638,16738,8168,8570,38591,52089,3426,45638
8600000US45640,12407,6257,6150,46104,53468,3615,45640
8600000US45642,0,0,0,,,,45642
8600000US45644,3807,1950,1857,74433,85316,14250,45644
8600000US45645,1932,947,985,43864,57208,12971,45645
8600000US45646,408,232,176,36563,47426,21293,45646
8600000US45647,2090,1158,932,52500,53581,7477,45647
8600000US45648,10476,5823,4653,40245,56774,4341,45648
8600000US45650,356,212,144,,48544,18918,45650
8600000US45651,4540,2263,2277,44081,56759,5088,45651
8600000US45652,2704,1375,1329,44619,71348,18930,45652
8600000US45653,3018,1432,1586,62778,75190,11453,45653
8600000US45654,904,452,452,48837,51846,8437,45654
8600000US45656,5128,2461,2667,46263,52711,3822,45656
8600000US45657,1569,813,756,36705,45755,8629,45657
8600000US45658,2091,1041,1050,43831,47735,6518,45658
8600000US45659,2093,990,1103,35833,55587,12169,45659
8600000US45660,5579,2806,2773,38015,49900,5354,45660
8600000US45661,5222,2448,2774,38177,51582,7289,45661
8600000US45662,23692,10881,12811,32133,48624,3793,45662
8600000US45663,4757,2244,2513,37361,48462,5950,45663
8600000US45669,8141,3872,4269,52224,62104,4214,45669
8600000US45671,259,142,117,45250,57846,16541,45671
8600000US45672,1118,520,598,54647,66226,19194,45672
8600000US45673,238,130,108,,39855,15203,45673
8600000US45674,572,321,251,27829,39468,12982,45674
8600000US45678,612,278,334,46602,60036,23533,45678
8600000US45679,1954,963,991,34915,60841,8826,45679
8600000US45680,9905,4782,5123,42370,58617,6950,45680
8600000US45681,1347,635,712,50385,80174,47747,45681
8600000US45682,1619,894,725,34028,50070,8505,45682
8600000US45684,1668,812,856,50378,70764,12047,45684
8600000US45685,796,388,408,40729,55422,13451,45685
8600000US45686,2814,1280,1534,39893,48512,5727,45686
8600000US45688,446,212,234,42731,47558,10051,45688
8600000US45690,11599,5561,6038,52786,64276,5152,45690
8600000US45692,6154,2772,3382,42905,57827,9177,45692
8600000US45693,6618,3205,3413,37310,56588,9642,45693
8600000US45694,8844,4027,4817,51658,73735,9809,45694
8600000US45695,505,268,237,37188,38372,7084,45695
8600000US45696,1268,543,725,35658,47223,9794,45696
8600000US45697,3850,1944,1906,57500,63588,7414,45697
8600000US45698,233,98,135,26458,36857,11206,45698
8600000US45701,31788,15868,15920,36848,57954,3737,45701
8600000US45710,4380,2188,2192,52019,60947,5184,45710
8600000US45711,995,497,498,48750,56662,9374,45711
8600000US45714,7751,3745,4006,44222,60699,9343,45714
8600000US45715,1758,836,922,41042,72717,24869,45715
8600000US45716,404,198,206,38214,59490,15948,45716
8600000US45719,817,400,417,28480,43570,12502,45719
8600000US45721,34,20,14,,,,45721
8600000US45723,2936,1470,1466,48929,63220,8307,45723
8600000US45724,1789,967,822,52348,56231,9155,45724
8600000US45727,355,202,153,35581,37958,6066,45727
8600000US45729,1036,528,508,77656,86326,14890,45729
8600000US45732,3397,1694,1703,37219,45935,3856,45732
8600000US45734,399,148,251,30536,44327,19633,45734
8600000US45735,1224,636,588,48143,73570,20883,45735
8600000US45740,325,144,181,35179,43267,19596,45740
8600000US45741,503,216,287,17288,35336,6783,45741
8600000US45742,2371,1166,1205,70804,89913,20323,45742
8600000US45743,1412,680,732,50526,63919,9859,45743
8600000US45744,2140,992,1148,48382,54823,8206,45744
8600000US45745,1134,540,594,62927,65083,12659,45745
8600000US45746,366,207,159,49107,47585,10105,45746
8600000US45750,21843,10583,11260,44609,65401,4152,45750
8600000US45760,2931,1421,1510,32692,52524,7271,45760
8600000US45761,1393,762,631,38542,58454,15088,45761
8600000US45764,7889,4137,3752,36014,51206,4218,45764
8600000US45766,833,390,443,26957,40036,11875,45766
8600000US45767,1843,894,949,45035,59307,10160,45767
8600000US45768,1234,638,596,51454,53150,8778,45768
8600000US45769,5446,2633,2813,41320,51888,4748,45769
8600000US45770,506,331,175,27778,47123,16174,45770
8600000US45771,2621,1298,1323,49291,72973,18938,45771
8600000US45772,1344,636,708,46844,57311,9513,45772
8600000US45773,43,14,29,,,,45773
8600000US45775,1011,465,546,51346,99762,47617,45775
8600000US45776,542,259,283,46319,57769,10960,45776
8600000US45778,515,198,317,33403,38447,13158,45778
8600000US45779,601,314,287,60950,70103,11675,45779
8600000US45780,2490,1135,1355,32969,57135,15980,45780
8600000US45782,367,183,184,20250,30587,7880,45782
8600000US45784,2635,1345,1290,52279,62298,9147,45784
8600000US45786,2622,1300,1322,63284,76785,9490,45786
8600000US45787,50,13,37,,88362,84965,45787
8600000US45788,956,520,436,55000,67072,12893,45788
8600000US45789,150,74,76,,,,45789
8600000US45801,17106,9108,7998,40898,53306,5311,45801
8600000US45804,11544,5543,6001,32660,41528,2329,45804
8600000US45805,18273,9425,8848,51603,64632,3077,45805
8600000US45806,8550,3999,4551,63387,86486,10390,45806
8600000US45807,9819,4922,4897,64142,75453,4362,45807
8600000US45808,264,131,133,53750,70036,21519,45808
8600000US45809,103,53,50,71118,72164,16397,45809
8600000US45810,6781,3486,3295,56250,65308,5619,45810
8600000US45812,1478,695,783,38839,55035,10339,45812
8600000US45813,2820,1409,1411,58385,77469,17424,45813
8600000US45814,2232,1095,1137,61724,73779,8401,45814
8600000US45816,275,150,125,55208,56223,8307,45816
8600000US45817,5414,2635,2779,71061,82067,7299,45817
8600000US45819,181,76,105,51944,63109,11503,45819
8600000US45820,324,147,177,46563,71247,24951,45820
8600000US45821,955,508,447,51679,54191,6311,45821
8600000US45822,14642,7410,7232,52255,67914,4285,45822
8600000US45826,335,168,167,68542,73624,9826,45826
8600000US45827,1587,819,768,78077,85344,8245,45827
8600000US45828,4478,2052,2426,60527,69335,5885,45828
8600000US45830,4240,2107,2133,55917,65299,3684,45830
8600000US45831,2439,1229,1210,52427,67771,7709,45831
8600000US45832,2200,1133,1067,64006,84121,16671,45832
8600000US45833,8206,4044,4162,58469,72311,6283,45833
8600000US45835,387,189,198,57857,69025,14402,45835
8600000US45836,1010,518,492,47206,55332,4870,45836
8600000US45838,38,22,16,,27959,10877,45838
8600000US45840,43838,21323,22515,54232,73141,3107,45840
8600000US45841,635,347,288,66705,68335,9446,45841
8600000US45843,2904,1449,1455,55357,66736,5890,45843
8600000US45844,2407,1253,1154,63750,77896,7862,45844
8600000US45845,2177,1134,1043,68295,92492,13813,45845
8600000US45846,2857,1511,1346,69231,79383,7447,45846
8600000US45849,791,363,428,55000,60337,7756,45849
8600000US45850,2567,1373,1194,58240,68404,7640,45850
8600000US45851,519,270,249,56250,60599,9011,45851
8600000US45853,1005,504,501,79500,109153,31513,45853
8600000US45854,341,161,180,44286,57375,7571,45854
8600000US45855,125,66,59,48750,70161,17218,45855
8600000US45856,3702,1874,1828,53939,70405,5657,45856
8600000US45858,2167,1129,1038,57353,70801,8383,45858
8600000US45859,395,203,192,41250,53111,7060,45859
8600000US45860,1735,925,810,79833,78304,7642,45860
8600000US45861,148,80,68,46964,50276,11299,45861
8600000US45862,1092,558,534,45729,84424,36703,45862
8600000US45863,983,471,512,59500,63670,6285,45863
8600000US45864,143,59,84,65750,63462,11217,45864
8600000US45865,3709,1767,1942,75573,88156,4436,45865
8600000US45866,115,61,54,42500,50162,10270,45866
8600000US45867,835,454,381,66976,68714,5854,45867
8600000US45868,505,282,223,67778,72277,6732,45868
8600000US45869,3426,1744,1682,75667,91756,7395,45869
8600000US45870,151,64,87,60500,76777,25858,45870
8600000US45871,1472,727,745,66458,77373,6827,45871
8600000US45872,3074,1523,1551,50000,60610,5728,45872
8600000US45873,1617,839,778,55417,61650,6850,45873
8600000US45874,1852,961,891,62984,74916,10200,45874
8600000US45875,8467,4006,4461,64715,80795,5749,45875
8600000US45876,538,275,263,60260,76849,11800,45876
8600000US45877,1638,841,797,65469,80793,9764,45877
8600000US45879,4511,2104,2407,44669,57362,4538,45879
8600000US45880,2062,1030,1032,64868,66062,5516,45880
8600000US45881,956,460,496,79300,93440,21154,45881
8600000US45882,2235,1008,1227,53846,66208,6253,45882
8600000US45883,2575,1295,1280,82179,102664,14583,45883
8600000US45884,107,71,36,,261667,375278,45884
8600000US45885,9826,4880,4946,57005,66469,3747,45885
8600000US45886,386,204,182,57708,67466,11450,45886
8600000US45887,3092,1402,1690,50451,63267,8131,45887
8600000US45888,153,82,71,55625,75028,20587,45888
8600000US45889,1069,518,551,94750,97670,17128,45889
8600000US45890,389,191,198,52917,69427,7975,45890
8600000US45891,11401,5397,6004,47915,58208,3141,45891
8600000US45894,520,233,287,62368,64394,14333,45894
8600000US45895,13650,6881,6769,61231,70496,3540,45895
8600000US45896,1433,713,720,61121,71782,6972,45896
8600000US45897,36,11,25,,,,45897
8600000US45898,701,328,373,50000,71612,21762,45898
8600000US45899,103,40,63,40000,57119,13435,45899
8600000US46001,7845,3722,4123,54913,62411,4448,46001
8600000US46011,13799,6464,7335,58000,68617,3392,46011
8600000US46012,16078,7469,8609,44487,57429,3907,46012
8600000US46013,13118,5946,7172,40673,50458,3263,46013
8600000US46016,13470,6771,6699,28340,36785,2740,46016
8600000US46017,4682,2302,2380,51402,59658,5007,46017
8600000US46030,2288,1090,1198,53654,73467,10389,46030
8600000US46031,1847,918,929,76131,90631,15015,46031
8600000US46032,36551,16985,19566,102143,154364,8352,46032
8600000US46033,27584,13241,14343,132432,160797,8132,46033
8600000US46034,5277,2655,2622,72451,83299,8988,46034
8600000US46035,802,395,407,57500,74805,15562,46035
8600000US46036,9215,4743,4472,46189,62849,6340,46036
8600000US46037,29640,14055,15585,113910,142476,9424,46037
8600000US46038,30796,14966,15830,90289,107419,5362,46038
8600000US46039,465,237,228,65125,61741,11587,46039
8600000US46040,8084,3960,4124,91023,126268,20363,46040
8600000US46041,16634,8168,8466,49926,61584,3932,46041
8600000US46044,2263,1046,1217,54770,65553,5422,46044
8600000US46045,78,43,35,55227,64123,29843,46045
8600000US46047,87,50,37,,,,46047
8600000US46048,1438,669,769,51850,57655,5751,46048
8600000US46049,778,384,394,51316,72998,13386,46049
8600000US46050,1575,709,866,63636,71863,7567,46050
8600000US46051,2157,981,1176,52955,70741,9682,46051
8600000US46052,17491,8417,9074,59917,79703,7078,46052
8600000US46055,8472,4155,4317,104033,136293,20175,46055
8600000US46056,1850,863,987,70754,87773,11320,46056
8600000US46057,931,488,443,67704,69861,9593,46057
8600000US46058,1775,903,872,73013,85757,9833,46058
8600000US46060,28871,14152,14719,73936,87517,5054,46060
8600000US46062,25543,12226,13317,85037,109053,6824,46062
8600000US46063,360,189,171,44688,52574,8197,46063
8600000US46064,13624,8263,5361,79802,92722,6152,46064
8600000US46065,2472,1212,1260,61902,68449,5274,46065
8600000US46068,2268,1103,1165,64826,72413,5128,46068
8600000US46069,5759,3126,2633,55360,80947,14651,46069
8600000US46070,1685,861,824,64688,81832,14133,46070
8600000US46071,2747,1359,1388,67222,80043,6741,46071
8600000US46072,6730,3275,3455,55074,70206,6611,46072
8600000US46074,22477,10881,11596,98643,119003,7081,46074
8600000US46075,4566,2231,2335,79183,96118,18827,46075
8600000US46076,1246,658,588,49107,62045,7692,46076
8600000US46077,19515,9445,10070,134644,173712,12504,46077
8600000US46103,162,76,86,63125,65183,12920,46103
8600000US46104,703,392,311,65724,66183,14656,46104
8600000US46105,1464,798,666,76250,70185,8394,46105
8600000US46106,4758,2394,2364,85496,121206,18386,46106
8600000US46107,10022,4491,5531,42370,55499,3728,46107
8600000US46110,438,216,222,55625,71141,32664,46110
8600000US46111,162,88,74,36250,41050,5814,46111
8600000US46112,27589,13870,13719,80394,95708,5115,46112
8600000US46113,11392,5714,5678,72430,78547,4813,46113
8600000US46115,1463,713,750,53221,61675,8636,46115
8600000US46117,436,219,217,85069,91743,23492,46117
8600000US46118,3786,1932,1854,68654,86056,9788,46118
8600000US46120,3913,1999,1914,61605,67756,5350,46120
8600000US46121,4651,2321,2330,64464,85005,12296,46121
8600000US46122,12077,5836,6241,77766,90136,8289,46122
8600000US46123,26287,12699,13588,90960,105929,7718,46123
8600000US46124,6703,3611,3092,52917,61740,5149,46124
8600000US46125,5,5,0,,,,46125
8600000US46126,3926,2062,1864,67730,74840,8796,46126
8600000US46127,183,119,64,,91654,47492,46127
8600000US46128,1642,874,768,65833,63303,6092,46128
8600000US46130,1954,1053,901,83206,91355,10427,46130
8600000US46131,24436,11814,12622,60988,76765,4101,46131
8600000US46133,605,324,281,61420,59849,10384,46133
8600000US46135,17268,9215,8053,51956,65334,4956,46135
8600000US46140,30630,14406,16224,62523,74882,3848,46140
8600000US46142,22845,10897,11948,72999,92305,5557,46142
8600000US46143,41017,19385,21632,70944,88505,4523,46143
8600000US46144,135,96,39,55982,55636,10275,46144
8600000US46146,179,67,112,75881,78559,14379,46146
8600000US46147,2304,1173,1131,67396,81896,8000,46147
8600000US46148,4103,2066,2037,56266,62996,5122,46148
8600000US46149,1462,724,738,69375,75847,9986,46149
8600000US46150,701,405,296,56528,68402,13243,46150
8600000US46151,24496,12025,12471,59727,73087,3337,46151
8600000US46155,130,88,42,52311,55544,6079,46155
8600000US46156,1234,621,613,50417,78948,33788,46156
8600000US46157,2956,1570,1386,76926,89283,7899,46157
8600000US46158,17500,8336,9164,63167,77405,4201,46158
8600000US46160,5282,2725,2557,58000,75429,9930,46160
8600000US46161,2308,1118,1190,75438,76047,7657,46161
8600000US46162,386,218,168,38413,58358,22386,46162
8600000US46163,9640,4648,4992,90330,105270,6999,46163
8600000US46164,3622,1807,1815,76000,92415,11080,46164
8600000US46165,1231,650,581,62201,80427,13844,46165
8600000US46166,1628,832,796,69167,72165,10137,46166
8600000US46167,4903,2361,2542,80350,103932,10906,46167
8600000US46168,26576,13687,12889,67157,81972,3127,46168
8600000US46171,1290,688,602,47152,56793,7323,46171
8600000US46172,1775,936,839,55577,70373,9050,46172
8600000US46173,7982,3790,4192,46073,59505,4306,46173
8600000US46175,448,242,206,51875,52417,11731,46175
8600000US46176,21185,10144,11041,55641,67199,2818,46176
8600000US46180,722,347,375,51932,65676,8593,46180
8600000US46181,3620,1871,1749,73090,92136,11386,46181
8600000US46182,1209,596,613,54063,69160,10520,46182
8600000US46183,15,0,15,,,,46183
8600000US46184,10155,4858,5297,67913,78823,8049,46184
8600000US46186,1378,703,675,69750,75418,11104,46186
8600000US46201,22364,10935,11429,29313,39147,1994,46201
8600000US46202,18368,9532,8836,41123,63064,4130,46202
8600000US46203,28592,13877,14715,37598,51066,2714,46203
8600000US46204,7712,4861,2851,49214,79244,10761,46204
8600000US46205,21726,10421,11305,46157,72891,4577,46205
8600000US46208,18485,8049,10436,34083,65843,5068,46208
8600000US46214,18554,8650,9904,47790,61764,3928,46214
8600000US46216,1867,868,999,41546,71250,19283,46216
8600000US46217,24819,11496,13323,62083,77682,5316,46217
8600000US46218,21167,9721,11446,24993,38606,7295,46218
8600000US46219,28555,13575,14980,39772,53037,2358,46219
8600000US46220,29875,14440,15435,68725,99887,6408,46220
8600000US46221,19808,10034,9774,47768,55004,2793,46221
8600000US46222,25090,12333,12757,33064,42118,3647,46222
8600000US46224,26550,12946,13604,36063,45309,2388,46224
8600000US46225,5095,2611,2484,34962,44857,3933,46225
8600000US46226,33511,14807,18704,34734,45335,1833,46226
8600000US46227,43899,20920,22979,40625,54045,2921,46227
8600000US46228,11667,5350,6317,65524,85694,6812,46228
8600000US46229,21208,9489,11719,47903,59186,3977,46229
8600000US46231,7304,3566,3738,63488,85894,24343,46231
8600000US46234,20088,9524,10564,75371,91103,5176,46234
8600000US46235,21583,9391,12192,36166,46433,2803,46235
8600000US46236,21299,10331,10968,82848,110708,7248,46236
8600000US46237,29058,14107,14951,64723,77259,3228,46237
8600000US46239,20721,9822,10899,72884,81683,3554,46239
8600000US46240,16509,7240,9269,58982,93882,6277,46240
8600000US46241,21617,10281,11336,38102,49368,3968,46241
8600000US46250,15628,7347,8281,56487,78141,4550,46250
8600000US46254,29276,12502,16774,45138,58231,2847,46254
8600000US46256,19304,9163,10141,66804,95212,5765,46256
8600000US46259,8090,4003,4087,104130,109033,8204,46259
8600000US46260,24301,10918,13383,47919,83529,5042,46260
8600000US46268,19277,8793,10484,52149,65423,4156,46268
8600000US46278,6626,3232,3394,109891,153088,19613,46278
8600000US46280,5798,2838,2960,62119,72703,6899,46280
8600000US46290,190,103,87,,294700,210241,46290
8600000US46301,562,277,285,68250,125587,40759,46301
8600000US46303,10979,5460,5519,68259,88917,12191,46303
8600000US46304,19295,9351,9944,77655,94752,5648,46304
8600000US46307,48505,23866,24639,82259,92526,3069,46307
8600000US46310,10451,5159,5292,60463,66511,4257,46310
8600000US46311,16947,8205,8742,85754,103423,5997,46311
8600000US46312,20406,9401,11005,31907,43339,2310,46312
8600000US46319,14007,6874,7133,60531,71439,2934,46319
8600000US46320,9830,4472,5358,30439,47350,6892,46320
8600000US46321,18073,8870,9203,81234,105394,5642,46321
8600000US46322,17974,8618,9356,63699,76254,2943,46322
8600000US46323,16555,8180,8375,49565,59460,4096,46323
8600000US46324,16144,7868,8276,46158,57339,2952,46324
8600000US46327,8450,4141,4309,45921,54381,4554,46327
8600000US46340,574,245,329,60694,78210,14080,46340
8600000US46341,7622,3623,3999,71641,81625,6635,46341
8600000US46342,23429,10994,12435,58250,67898,2552,46342
8600000US46345,144,88,56,50938,54421,14277,46345
8600000US46346,1016,500,516,40938,50283,5741,46346
8600000US46347,3648,1767,1881,76094,89558,8088,46347
8600000US46348,867,389,478,47232,65434,8941,46348
8600000US46349,2351,1243,1108,60972,65801,11163,46349
8600000US46350,32768,15835,16933,52462,68852,2924,46350
8600000US46356,13229,6629,6600,74053,82804,4738,46356
8600000US46360,33929,17131,16798,43816,59145,2035,46360
8600000US46365,753,387,366,58603,72286,20564,46365
8600000US46366,4339,2104,2235,48561,56501,4188,46366
8600000US46368,29973,14162,15811,54775,67233,3263,46368
8600000US46371,2482,1250,1232,78253,83046,13672,46371
8600000US46373,11490,5594,5896,103232,124023,12675,46373
8600000US46374,699,330,369,80104,137388,81322,46374
8600000US46375,18898,9065,9833,72690,95864,6493,46375
8600000US46376,203,91,112,46750,56604,12834,46376
8600000US46377,200,81,119,,51604,30678,46377
8600000US46379,134,112,22,,60434,17158,46379
8600000US46381,92,52,40,38542,38841,23057,46381
8600000US46382,1341,622,719,78750,85433,8285,46382
8600000US46383,33167,16390,16777,62333,80589,4274,46383
8600000US46385,29877,14744,15133,77430,97535,5590,46385
8600000US46390,2463,1189,1274,73029,80982,7305,46390
8600000US46391,8824,6723,2101,68063,85358,10858,46391
8600000US46392,6165,3038,3127,64145,75132,6927,46392
8600000US46393,297,219,78,58333,57665,16257,46393
8600000US46394,9868,4835,5033,49239,59709,3494,46394
8600000US46402,4710,1965,2745,18504,32431,5032,46402
8600000US46403,10449,4739,5710,38496,53724,4727,46403
8600000US46404,12262,4898,7364,31909,44656,4764,46404
8600000US46405,8351,4217,4134,40859,49733,4005,46405
8600000US46406,7160,3213,3947,29933,44054,5976,46406
8600000US46407,8364,3693,4671,22008,30918,2408,46407
8600000US46408,12083,5593,6490,36662,46081,3363,46408
8600000US46409,5781,2766,3015,28808,37476,3337,46409
8600000US46410,29225,13545,15680,56799,66330,3383,46410
8600000US46501,2515,1271,1244,54318,62653,6944,46501
8600000US46502,22,11,11,,,,46502
8600000US46504,2631,1244,1387,54650,64913,6198,46504
8600000US46506,7266,3568,3698,63958,69738,5320,46506
8600000US46507,6715,3382,3333,67583,88810,7535,46507
8600000US46508,112,51,61,38750,41188,9828,46508
8600000US46510,3030,1558,1472,51094,62584,5160,46510
8600000US46511,3296,1619,1677,52570,83981,16205,46511
8600000US46514,31541,14832,16709,52535,65726,3068,46514
8600000US46516,22712,11290,11422,46761,58892,3325,46516
8600000US46517,18741,8987,9754,49618,57034,3225,46517
8600000US46524,1628,815,813,49006,61765,11492,46524
8600000US46526,23719,11585,12134,54187,66083,3017,46526
8600000US46528,18751,9748,9003,63537,83609,6702,46528
8600000US46530,22785,11078,11707,101526,133414,7156,46530
8600000US46531,1288,627,661,53636,60098,8095,46531
8600000US46532,1317,619,698,54107,64382,9354,46532
8600000US46534,8579,4173,4406,48676,57812,4093,46534
8600000US46536,2410,1138,1272,55833,69540,7735,46536
8600000US46537,385,207,178,55250,57858,10914,46537
8600000US46538,2845,1400,1445,72574,94262,11971,46538
8600000US46539,1903,938,965,52143,63956,6443,46539
8600000US46540,8371,4223,4148,76986,90664,6671,46540
8600000US46542,3112,1590,1522,59623,62992,6647,46542
8600000US46543,1958,1037,921,78480,95265,17078,46543
8600000US46544,24036,11457,12579,47778,59927,3384,46544
8600000US46545,20171,9422,10749,42577,55054,2683,46545
8600000US46550,9052,4409,4643,58005,73873,6284,46550
8600000US46552,5289,2694,2595,61016,85154,21841,46552
8600000US46553,2230,1023,1207,62829,69778,7405,46553
8600000US46554,3809,1855,1954,58073,67091,5067,46554
8600000US46555,2180,1140,1040,50417,63637,7424,46555
8600000US46556,7194,3425,3769,25208,24269,6281,46556
8600000US46561,9704,4540,5164,74298,78690,4197,46561
8600000US46562,3982,1923,2059,54048,69426,8068,46562
8600000US46563,17959,8805,9154,51687,63775,2961,46563
8600000US46565,5582,2700,2882,68690,81950,7954,46565
8600000US46567,6730,3374,3356,57399,80327,6507,46567
8600000US46570,790,383,407,47740,57908,11845,46570
8600000US46571,2993,1473,1520,62857,81997,13868,46571
8600000US46573,2816,1418,1398,63750,84344,11227,46573
8600000US46574,7268,3599,3669,58368,70522,6683,46574
8600000US46580,16534,8231,8303,56429,75356,5736,46580
8600000US46582,9899,4845,5054,64122,76901,5394,46582
8600000US46590,3916,1882,2034,63157,78537,7421,46590
8600000US46595,67,16,51,58393,54145,15860,46595
8600000US46601,4583,2477,2106,18711,28323,2532,46601
8600000US46613,8071,3831,4240,38828,45283,3576,46613
8600000US46614,23660,11282,12378,51933,71308,4231,46614
8600000US46615,9737,4570,5167,41069,53501,3416,46615
8600000US46616,4084,2097,1987,40644,53007,3749,46616
8600000US46617,7097,3461,3636,59525,98034,11804,46617
8600000US46619,15295,7176,8119,39143,48025,3115,46619
8600000US46628,19574,9210,10364,42103,62753,4428,46628
8600000US46635,5389,2420,2969,52621,69417,8096,46635
8600000US46637,12716,6157,6559,56109,68433,5167,46637
8600000US46701,6523,3401,3122,57011,63319,4730,46701
8600000US46702,1646,898,748,58592,61710,5744,46702
8600000US46703,14595,7389,7206,55176,69708,4416,46703
8600000US46704,28,10,18,,,,46704
8600000US46705,1256,662,594,53500,66893,15974,46705
8600000US46706,14134,6944,7190,54368,70763,4948,46706
8600000US46710,3224,1499,1725,68500,82336,13013,46710
8600000US46711,5239,2466,2773,48408,62263,6329,46711
8600000US46714,11011,5330,5681,50000,63463,3563,46714
8600000US46721,3716,1924,1792,59783,70863,5541,46721
8600000US46723,6004,3002,3002,62561,82452,9445,46723
8600000US46725,17993,8766,9227,61564,71825,3012,46725
8600000US46730,823,416,407,62386,70257,17631,46730
8600000US46731,495,222,273,45868,65973,26653,46731
8600000US46732,2331,1141,1190,55508,61980,6623,46732
8600000US46733,13848,6729,7119,53204,62781,4175,46733
8600000US46737,6111,3015,3096,58488,72812,4935,46737
8600000US46738,6289,3004,3285,44086,58351,5842,46738
8600000US46740,2773,1354,1419,46714,59006,7529,46740
8600000US46741,3028,1486,1542,59069,74616,8207,46741
8600000US46742,2756,1415,1341,62284,77199,8237,46742
8600000US46743,1583,841,742,58056,67514,8723,46743
8600000US46745,1637,831,806,55993,66009,6646,46745
8600000US46746,3701,1962,1739,53047,66840,9113,46746
8600000US46747,2030,1034,996,48542,60907,6805,46747
8600000US46748,3518,1721,1797,90688,108113,14184,46748
8600000US46750,20812,10089,10723,49788,60052,2056,46750
8600000US46755,11547,5617,5930,48977,58598,3254,46755
8600000US46759,277,119,158,49554,48653,8076,46759
8600000US46760,1005,538,467,51528,60671,7479,46760
8600000US46761,7816,3697,4119,53820,65228,4102,46761
8600000US46763,1283,632,651,62417,73515,12168,46763
8600000US46764,1101,573,528,62929,66653,6920,46764
8600000US46765,3915,1992,1923,92232,98362,10073,46765
8600000US46766,707,412,295,65491,76628,21779,46766
8600000US46767,5608,2705,2903,54775,72045,10189,46767
8600000US46770,2266,1095,1171,62156,69058,6423,46770
8600000US46771,0,0,0,,,,46771
8600000US46772,1873,1001,872,51638,66444,10801,46772
8600000US46773,2607,1308,1299,62143,71760,4777,46773
8600000US46774,13030,6328,6702,55613,64590,2887,46774
8600000US46776,1077,609,468,54038,63413,9939,46776
8600000US46777,4759,2274,2485,68056,73842,6262,46777
8600000US46779,1561,798,763,57315,63768,6610,46779
8600000US46781,650,350,300,62500,65831,7080,46781
8600000US46783,4875,2395,2480,81667,112137,12096,46783
8600000US46784,1539,741,798,56488,77789,11420,46784
8600000US46785,1129,520,609,63534,75072,15118,46785
8600000US46786,41,13,28,,,,46786
8600000US46787,2806,1399,1407,54291,68180,6545,46787
8600000US46788,2288,1246,1042,66471,100061,28356,46788
8600000US46791,837,389,448,64833,89547,34250,46791
8600000US46792,2976,1416,1560,57500,69874,7293,46792
8600000US46793,3436,1636,1800,57389,67131,8118,46793
8600000US46794,1345,711,634,49909,71689,26235,46794
8600000US46795,5231,2779,2452,65794,80595,7022,46795
8600000US46797,2611,1340,1271,66456,71189,6441,46797
8600000US46798,1210,570,640,61250,75687,13054,46798
8600000US46799,173,95,78,38375,42491,6410,46799
8600000US46802,8104,4741,3363,34658,44830,3002,46802
8600000US46803,6468,3230,3238,22023,30596,2443,46803
8600000US46804,22236,10378,11858,69605,93985,6544,46804
8600000US46805,16209,7519,8690,43056,53460,2703,46805
8600000US46806,17211,7573,9638,28490,38377,2274,46806
8600000US46807,12144,5792,6352,47127,56040,3178,46807
8600000US46808,14714,7354,7360,39563,51993,3836,46808
8600000US46809,6721,3216,3505,38855,49765,2935,46809
8600000US46814,8773,4145,4628,119432,176008,18063,46814
8600000US46815,21332,9500,11832,54746,69372,4032,46815
8600000US46816,13335,5994,7341,35632,48983,4765,46816
8600000US46818,15343,7801,7542,59766,72486,3925,46818
8600000US46819,7491,3419,4072,47974,57812,4074,46819
8600000US46825,23288,11591,11697,55086,67200,3811,46825
8600000US46835,26670,12926,13744,61052,75089,3230,46835
8600000US46845,16485,8034,8451,93060,115310,7785,46845
8600000US46901,31073,15225,15848,46503,60421,2661,46901
8600000US46902,27326,12534,14792,50685,62577,2418,46902
8600000US46910,2513,1255,1258,56477,68624,8487,46910
8600000US46911,998,486,512,54450,67332,10171,46911
8600000US46913,953,514,439,62639,80538,13385,46913
8600000US46914,1284,733,551,60156,71222,12553,46914
8600000US46915,477,220,257,53750,60027,7004,46915
8600000US46917,1240,630,610,48563,60088,7352,46917
8600000US46919,1931,902,1029,52380,64614,8889,46919
8600000US46920,834,422,412,64875,76588,12622,46920
8600000US46922,18,7,11,,,,46922
8600000US46923,6357,3099,3258,55250,73752,6217,46923
8600000US46926,1212,668,544,56029,63643,8956,46926
8600000US46928,3411,1680,1731,47332,58646,5495,46928
8600000US46929,2168,1059,1109,50160,56953,3943,46929
8600000US46930,70,33,37,53750,57107,13785,46930
8600000US46931,128,67,61,37813,42933,11479,46931
8600000US46932,2536,1251,1285,52847,62357,4800,46932
8600000US46933,4656,2279,2377,42822,48436,4746,46933
8600000US46936,4558,2160,2398,67029,80426,6432,46936
8600000US46938,2305,1061,1244,48333,54295,4533,46938
8600000US46939,1398,774,624,38438,53389,5632,46939
8600000US46940,2117,1059,1058,62337,68409,7286,46940
8600000US46941,784,397,387,54922,64572,9815,46941
8600000US46943,156,53,103,34800,53542,22797,46943
8600000US46946,24,8,16,,,,46946
8600000US46947,21476,10671,10805,45249,57828,3146,46947
8600000US46950,465,220,245,50708,53094,7841,46950
8600000US46951,1528,801,727,47222,61762,9266,46951
8600000US46952,14882,6778,8104,45037,57831,3615,46952
8600000US46953,19051,9070,9981,33120,45094,2479,46953
8600000US46957,480,222,258,39196,42080,6502,46957
8600000US46958,529,327,202,58594,59657,13488,46958
8600000US46959,519,292,227,23544,37574,18713,46959
8600000US46960,845,447,398,50129,76819,28537,46960
8600000US46961,107,43,64,31979,42687,16166,46961
8600000US46962,7333,3439,3894,52197,58447,3903,46962
8600000US46967,83,43,40,38500,38742,12627,46967
8600000US46968,23,6,17,,,,46968
8600000US46970,18470,9887,8583,43115,55756,3687,46970
8600000US46974,1375,731,644,61121,64076,6804,46974
8600000US46975,11134,5262,5872,50026,62357,5452,46975
8600000US46978,1487,718,769,57083,64854,7296,46978
8600000US46979,3614,1903,1711,80284,99006,7372,46979
8600000US46982,1821,845,976,49623,60417,8506,46982
8600000US46984,159,70,89,61389,65169,22524,46984
8600000US46985,1108,583,525,49013,56034,7978,46985
8600000US46986,1200,574,626,47321,59764,7296,46986
8600000US46987,749,385,364,56850,62100,5843,46987
8600000US46988,729,359,370,44219,73972,42674,46988
8600000US46989,4009,1797,2212,68214,82339,10925,46989
8600000US46990,486,228,258,54728,72089,18204,46990
8600000US46991,1302,659,643,58281,61113,5443,46991
8600000US46992,12917,6201,6716,48315,59954,4505,46992
8600000US46994,2189,1107,1082,51546,68698,7312,46994
8600000US46996,4965,2476,2489,43478,55428,3623,46996
8600000US46998,160,73,87,47344,47588,11902,46998
8600000US47001,8302,4067,4235,56445,73547,5995,47001
8600000US47003,730,351,379,35221,40422,5774,47003
8600000US47006,8730,4249,4481,61588,80239,7610,47006
8600000US47010,204,82,122,23667,37553,17491,47010
8600000US47011,585,381,204,58789,78560,24304,47011
8600000US47012,7729,3840,3889,52879,65968,5348,47012
8600000US47016,719,361,358,78828,87173,20218,47016
8600000US47017,371,165,206,68750,70819,11618,47017
8600000US47018,3246,1590,1656,65438,69040,5082,47018
8600000US47020,854,446,408,44750,56918,12217,47020
8600000US47022,2362,1179,1183,68964,83427,10368,47022
8600000US47023,1254,630,624,58083,69348,9972,47023
8600000US47024,2423,1178,1245,52315,55435,5806,47024
8600000US47025,17348,8390,8958,66241,78389,3892,47025
8600000US47030,1582,770,812,67386,86912,36881,47030
8600000US47031,4218,2061,2157,56154,69267,8814,47031
8600000US47032,2367,1406,961,59512,78654,12111,47032
8600000US47034,80,33,47,28500,37125,14989,47034
8600000US47035,200,109,91,,33522,27218,47035
8600000US47036,739,317,422,96667,102109,14909,47036
8600000US47037,3399,1657,1742,54265,59636,5077,47037
8600000US47038,1207,552,655,46693,51935,10000,47038
8600000US47040,4012,2059,1953,52967,62618,5137,47040
8600000US47041,4936,2500,2436,68030,74555,5608,47041
8600000US47042,3303,1647,1656,55660,66262,8022,47042
8600000US47043,4333,2147,2186,49676,60631,7277,47043
8600000US47060,4590,2312,2278,74394,87729,10331,47060
8600000US47102,5316,2675,2641,35174,46227,5167,47102
8600000US47104,38,20,18,,,,47104
8600000US47106,3534,1772,1762,64215,80377,13237,47106
8600000US47108,1583,799,784,45975,59079,9431,47108
8600000US47110,584,194,390,66458,67280,12134,47110
8600000US47111,12403,5916,6487,60898,73918,5628,47111
8600000US47112,12442,6253,6189,59250,73978,5272,47112
8600000US47114,177,97,80,51484,60025,14226,47114
8600000US47115,2360,1047,1313,45260,68356,13067,47115
8600000US47116,485,303,182,49375,51003,11053,47116
8600000US47117,3290,1764,1526,60223,65062,6826,47117
8600000US47118,2392,1183,1209,42614,55811,13073,47118
8600000US47119,8735,4309,4426,92647,127648,12863,47119
8600000US47120,607,243,364,56917,55385,17656,47120
8600000US47122,7853,3761,4092,73375,89965,5088,47122
8600000US47123,80,37,43,29345,38995,22697,47123
8600000US47124,3446,1702,1744,76793,88886,7105,47124
8600000US47125,1202,596,606,49293,62343,11462,47125
8600000US47126,3765,2152,1613,70556,83420,8725,47126
8600000US47129,15776,7076,8700,40549,51154,3961,47129
8600000US47130,36061,16915,19146,54728,68858,3134,47130
8600000US47135,957,484,473,72226,83162,15227,47135
8600000US47136,3581,1713,1868,69534,81864,8052,47136
8600000US47137,1311,662,649,36131,46356,7780,47137
8600000US47138,3700,1834,1866,63673,69262,6173,47138
8600000US47140,2035,993,1042,38510,44422,4003,47140
8600000US47141,1225,596,629,58818,81185,25311,47141
8600000US47142,785,357,428,52704,57618,10386,47142
8600000US47143,2298,1212,1086,77331,99288,18351,47143
8600000US47145,1588,868,720,55375,61132,7384,47145
8600000US47147,737,420,317,48214,62921,14033,47147
8600000US47150,37685,17838,19847,52077,66160,2688,47150
8600000US47160,81,44,37,,51597,22994,47160
8600000US47161,2502,1414,1088,59844,70006,9748,47161
8600000US47162,556,197,359,52700,58097,12836,47162
8600000US47163,1178,655,523,62534,79412,29252,47163
8600000US47164,3231,1621,1610,46875,59354,8603,47164
8600000US47165,4977,2466,2511,51753,64731,6541,47165
8600000US47166,1306,621,685,44159,60345,12629,47166
8600000US47167,11423,5645,5778,43731,56960,4509,47167
8600000US47170,11712,5654,6058,47380,61538,4367,47170
8600000US47172,13045,6655,6390,77362,89896,4681,47172
8600000US47175,635,266,369,39479,54710,13023,47175
8600000US47177,862,455,407,51875,57564,11899,47177
8600000US47201,33509,17172,16337,58605,75742,3036,47201
8600000US47203,20751,9828,10923,59337,80484,4564,47203
8600000US47220,4475,2142,2333,53250,65252,7677,47220
8600000US47223,944,458,486,56591,67152,15638,47223
8600000US47224,464,219,245,45136,45486,15030,47224
8600000US47226,211,150,61,67708,172922,86187,47226
8600000US47227,1693,860,833,58105,63720,8405,47227
8600000US47229,2277,1147,1130,46840,64431,9124,47229
8600000US47230,1218,614,604,50446,57835,6614,47230
8600000US47231,606,346,260,50000,63476,11975,47231
8600000US47232,2578,1389,1189,58766,60486,5904,47232
8600000US47234,1235,604,631,59115,71479,8650,47234
8600000US47235,1064,591,473,62629,57203,10313,47235
8600000US47240,16206,8036,8170,56228,68298,3610,47240
8600000US47243,4764,2444,2320,51921,60522,4662,47243
8600000US47244,534,269,265,49659,61135,12198,47244
8600000US47246,3349,1641,1708,63315,73085,6246,47246
8600000US47247,152,74,78,78750,68158,16450,47247
8600000US47250,17440,7832,9608,48827,65788,6611,47250
8600000US47260,1366,740,626,41196,53757,7573,47260
8600000US47263,180,73,107,45625,51123,8132,47263
8600000US47264,1093,554,539,54079,66728,15813,47264
8600000US47265,15666,7883,7783,47747,59151,3258,47265
8600000US47270,334,165,169,59250,62415,12729,47270
8600000US47272,1593,792,801,47969,61573,8558,47272
8600000US47273,1277,640,637,53750,59823,9601,47273
8600000US47274,23243,11217,12026,49644,62472,3174,47274
8600000US47280,673,295,378,75395,65191,18207,47280
8600000US47281,919,516,403,64013,75116,12179,47281
8600000US47282,254,109,145,34732,60151,20713,47282
8600000US47283,2549,1229,1320,45300,59467,7236,47283
8600000US47302,20754,9649,11105,35593,47866,2712,47302
8600000US47303,21408,10122,11286,33587,48096,3449,47303
8600000US47304,25866,12756,13110,53598,70772,5705,47304
8600000US47305,2778,1469,1309,25057,34922,3841,47305
8600000US47306,4976,1789,3187,,,,47306
8600000US47320,2897,1296,1601,53241,66254,7727,47320
8600000US47324,125,45,80,31500,39024,11926,47324
8600000US47325,458,198,260,63333,60845,18380,47325
8600000US47326,1409,707,702,57697,64727,9306,47326
8600000US47327,3543,1682,1861,39482,53567,5231,47327
8600000US47330,4159,2012,2147,57066,75506,10293,47330
8600000US47331,17489,8565,8924,42741,55492,3232,47331
8600000US47334,2589,1298,1291,59167,74775,9236,47334
8600000US47335,533,247,286,37857,52026,8047,47335
8600000US47336,2375,1146,1229,39143,55091,6909,47336
8600000US47337,132,76,56,47857,45221,10077,47337
8600000US47338,1969,946,1023,52024,56108,5314,47338
8600000US47339,412,224,188,38438,51425,13044,47339
8600000US47340,2116,1102,1014,50694,61015,6244,47340
8600000US47341,1737,886,851,60000,79633,14260,47341
8600000US47342,2181,1134,1047,54583,62338,8483,47342
8600000US47344,61,25,36,41875,50057,17928,47344
8600000US47345,1078,554,524,63087,66156,8143,47345
8600000US47346,3072,1497,1575,52500,67541,6706,47346
8600000US47348,7217,3487,3730,42432,58751,7076,47348
8600000US47351,304,143,161,56042,55601,8049,47351
8600000US47352,779,385,394,41736,52765,6456,47352
8600000US47353,4347,2101,2246,49161,59058,3753,47353
8600000US47354,926,460,466,42054,72218,21841,47354
8600000US47355,2188,1147,1041,46548,54245,6898,47355
8600000US47356,4186,2029,2157,55542,64837,5252,47356
8600000US47357,645,275,370,50156,52218,10296,47357
8600000US47358,771,377,394,46974,84515,21880,47358
8600000US47359,2333,1183,1150,43958,57352,8211,47359
8600000US47360,1109,563,546,63281,79135,16688,47360
8600000US47361,152,71,81,55625,56802,9699,47361
8600000US47362,24099,13022,11077,44797,58038,5317,47362
8600000US47367,23,11,12,,,,47367
8600000US47368,2293,1128,1165,53011,62463,9651,47368
8600000US47369,1033,489,544,44948,54186,6885,47369
8600000US47371,9250,4510,4740,47068,59513,7703,47371
8600000US47373,1938,974,964,42679,51760,4974,47373
8600000US47374,35816,16927,18889,41324,60209,3881,47374
8600000US47380,1204,615,589,48111,59747,8078,47380
8600000US47381,116,43,73,33125,42154,14727,47381
8600000US47382,182,75,107,30000,37782,7327,47382
8600000US47383,2517,1185,1332,62330,78434,9876,47383
8600000US47384,1399,707,692,63456,70576,7891,47384
8600000US47385,1083,533,550,52692,59886,9500,47385
8600000US47386,975,494,481,63359,67940,9279,47386
8600000US47387,597,282,315,46220,57062,11987,47387
8600000US47388,237,113,124,37083,48326,9292,47388
8600000US47390,3651,1716,1935,37731,45255,3310,47390
8600000US47393,1274,608,666,72750,79056,11909,47393
8600000US47394,6489,3049,3440,45582,56696,6608,47394
8600000US47396,5327,2610,2717,53871,78220,9662,47396
8600000US47401,36689,18081,18608,50844,82131,5613,47401
8600000US47403,26533,12943,13590,51243,62867,2767,47403
8600000US47404,19442,9893,9549,39424,53107,2847,47404
8600000US47405,3788,1891,1897,,,,47405
8600000US47406,3756,1748,2008,,,,47406
8600000US47408,22932,11637,11295,31412,56558,4390,47408
8600000US47420,270,120,150,68194,49684,23122,47420
8600000US47421,21605,10323,11282,49613,61850,3726,47421
8600000US47424,7218,3681,3537,54159,63000,3808,47424
8600000US47427,613,306,307,47813,53104,6190,47427
8600000US47429,6724,3126,3598,60208,75330,8638,47429
8600000US47431,1231,640,591,52799,69158,17151,47431
8600000US47432,3612,1744,1868,42064,53181,4582,47432
8600000US47433,3148,1530,1618,57188,69339,8304,47433
8600000US47434,0,0,0,,,,47434
8600000US47436,1169,610,559,43160,57280,13175,47436
8600000US47437,139,74,65,,121229,113477,47437
8600000US47438,3267,1543,1724,49792,62392,7356,47438
8600000US47441,7472,3689,3783,47083,55411,3824,47441
8600000US47443,967,510,457,50341,68097,14475,47443
8600000US47446,7950,3949,4001,52853,56965,4211,47446
8600000US47448,6086,2836,3250,54023,72622,7369,47448
8600000US47449,287,140,147,32273,42468,8971,47449
8600000US47451,900,453,447,45063,59554,16420,47451
8600000US47452,3838,1943,1895,55417,63950,7056,47452
8600000US47453,581,299,282,46711,59623,13280,47453
8600000US47454,5719,2751,2968,39827,53696,6208,47454
8600000US47455,62,33,29,,,,47455
8600000US47456,1209,633,576,54000,57421,6329,47456
8600000US47457,98,40,58,78500,77987,24648,47457
8600000US47458,19,9,10,,,,47458
8600000US47459,2817,1375,1442,55223,62679,7082,47459
8600000US47460,8706,4246,4460,48664,58976,4552,47460
8600000US47462,3273,1704,1569,65818,72469,6401,47462
8600000US47464,172,89,83,31250,41529,12744,47464
8600000US47465,384,156,228,45850,43607,8990,47465
8600000US47467,50,23,27,,,,47467
8600000US47468,1248,634,614,58015,81504,17315,47468
8600000US47469,1368,750,618,52500,58238,8693,47469
8600000US47470,1401,729,672,54952,69141,19964,47470
8600000US47471,1937,884,1053,48438,59826,8527,47471
8600000US47501,13475,6668,6807,47391,60417,2805,47501
8600000US47512,3034,1349,1685,42464,51534,6368,47512
8600000US47513,1866,914,952,52313,60084,13248,47513
8600000US47514,1587,1477,110,49750,62183,19533,47514
8600000US47515,692,373,319,56042,75102,15317,47515
8600000US47516,972,468,504,63628,81934,15026,47516
8600000US47519,606,263,343,97317,105679,18644,47519
8600000US47520,2223,1107,1116,41780,50616,5305,47520
8600000US47521,484,252,232,82049,85377,15711,47521
8600000US47522,354,189,165,56688,56672,10605,47522
8600000US47523,2562,1285,1277,51087,61425,4976,47523
8600000US47524,357,230,127,58382,95106,58180,47524
8600000US47525,248,133,115,29141,55954,21565,47525
8600000US47527,1187,576,611,55250,68359,12356,47527
8600000US47528,371,202,169,45625,50128,7569,47528
8600000US47529,806,379,427,39569,50653,5933,47529
8600000US47531,533,313,220,40954,57847,14657,47531
8600000US47532,3700,1776,1924,69875,73667,5852,47532
8600000US47535,616,322,294,47500,66508,16720,47535
8600000US47536,0,0,0,,,,47536
8600000US47537,790,379,411,78258,79153,9340,47537
8600000US47541,869,444,425,70750,69107,7913,47541
8600000US47542,7327,3781,3546,52878,65099,6677,47542
8600000US47546,16025,7637,8388,59603,77133,7305,47546
8600000US47550,528,248,280,73083,83654,16120,47550
8600000US47551,653,305,348,71364,89079,24452,47551
8600000US47552,294,175,119,,463145,482004,47552
8600000US47553,6039,3119,2920,53480,62500,4730,47553
8600000US47557,1254,660,594,59688,68561,7009,47557
8600000US47558,2906,1466,1440,60456,79348,13120,47558
8600000US47561,1257,635,622,54868,60575,9983,47561
8600000US47562,3176,1563,1613,49509,63089,6594,47562
8600000US47564,986,516,470,53667,64682,11885,47564
8600000US47567,4847,2372,2475,54104,66461,4416,47567
8600000US47568,586,248,338,39896,56937,12555,47568
8600000US47574,255,159,96,75583,107824,54976,47574
8600000US47575,1014,555,459,67941,74798,22075,47575
8600000US47576,271,129,142,78516,73792,18203,47576
8600000US47577,980,574,406,67250,74049,13372,47577
8600000US47578,718,329,389,57875,71058,10108,47578
8600000US47579,1922,906,1016,72917,89100,10585,47579
8600000US47580,343,149,194,,78799,24689,47580
8600000US47581,3016,1429,1587,48520,62076,10429,47581
8600000US47584,120,66,54,41000,44534,7063,47584
8600000US47585,407,230,177,53966,62073,19341,47585
8600000US47586,8233,3960,4273,50256,61507,3165,47586
8600000US47588,450,268,182,57321,66810,14949,47588
8600000US47590,405,258,147,32250,40061,9066,47590
8600000US47591,20312,10231,10081,45104,59502,3468,47591
8600000US47596,67,34,33,39531,36664,26767,47596
8600000US47597,656,312,344,54375,63223,8564,47597
8600000US47598,2401,1185,1216,52500,60250,5290,47598
8600000US47601,10887,5309,5578,57954,77291,6229,47601
8600000US47610,3813,1805,2008,54212,60899,5324,47610
8600000US47611,1156,566,590,60833,77529,13238,47611
8600000US47612,598,314,284,52159,58580,7279,47612
8600000US47613,2345,1178,1167,74625,80919,8685,47613
8600000US47615,1491,614,877,50607,54796,8061,47615
8600000US47616,253,133,120,,68495,25278,47616
8600000US47619,1249,633,616,58250,73990,7184,47619
8600000US47620,10311,4962,5349,58693,72853,5658,47620
8600000US47630,27255,13335,13920,80925,104302,5194,47630
8600000US47631,1704,834,870,61667,73724,7395,47631
8600000US47633,1966,1017,949,44130,56368,6164,47633
8600000US47634,1713,886,827,52153,59582,5887,47634
8600000US47635,4320,2199,2121,51029,61058,4696,47635
8600000US47637,963,465,498,56364,68896,8248,47637
8600000US47638,2655,1394,1261,73162,90834,15502,47638
8600000US47639,3006,1448,1558,86103,100771,9948,47639
8600000US47640,839,430,409,50069,68990,13592,47640
8600000US47648,3325,1649,1676,59097,76210,10163,47648
8600000US47649,1252,649,603,59620,61993,8934,47649
8600000US47654,75,32,43,58594,58350,13441,47654
8600000US47660,3799,1846,1953,49291,63364,7379,47660
8600000US47665,2824,1402,1422,52500,68070,5906,47665
8600000US47666,1343,644,699,41030,57872,11020,47666
8600000US47670,9250,4567,4683,49651,63145,5491,47670
8600000US47683,127,60,67,57054,66458,15145,47683
8600000US47708,282,152,130,,118152,42525,47708
8600000US47710,15070,7330,7740,36061,49567,3519,47710
8600000US47711,25430,12595,12835,51645,66756,5676,47711
8600000US47712,21566,10019,11547,49067,68384,5289,47712
8600000US47713,7945,3474,4471,26595,38445,3959,47713
8600000US47714,26216,12623,13593,38605,51437,2336,47714
8600000US47715,21735,9848,11887,45304,65036,4696,47715
8600000US47720,13584,6556,7028,62057,80522,7332,47720
8600000US47725,12470,6217,6253,88602,123564,16648,47725
8600000US47802,27728,14898,12830,45376,65781,3487,47802
8600000US47803,16740,8432,8308,51917,67736,4080,47803
8600000US47804,8825,4155,4670,34970,45380,3919,47804
8600000US47805,9688,4815,4873,53495,65695,4003,47805
8600000US47807,9798,4798,5000,21288,31786,2668,47807
8600000US47809,2723,1287,1436,,,,47809
8600000US47832,826,448,378,75909,69901,10068,47832
8600000US47833,826,444,382,59977,74480,16757,47833
8600000US47834,14896,7234,7662,53104,63314,2977,47834
8600000US47836,0,0,0,,,,47836
8600000US47837,977,498,479,34671,44880,9781,47837
8600000US47838,3217,2521,696,51667,56638,5944,47838
8600000US47840,1227,622,605,64441,65220,8500,47840
8600000US47841,1744,851,893,42583,52016,4391,47841
8600000US47842,7521,3678,3843,46192,55524,4002,47842
8600000US47846,421,239,182,58313,75872,20169,47846
8600000US47847,837,422,415,56750,72362,12844,47847
8600000US47848,1414,704,710,47794,62357,12240,47848
8600000US47849,301,165,136,57143,81565,30455,47849
8600000US47850,1849,949,900,55469,64703,7824,47850
8600000US47853,100,46,54,52500,54466,8751,47853
8600000US47854,574,306,268,64000,70847,14272,47854
8600000US47855,402,197,205,40417,44928,7454,47855
8600000US47857,376,161,215,51771,51479,7813,47857
8600000US47858,478,244,234,63971,132031,93320,47858
8600000US47859,608,302,306,44615,58639,10064,47859
8600000US47860,281,152,129,40625,45232,8794,47860
8600000US47861,569,263,306,72981,69807,10939,47861
8600000US47862,1110,633,477,44542,53339,6770,47862
8600000US47863,210,130,80,65395,58425,9287,47863
8600000US47865,183,80,103,42132,53859,23186,47865
8600000US47866,459,245,214,41538,42685,14000,47866
8600000US47868,2327,1242,1085,43150,53274,6601,47868
8600000US47869,94,52,42,63438,74900,24939,47869
8600000US47871,178,84,94,40000,49969,7756,47871
8600000US47872,7078,2987,4091,47500,65062,11175,47872
8600000US47874,2394,1294,1100,45363,59308,8790,47874
8600000US47876,354,0,354,,,,47876
8600000US47879,2513,1255,1258,44039,54570,6091,47879
8600000US47880,20,5,15,,,,47880
8600000US47881,290,145,145,50179,49772,7046,47881
8600000US47882,6255,2982,3273,43301,56280,5663,47882
8600000US47884,136,59,77,36667,41154,6890,47884
8600000US47885,6882,3255,3627,45838,66478,12670,47885
8600000US47901,3330,1719,1611,34981,40217,4526,47901
8600000US47904,13544,7110,6434,37495,49300,4203,47904
8600000US47905,31589,14967,16622,57394,72230,3282,47905
8600000US47906,64346,34852,29494,46594,70469,3116,47906
8600000US47907,0,0,0,,,,47907
8600000US47909,31643,15491,16152,57634,71523,3165,47909
8600000US47916,44,19,25,,46771,30363,47916
8600000US47917,404,183,221,43487,55057,12372,47917
8600000US47918,4671,2324,2347,48910,67813,8100,47918
8600000US47920,1893,1017,876,76071,87808,10469,47920
8600000US47921,845,428,417,43500,53743,7116,47921
8600000US47922,1280,594,686,44402,55636,7336,47922
8600000US47923,2535,1274,1261,59485,71419,8304,47923
8600000US47924,150,86,64,78475,67538,18028,47924
8600000US47925,160,40,120,38036,38149,11672,47925
8600000US47926,1014,523,491,52083,65894,12378,47926
8600000US47928,1668,828,840,53854,62077,9178,47928
8600000US47929,530,263,267,63125,63419,7847,47929
8600000US47930,971,472,499,58583,75368,14036,47930
8600000US47932,3903,1976,1927,55942,73928,9711,47932
8600000US47933,21657,11096,10561,51370,63983,2890,47933
8600000US47940,1339,647,692,60982,71315,9100,47940
8600000US47941,1038,505,533,53018,67857,11241,47941
8600000US47942,568,283,285,58472,62505,5975,47942
8600000US47943,915,475,440,67955,66427,10702,47943
8600000US47944,2648,1284,1364,43320,54118,3917,47944
8600000US47946,1724,874,850,61306,69907,7740,47946
8600000US47948,1113,501,612,45000,50704,5458,47948
8600000US47949,906,417,489,52794,61922,9277,47949
8600000US47950,603,328,275,61985,75397,13302,47950
8600000US47951,1790,883,907,50769,58980,4780,47951
8600000US47952,2331,1153,1178,42117,53534,6179,47952
8600000US47954,1708,850,858,64119,71248,6396,47954
8600000US47955,705,341,364,57738,61258,7110,47955
8600000US47957,1448,723,725,49063,53152,7028,47957
8600000US47958,136,60,76,41250,48043,9877,47958
8600000US47959,2035,1022,1013,44406,55143,5024,47959
8600000US47960,11665,5681,5984,52838,67889,3702,47960
8600000US47963,1598,756,842,51629,67055,10099,47963
8600000US47964,86,44,42,39688,49626,15363,47964
8600000US47965,437,210,227,62917,68361,10299,47965
8600000US47966,319,165,154,48906,51233,6463,47966
8600000US47967,442,214,228,43125,51318,20073,47967
8600000US47968,811,387,424,64688,76746,13560,47968
8600000US47969,105,46,59,55000,63200,18005,47969
8600000US47970,1341,677,664,46534,69704,16905,47970
8600000US47971,1450,692,758,57500,66447,8763,47971
8600000US47974,956,435,521,52898,65286,8530,47974
8600000US47975,527,231,296,66522,79752,13660,47975
8600000US47977,1746,862,884,56750,64008,6059,47977
8600000US47978,8484,4239,4245,57389,67931,4094,47978
8600000US47980,811,438,373,63313,85661,14015,47980
8600000US47981,572,266,306,79167,122661,51751,47981
8600000US47982,157,73,84,58750,62316,14693,47982
8600000US47983,160,94,66,59900,56907,5986,47983
8600000US47987,3044,1487,1557,50698,61050,8109,47987
8600000US47989,1007,480,527,58442,72390,14085,47989
8600000US47990,1380,719,661,55027,58895,7847,47990
8600000US47991,721,369,352,52857,64337,10308,47991
8600000US47992,1236,580,656,74674,106702,41349,47992
8600000US47993,2868,1388,1480,57337,65996,4072,47993
8600000US47994,238,124,114,53125,54203,9237,47994
8600000US47995,1298,660,638,71293,74291,5461,47995
8600000US47997,87,41,46,71875,74502,24109,47997
8600000US48001,9676,5008,4668,57450,72750,6221,48001
8600000US48002,2531,1306,1225,69663,81347,5446,48002
8600000US48003,4977,2530,2447,65612,83254,8457,48003
8600000US48005,4415,2224,2191,73313,82481,4762,48005
8600000US48006,3115,1624,1491,67083,81459,5578,48006
8600000US48009,15859,7383,8476,117670,193241,9684,48009
8600000US48014,3205,1575,1630,60123,73006,7434,48014
8600000US48015,6470,3068,3402,42729,52285,3577,48015
8600000US48017,10179,5072,5107,67316,78331,3585,48017
8600000US48021,24390,11161,13229,46684,56921,2634,48021
8600000US48022,1997,1021,976,75152,80469,8439,48022
8600000US48023,4009,2036,1973,74787,91439,10329,48023
8600000US48025,11275,5361,5914,123365,175849,12669,48025
8600000US48026,11698,5410,6288,56732,71314,4114,48026
8600000US48027,2559,1352,1207,64922,78050,5123,48027
8600000US48028,980,488,492,55000,77211,14152,48028
8600000US48030,13334,7058,6276,35817,46286,2812,48030
8600000US48032,1567,799,768,65667,81947,8223,48032
8600000US48033,13563,6062,7501,49845,65270,4052,48033
8600000US48034,11669,4872,6797,45964,65253,6534,48034
8600000US48035,27167,12788,14379,49662,59766,2857,48035
8600000US48036,17259,8120,9139,52335,64407,3605,48036
8600000US48038,36460,16664,19796,59136,74424,2667,48038
8600000US48039,6096,2930,3166,49975,63157,4252,48039
8600000US48040,7524,3533,3991,63102,71901,4469,48040
8600000US48041,3622,1896,1726,62717,76825,5923,48041
8600000US48042,22309,10847,11462,96855,109594,4689,48042
8600000US48043,13198,6693,6505,43289,57678,5421,48043
8600000US48044,42381,20575,21806,99632,108428,3407,48044
8600000US48045,20710,9913,10797,64495,80370,3780,48045
8600000US48047,31041,14734,16307,77002,88725,3112,48047
8600000US48048,5531,2695,2836,61521,68780,5954,48048
8600000US48049,4406,2142,2264,62770,81703,6406,48049
8600000US48050,1354,672,682,89107,101972,15866,48050
8600000US48051,14058,7677,6381,73705,86799,7503,48051
8600000US48054,5901,2921,2980,70048,88907,9412,48054
8600000US48059,11656,5357,6299,56629,80739,6339,48059
8600000US48060,30550,14835,15715,40817,53609,2998,48060
8600000US48062,7011,3463,3548,66422,78764,5690,48062
8600000US48063,3231,1733,1498,73839,83883,12586,48063
8600000US48064,3151,1568,1583,64719,80074,7704,48064
8600000US48065,8807,4425,4382,74688,99015,7620,48065
8600000US48066,37485,17746,19739,43654,55554,2086,48066
8600000US48067,21167,11004,10163,82025,108540,6885,48067
8600000US48069,1903,922,981,116583,149923,14518,48069
8600000US48070,4503,2151,2352,130417,171959,13210,48070
8600000US48071,24630,12052,12578,50350,65384,5053,48071
8600000US48072,12099,5810,6289,82095,96441,5445,48072
8600000US48073,28923,14224,14699,76203,91195,3063,48073
8600000US48074,7230,3409,3821,56389,68848,6933,48074
8600000US48075,17800,7447,10353,54966,68334,3455,48075
8600000US48076,20164,9132,11032,67672,83203,4153,48076
8600000US48079,9483,4749,4734,71194,86207,6126,48079
8600000US48080,18578,8847,9731,55755,67699,2455,48080
8600000US48081,16703,7871,8832,62305,80429,6892,48081
8600000US48082,13552,6813,6739,57106,78664,8481,48082
8600000US48083,18692,9257,9435,74439,90708,4691,48083
8600000US48084,12126,6081,6045,90383,111248,4596,48084
8600000US48085,19796,9818,9978,113536,130186,4625,48085
8600000US48088,17669,8289,9380,60886,70524,2948,48088
8600000US48089,23676,11183,12493,36967,47828,3263,48089
8600000US48091,22942,11333,11609,38731,52987,3781,48091
8600000US48092,21457,10523,10934,56566,69568,2521,48092
8600000US48093,20143,8968,11175,51830,68068,3284,48093
8600000US48094,15008,7657,7351,90542,110803,5396,48094
8600000US48095,4533,2258,2275,102745,121009,12966,48095
8600000US48096,3249,1580,1669,69167,83037,7781,48096
8600000US48097,4069,2013,2056,50972,63554,3594,48097
8600000US48098,14969,7162,7807,124183,156948,9610,48098
8600000US48101,21886,10996,10890,69094,83799,6362,48101
8600000US48103,43931,21408,22523,91962,118488,3809,48103
8600000US48104,39560,19625,19935,58144,96256,5034,48104
8600000US48105,30745,15749,14996,71504,109024,5520,48105
8600000US48108,21088,10189,10899,64440,94931,3578,48108
8600000US48109,5421,2383,3038,,,,48109
8600000US48111,32250,15296,16954,56794,72110,2877,48111
8600000US48114,16087,8085,8002,95387,119564,5048,48114
8600000US48116,21817,10652,11165,84226,111656,4974,48116
8600000US48117,8103,4128,3975,63919,84237,6789,48117
8600000US48118,10200,4941,5259,85723,112020,7022,48118
8600000US48120,5184,2599,2585,37066,66112,11087,48120
8600000US48122,7178,3368,3810,43556,51119,5982,48122
8600000US48124,22604,10776,11828,71689,85905,3531,48124
8600000US48125,15683,7824,7859,49424,58040,3211,48125
8600000US48126,31674,15674,16000,33710,48733,2485,48126
8600000US48127,26780,12659,14121,49386,68914,3677,48127
8600000US48128,7940,3758,4182,78993,95929,8134,48128
8600000US48130,11505,5424,6081,103429,127148,10523,48130
8600000US48131,5478,2589,2889,60287,72672,6663,48131
8600000US48133,4333,2163,2170,55160,65647,4057,48133
8600000US48134,16016,7786,8230,73983,83093,4155,48134
8600000US48135,21397,10410,10987,54102,63711,2554,48135
8600000US48137,3986,2082,1904,68750,84070,7909,48137
8600000US48138,8164,4054,4110,101196,127667,9171,48138
8600000US48139,94,33,61,58625,56505,11455,48139
8600000US48140,2592,1365,1227,79728,87668,7587,48140
8600000US48141,17195,7912,9283,32183,42773,2121,48141
8600000US48143,0,0,0,,,,48143
8600000US48144,7535,3682,3853,70741,87070,8817,48144
8600000US48145,2718,1393,1325,73459,86191,6269,48145
8600000US48146,27572,13121,14451,43470,55714,3904,48146
8600000US48150,20865,10050,10815,74437,84556,2621,48150
8600000US48152,25505,12050,13455,72440,91744,3823,48152
8600000US48154,30845,14941,15904,82765,96197,2969,48154
8600000US48157,982,449,533,47750,60533,7789,48157
8600000US48158,6162,3034,3128,74650,89017,5245,48158
8600000US48159,1969,1019,950,68205,76956,5911,48159
8600000US48160,10376,5858,4518,72821,84246,4374,48160
8600000US48161,20274,9646,10628,49418,64521,3821,48161
8600000US48162,22049,10450,11599,55117,68019,3333,48162
8600000US48164,6696,3389,3307,89844,107960,8326,48164
8600000US48165,5660,2837,2823,88558,101404,6324,48165
8600000US48166,8574,4200,4374,62055,78263,7422,48166
8600000US48167,17080,8342,8738,94788,138084,10886,48167
8600000US48168,16667,8014,8653,133984,172721,9549,48168
8600000US48169,17162,8537,8625,81524,96573,3982,48169
8600000US48170,31465,15447,16018,82880,116039,5486,48170
8600000US48173,9801,4960,4841,79022,86045,4140,48173
8600000US48174,23483,11356,12127,49466,60686,3142,48174
8600000US48176,18022,9074,8948,102875,127523,6757,48176
8600000US48177,130,66,64,121250,120841,38334,48177
8600000US48178,25666,12343,13323,92436,114728,4159,48178
8600000US48179,2922,1423,1499,83045,97554,12036,48179
8600000US48180,47421,22324,25097,47370,58505,1682,48180
8600000US48182,16943,8159,8784,69143,82039,2967,48182
8600000US48183,34033,16195,17838,63557,79923,2631,48183
8600000US48184,13765,6390,7375,43927,58636,3848,48184
8600000US48185,38902,17261,21641,47205,62138,2603,48185
8600000US48186,26651,12728,13923,49171,61735,2843,48186
8600000US48187,37486,18280,19206,84161,103311,2775,48187
8600000US48188,31090,14795,16295,98562,116007,4159,48188
8600000US48189,11297,5630,5667,65733,90375,11335,48189
8600000US48190,157,60,97,183257,172306,22138,48190
8600000US48191,3202,1658,1544,69366,80841,7170,48191
8600000US48192,20262,9740,10522,53110,67000,2980,48192
8600000US48193,12530,5582,6948,57692,75136,5891,48193
8600000US48195,24161,11440,12721,54978,64643,2629,48195
8600000US48197,55171,26792,28379,56842,76088,2972,48197
8600000US48198,29209,13742,15467,45721,62282,3318,48198
8600000US48201,13209,6115,7094,15168,31240,2832,48201
8600000US48202,14063,7113,6950,26164,43653,5935,48202
8600000US48203,17814,8526,9288,21013,39172,4112,48203
8600000US48204,17898,7898,10000,24362,36340,4583,48204
8600000US48205,25158,11571,13587,36307,41770,1852,48205
8600000US48206,12550,5780,6770,22308,39626,4500,48206
8600000US48207,17747,7646,10101,29625,43938,2246,48207
8600000US48208,7228,3514,3714,21070,40844,5202,48208
8600000US48209,21480,10498,10982,27418,38688,3773,48209
8600000US48210,19480,9697,9783,29007,36685,2319,48210
8600000US48211,4604,2565,2039,23507,31258,2953,48211
8600000US48212,26682,13605,13077,26435,37135,2225,48212
8600000US48213,17666,8523,9143,23559,34463,2124,48213
8600000US48214,17256,8021,9235,28961,45686,3476,48214
8600000US48215,8790,3941,4849,22721,42803,5142,48215
8600000US48216,4191,2255,1936,31000,45827,5394,48216
8600000US48217,5370,2387,2983,26413,38435,5037,48217
8600000US48218,5762,2803,2959,27038,37950,4367,48218
8600000US48219,37013,16748,20265,33029,43242,1968,48219
8600000US48220,19937,10007,9930,62068,75865,3661,48220
8600000US48221,32816,14294,18522,41297,56456,3214,48221
8600000US48223,18360,8594,9766,35562,47763,2277,48223
8600000US48224,29468,13235,16233,32817,43453,2107,48224
8600000US48225,10713,4981,5732,47864,57584,4133,48225
8600000US48226,6677,3826,2851,57083,81836,10303,48226
8600000US48227,30362,13568,16794,29250,37901,2052,48227
8600000US48228,38341,17766,20575,26269,36248,1407,48228
8600000US48229,7117,3270,3847,27241,40590,5252,48229
8600000US48230,12541,6019,6522,110549,165592,11379,48230
8600000US48233,0,0,0,,,,48233
8600000US48234,25376,11754,13622,27947,41958,4539,48234
8600000US48235,34425,15035,19390,31759,42305,2987,48235
8600000US48236,22665,10628,12037,103742,142263,5963,48236
8600000US48237,23455,10317,13138,49721,60429,3525,48237
8600000US48238,20592,9657,10935,24280,37054,3469,48238
8600000US48239,26956,12510,14446,55078,62543,2323,48239
8600000US48240,13566,6288,7278,54070,63035,4944,48240
8600000US48242,0,0,0,,,,48242
8600000US48243,0,0,0,,,,48243
8600000US48301,10976,5219,5757,144659,207875,13596,48301
8600000US48302,12413,6112,6301,129154,198931,12586,48302
8600000US48304,12907,5952,6955,120104,176286,11434,48304
8600000US48306,20257,9873,10384,147303,181705,7764,48306
8600000US48307,34022,16239,17783,77904,102758,3037,48307
8600000US48309,24168,11528,12640,97025,120845,5326,48309
8600000US48310,34707,17019,17688,58495,73122,3329,48310
8600000US48312,27319,13053,14266,61136,75681,2683,48312
8600000US48313,26872,13174,13698,68193,79993,3462,48313
8600000US48314,16770,8000,8770,66210,87590,5950,48314
8600000US48315,21959,10077,11882,77532,104628,5982,48315
8600000US48316,21587,10277,11310,83107,105115,8781,48316
8600000US48317,22702,10989,11713,62250,74810,3322,48317
8600000US48320,4005,1970,2035,49474,80149,9608,48320
8600000US48322,26222,11925,14297,88850,124545,6107,48322
8600000US48323,13291,6385,6906,113008,163880,14182,48323
8600000US48324,14016,6878,7138,110761,152088,7833,48324
8600000US48326,18254,9300,8954,63016,76341,3365,48326
8600000US48327,18126,8665,9461,56606,70623,2843,48327
8600000US48328,20715,10105,10610,53627,71435,3594,48328
8600000US48329,19668,9320,10348,73336,86783,3714,48329
8600000US48331,17179,8029,9150,109847,136901,8056,48331
8600000US48334,15608,6841,8767,78368,101105,7510,48334
8600000US48335,19545,9838,9707,77222,97242,5154,48335
8600000US48336,20432,9690,10742,62025,77940,4464,48336
8600000US48340,18648,8884,9764,35612,46987,4688,48340
8600000US48341,14010,7107,6903,36482,48363,2881,48341
8600000US48342,11805,5517,6288,25489,38364,4750,48342
8600000US48346,18364,8938,9426,78901,98683,5081,48346
8600000US48348,18003,8865,9138,106728,127976,6407,48348
8600000US48350,5560,2773,2787,80150,105183,9368,48350
8600000US48353,5116,2390,2726,78466,95582,6857,48353
8600000US48356,6771,3494,3277,85787,100121,7662,48356
8600000US48357,6568,3123,3445,81773,111530,19184,48357
8600000US48359,7170,3498,3672,83036,108127,10089,48359
8600000US48360,9289,4510,4779,107295,125583,6282,48360
8600000US48362,12328,5946,6382,88255,113633,8486,48362
8600000US48363,4657,2419,2238,127946,161624,19049,48363
8600000US48367,3897,1985,1912,85118,103989,10121,48367
8600000US48370,1439,682,757,113879,141554,23593,48370
8600000US48371,18345,9162,9183,82885,100579,5777,48371
8600000US48374,11358,5515,5843,138984,163885,10193,48374
8600000US48375,17183,8300,8883,95640,126710,11302,48375
8600000US48377,13085,6102,6983,62874,93585,6081,48377
8600000US48380,6104,3022,3082,99405,131717,12805,48380
8600000US48381,10510,4996,5514,74056,100645,6435,48381
8600000US48382,17579,8655,8924,106207,125855,5393,48382
8600000US48383,10254,5105,5149,83586,95441,4435,48383
8600000US48386,14132,7331,6801,79795,98500,5047,48386
8600000US48390,18959,9160,9799,73331,89751,3617,48390
8600000US48393,12900,6287,6613,52902,78108,3630,48393
8600000US48397,0,0,0,,,,48397
8600000US48401,1189,616,573,44926,57217,6916,48401
8600000US48411,96,46,50,,,,48411
8600000US48412,4017,2198,1819,65788,81627,9235,48412
8600000US48413,5592,2660,2932,46331,57998,3290,48413
8600000US48414,2022,984,1038,57500,68885,5867,48414
8600000US48415,7414,3701,3713,60768,76364,7482,48415
8600000US48416,3618,1793,1825,50273,63671,5165,48416
8600000US48417,2100,1022,1078,55357,66510,8270,48417
8600000US48418,3047,1524,1523,70650,82146,5959,48418
8600000US48419,1856,908,948,46971,52916,2978,48419
8600000US48420,17524,8507,9017,52978,67221,3018,48420
8600000US48421,5291,2651,2640,56679,64933,3646,48421
8600000US48422,5057,2417,2640,48575,58067,4176,48422
8600000US48423,24967,11793,13174,52367,70438,4521,48423
8600000US48426,766,401,365,47569,57608,7438,48426
8600000US48427,2134,1013,1121,48087,53958,3254,48427
8600000US48428,4073,2009,2064,71773,83348,5480,48428
8600000US48429,7232,3377,3855,51904,62796,4375,48429
8600000US48430,28515,14264,14251,72265,91717,3749,48430
8600000US48432,518,263,255,46607,65915,8835,48432
8600000US48433,19960,9558,10402,61828,78359,4387,48433
8600000US48434,56,28,28,44167,58212,14252,48434
8600000US48435,1603,807,796,55283,58908,7473,48435
8600000US48436,2864,1540,1324,73988,82236,7035,48436
8600000US48437,557,223,334,54076,55976,13586,48437
8600000US48438,5234,2576,2658,87669,103458,9333,48438
8600000US48439,36963,17654,19309,70527,96848,4635,48439
8600000US48440,149,80,69,,46798,22513,48440
8600000US48441,3138,1589,1549,42799,58660,5003,48441
8600000US48442,16190,7631,8559,68898,81901,5116,48442
8600000US48444,7278,3679,3599,53080,67600,3934,48444
8600000US48445,941,461,480,42273,52544,5210,48445
8600000US48446,24745,12544,12201,53535,65431,2422,48446
8600000US48449,2247,1133,1114,49293,58935,5381,48449
8600000US48450,4041,1988,2053,43817,58325,5928,48450
8600000US48451,10735,5307,5428,81356,97992,5393,48451
8600000US48453,3824,1827,1997,41406,58754,5310,48453
8600000US48454,936,482,454,47375,63399,6404,48454
8600000US48455,6507,3314,3193,76723,109867,13231,48455
8600000US48456,575,304,271,55417,59311,4601,48456
8600000US48457,6431,3261,3170,54420,62901,3714,48457
8600000US48458,14650,6681,7969,34887,45728,3099,48458
8600000US48460,1776,909,867,64420,73026,4842,48460
8600000US48461,6065,2958,3107,56555,72679,7859,48461
8600000US48462,10663,5489,5174,92756,101234,4984,48462
8600000US48463,3571,1738,1833,58394,68677,5198,48463
8600000US48464,1754,909,845,56842,62863,4773,48464
8600000US48465,480,258,222,47500,56636,7641,48465
8600000US48466,1118,592,526,52866,56685,3431,48466
8600000US48467,1937,964,973,50071,65172,4780,48467
8600000US48468,956,497,459,43750,59612,7053,48468
8600000US48469,1125,542,583,46111,77136,19342,48469
8600000US48470,643,329,314,46739,57632,8198,48470
8600000US48471,4220,2103,2117,40392,57511,6569,48471
8600000US48472,1310,638,672,48295,61645,5894,48472
8600000US48473,17168,8233,8935,63671,77465,3806,48473
8600000US48475,2009,1022,987,53542,66184,5430,48475
8600000US48476,394,189,205,65400,69391,13522,48476
8600000US48502,1097,810,287,30500,37682,14918,48502
8600000US48503,19805,8948,10857,27105,41876,2979,48503
8600000US48504,20476,9166,11310,31087,41895,3003,48504
8600000US48505,15187,7058,8129,25931,33328,2623,48505
8600000US48506,22032,10950,11082,37594,44559,1658,48506
8600000US48507,23953,11514,12439,35746,44650,1947,48507
8600000US48509,6960,3310,3650,54831,65799,4945,48509
8600000US48519,5649,2504,3145,47238,57655,5056,48519
8600000US48529,7437,3398,4039,30708,44185,7812,48529
8600000US48532,15235,6611,8624,40989,56931,3289,48532
8600000US48551,0,0,0,,,,48551
8600000US48553,0,0,0,,,,48553
8600000US48554,0,0,0,,,,48554
8600000US48601,25969,11835,14134,28654,39986,2718,48601
8600000US48602,22717,11103,11614,35761,46490,2550,48602
8600000US48603,21986,10148,11838,53274,77013,5702,48603
8600000US48604,10326,4479,5847,45909,55921,3037,48604
8600000US48607,1319,653,666,27375,36246,6189,48607
8600000US48609,9891,4652,5239,58195,85661,9210,48609
8600000US48610,2570,1461,1109,40616,46845,2617,48610
8600000US48611,4953,2322,2631,66809,74490,5347,48611
8600000US48612,7438,3761,3677,42658,55935,4143,48612
8600000US48613,843,456,387,44000,59657,7842,48613
8600000US48614,1120,559,561,44375,54380,4940,48614
8600000US48615,2189,1095,1094,48795,57538,6108,48615
8600000US48616,5642,2824,2818,49366,63566,3248,48616
8600000US48617,6464,3071,3393,51166,65916,4809,48617
8600000US48618,4098,2016,2082,44160,53833,2731,48618
8600000US48619,496,251,245,40066,54736,8588,48619
8600000US48621,932,422,510,44861,44558,5779,48621
8600000US48622,5065,2325,2740,46703,57263,4195,48622
8600000US48623,10671,5961,4710,80032,95137,6028,48623
8600000US48624,12318,6053,6265,42570,55039,2352,48624
8600000US48625,10720,5490,5230,31564,43252,2406,48625
8600000US48626,4634,2318,2316,61683,76957,6027,48626
8600000US48627,87,46,41,,122355,70477,48627
8600000US48628,1853,945,908,57266,73061,6918,48628
8600000US48629,6090,2923,3167,40565,45569,3005,48629
8600000US48630,37,20,17,,,,48630
8600000US48631,3347,1724,1623,53851,68081,8577,48631
8600000US48632,4280,2255,2025,35685,51865,11010,48632
8600000US48633,160,66,94,38917,59561,18550,48633
8600000US48634,3727,1734,1993,57307,68634,7350,48634
8600000US48635,1332,648,684,40352,51219,4494,48635
8600000US48636,641,313,328,37500,50144,8301,48636
8600000US48637,2395,1183,1212,50216,71547,8227,48637
8600000US48638,9657,4466,5191,47178,65364,5005,48638
8600000US48640,25772,12504,13268,59001,79122,3973,48640
8600000US48642,25054,12129,12925,65131,96016,5244,48642
8600000US48647,3443,1749,1694,40625,49102,4116,48647
8600000US48649,1083,543,540,52361,60342,5783,48649
8600000US48650,5747,2907,2840,48714,58108,2926,48650
8600000US48651,4209,2120,2089,36310,50966,5812,48651
8600000US48652,1316,718,598,57438,65545,5101,48652
8600000US48653,8500,4156,4344,44054,56872,4485,48653
8600000US48654,1733,903,830,38784,49390,4923,48654
8600000US48655,4581,2290,2291,52646,63034,3334,48655
8600000US48656,3464,1768,1696,36273,40752,3001,48656
8600000US48657,6558,3148,3410,57151,74094,7219,48657
8600000US48658,3909,1907,2002,40047,57210,7408,48658
8600000US48659,2062,1030,1032,41696,53290,3722,48659
8600000US48661,8476,4146,4330,43938,56109,2037,48661
8600000US48662,1277,649,628,58125,72830,10656,48662
8600000US48667,0,0,0,,,,48667
8600000US48701,1110,525,585,43750,56784,7648,48701
8600000US48703,2514,1231,1283,39329,50884,3288,48703
8600000US48705,469,262,207,34148,43907,6318,48705
8600000US48706,31418,14920,16498,48166,61858,1908,48706
8600000US48708,20431,10094,10337,40181,53775,2450,48708
8600000US48710,0,0,0,,,,48710
8600000US48720,816,433,383,36053,56714,7921,48720
8600000US48721,436,221,215,46625,48275,6679,48721
8600000US48722,2464,1175,1289,54349,66746,7322,48722
8600000US48723,9574,4709,4865,45599,61989,3864,48723
8600000US48724,484,182,302,,54698,28338,48724
8600000US48725,1822,904,918,42073,53449,6191,48725
8600000US48726,4578,2314,2264,48342,60045,3485,48726
8600000US48727,868,474,394,45714,55977,6234,48727
8600000US48728,223,130,93,36250,46567,9353,48728
8600000US48729,1120,577,543,45938,58972,5983,48729
8600000US48730,3890,1952,1938,41351,60673,7962,48730
8600000US48731,1243,640,603,40043,53908,4550,48731
8600000US48732,9030,4356,4674,44932,68111,9184,48732
8600000US48733,1372,632,740,46169,59899,4678,48733
8600000US48734,6057,2771,3286,67643,98564,12714,48734
8600000US48735,836,422,414,48203,63520,16892,48735
8600000US48737,1071,566,505,37742,46575,6261,48737
8600000US48738,1055,523,532,45968,50778,4358,48738
8600000US48739,3412,1658,1754,36985,48229,4340,48739
8600000US48740,1939,919,1020,40244,52765,5459,48740
8600000US48741,1576,809,767,42143,52145,4274,48741
8600000US48742,1443,740,703,39258,48693,3370,48742
8600000US48743,85,67,18,,18220,16319,48743
8600000US48744,3433,1710,1723,48565,60239,6302,48744
8600000US48745,1072,550,522,37833,51256,4571,48745
8600000US48746,6482,3192,3290,55359,64681,4701,48746
8600000US48747,1115,560,555,64286,77644,8398,48747
8600000US48748,1534,773,761,37572,46390,3870,48748
8600000US48749,871,433,438,41172,54117,6589,48749
8600000US48750,6945,3402,3543,42385,50896,2984,48750
8600000US48754,754,397,357,49779,76800,19651,48754
8600000US48755,2466,1211,1255,50109,64656,4047,48755
8600000US48756,3551,1735,1816,33847,42581,3821,48756
8600000US48757,2936,1458,1478,56667,74821,10580,48757
8600000US48759,2660,1257,1403,52621,60936,4478,48759
8600000US48760,1060,528,532,47656,55478,5943,48760
8600000US48761,816,402,414,34573,42707,7247,48761
8600000US48762,956,432,524,46042,62704,10420,48762
8600000US48763,4136,2040,2096,49988,65106,4380,48763
8600000US48765,618,337,281,39250,47245,4421,48765
8600000US48766,1043,559,484,41217,48717,3951,48766
8600000US48767,1634,840,794,58512,71468,5875,48767
8600000US48768,7211,3602,3609,41606,55325,3510,48768
8600000US48770,1475,779,696,40242,50123,5302,48770
8600000US48801,10257,4942,5315,36658,54290,4068,48801
8600000US48806,1258,608,650,46667,58137,4845,48806
8600000US48807,630,321,309,44583,72049,25552,48807
8600000US48808,4616,2244,2372,74792,89677,9431,48808
8600000US48809,8129,3939,4190,51018,60834,3732,48809
8600000US48811,4469,3110,1359,43802,65354,7248,48811
8600000US48813,16282,7864,8418,62050,76260,4082,48813
8600000US48815,1903,972,931,65739,80287,11173,48815
8600000US48816,59,36,23,,53832,27820,48816
8600000US48817,4897,2269,2628,53586,63183,8012,48817
8600000US48818,1851,955,896,32917,47082,4327,48818
8600000US48819,2099,995,1104,60976,76735,7159,48819
8600000US48820,13425,6469,6956,82991,111706,6776,48820
8600000US48821,4951,2385,2566,71500,86529,6353,48821
8600000US48822,2405,1223,1182,78864,88838,8395,48822
8600000US48823,45188,22093,23095,45008,75158,3072,48823
8600000US48825,12532,6073,6459,,,,48825
8600000US48827,12469,5974,6495,62457,73374,3919,48827
8600000US48829,2633,1279,1354,40141,53093,5552,48829
8600000US48831,2757,1365,1392,45777,57785,4767,48831
8600000US48832,1096,508,588,55924,65458,7433,48832
8600000US48834,1631,813,818,48015,58316,5151,48834
8600000US48835,2293,1187,1106,71563,78823,5000,48835
8600000US48836,10393,5189,5204,70203,79007,4147,48836
8600000US48837,15067,7378,7689,70928,88559,5929,48837
8600000US48838,14039,6800,7239,48094,59576,3797,48838
8600000US48840,10202,4858,5344,61895,90262,6800,48840
8600000US48841,601,318,283,67115,80501,13057,48841
8600000US48842,16552,7935,8617,60601,75386,3905,48842
8600000US48843,35010,16907,18103,76675,89961,2406,48843
8600000US48845,729,398,331,49018,68387,16840,48845
8600000US48846,16073,9753,6320,50000,58886,3773,48846
8600000US48847,4452,2059,2393,49684,61642,3991,48847
8600000US48848,5883,2916,2967,74479,92626,9775,48848
8600000US48849,4475,2206,2269,53868,63369,3824,48849
8600000US48850,3420,1673,1747,43050,54749,3524,48850
8600000US48851,1628,830,798,58224,72374,8706,48851
8600000US48852,107,49,58,30000,41408,14005,48852
8600000US48853,532,289,243,46932,54276,4957,48853
8600000US48854,15313,7657,7656,68893,85310,4909,48854
8600000US48855,11827,6065,5762,80880,92478,3972,48855
8600000US48856,672,336,336,43648,53925,11506,48856
8600000US48857,2190,1097,1093,68253,74623,7010,48857
8600000US48858,42802,20349,22453,39583,59734,2345,48858
8600000US48860,1178,662,516,51083,64024,9583,48860
8600000US48861,1109,556,553,59191,64660,5642,48861
8600000US48864,17665,8446,9219,88030,112884,8851,48864
8600000US48865,1656,901,755,39234,60879,13510,48865
8600000US48866,3932,1931,2001,58516,67527,4567,48866
8600000US48867,21185,10401,10784,46789,61082,2140,48867
8600000US48870,117,53,64,41750,46643,18179,48870
8600000US48871,1523,746,777,62019,70434,5914,48871
8600000US48872,5433,2718,2715,70435,78948,5661,48872
8600000US48873,989,530,459,65769,80407,10403,48873
8600000US48874,57,31,26,41250,47435,17908,48874
8600000US48875,7705,3879,3826,70451,78745,4120,48875
8600000US48876,3157,1599,1558,59006,70194,5226,48876
8600000US48877,1852,919,933,47857,60929,13051,48877
8600000US48878,1131,499,632,55104,71068,9626,48878
8600000US48879,13831,6877,6954,61193,72252,2670,48879
8600000US48880,8393,5892,2501,43906,57968,4979,48880
8600000US48881,4636,2343,2293,56852,66404,5327,48881
8600000US48883,5342,2616,2726,54946,63555,4716,48883
8600000US48884,3583,1808,1775,51250,65261,8354,48884
8600000US48885,661,344,317,46875,55409,7147,48885
8600000US48886,1554,860,694,43824,58443,6599,48886
8600000US48888,4649,2345,2304,49590,59455,3967,48888
8600000US48889,1019,513,506,48088,60785,12407,48889
8600000US48890,1653,833,820,57950,71808,8310,48890
8600000US48891,2262,1080,1182,53594,64670,13479,48891
8600000US48892,3411,1702,1709,72083,83249,8443,48892
8600000US48893,4212,2264,1948,59368,72312,5030,48893
8600000US48894,1295,650,645,73594,78008,5096,48894
8600000US48895,8989,4498,4491,93884,118694,9613,48895
8600000US48896,246,82,164,25368,30472,6407,48896
8600000US48897,1081,510,571,64250,82697,14986,48897
8600000US48906,19354,9678,9676,44626,57769,3337,48906
8600000US48910,27837,12777,15060,40271,49551,2183,48910
8600000US48911,30119,13601,16518,42817,54806,2076,48911
8600000US48912,14478,7380,7098,41517,53769,2957,48912
8600000US48915,7845,3584,4261,40234,57285,12282,48915
8600000US48917,26693,12622,14071,59393,77039,3884,48917
8600000US48921,0,0,0,,,,48921
8600000US48933,2175,1244,931,26008,37856,6007,48933
8600000US49001,15842,7804,8038,43238,54670,2589,49001
8600000US49002,16257,7785,8472,56288,74542,6422,49002
8600000US49004,12157,5637,6520,55950,66129,3487,49004
8600000US49006,25510,12532,12978,37403,55697,3553,49006
8600000US49007,8418,4477,3941,31463,46439,7453,49007
8600000US49008,13697,6638,7059,53100,81070,5948,49008
8600000US49009,35374,16585,18789,59557,88142,4909,49009
8600000US49010,13814,7282,6532,56111,65421,3303,49010
8600000US49011,1678,764,914,53000,60358,5418,49011
8600000US49012,2612,1293,1319,68311,79719,6805,49012
8600000US49013,4123,1991,2132,43136,56629,4253,49013
8600000US49014,16823,8446,8377,53046,63604,3281,49014
8600000US49015,20392,9862,10530,53208,71664,3932,49015
8600000US49017,16785,7724,9061,48921,62339,2919,49017
8600000US49021,4863,2444,2419,53201,65536,3214,49021
8600000US49022,23086,10731,12355,31876,45931,2771,49022
8600000US49024,22014,10261,11753,69179,91745,4260,49024
8600000US49026,1865,957,908,42708,54357,6941,49026
8600000US49027,96,54,42,36250,45476,13862,49027
8600000US49028,4904,2440,2464,52706,61480,3689,49028
8600000US49029,1115,519,596,59375,68290,11869,49029
8600000US49030,1583,808,775,53631,60873,4728,49030
8600000US49031,5954,2839,3115,49671,68988,9480,49031
8600000US49032,2435,1200,1235,54352,67069,6864,49032
8600000US49033,1377,644,733,72083,82948,10893,49033
8600000US49034,2077,1009,1068,62843,74622,5930,49034
8600000US49036,18615,9969,8646,49566,63073,3568,49036
8600000US49037,15769,7727,8042,31383,42855,3369,49037
8600000US49038,7316,3574,3742,54921,69198,6214,49038
8600000US49040,2432,1190,1242,45808,66117,12427,49040
8600000US49042,3775,1927,1848,49024,56711,4038,49042
8600000US49043,1627,745,882,27463,41194,5581,49043
8600000US49045,3950,2026,1924,49342,65509,11675,49045
8600000US49046,6321,3248,3073,62855,71642,9845,49046
8600000US49047,11627,5770,5857,45225,61384,3881,49047
8600000US49048,19206,9392,9814,44602,58965,4058,49048
8600000US49050,1314,691,623,59107,74351,11583,49050
8600000US49051,2091,958,1133,75254,91260,18592,49051
8600000US49052,725,349,376,50714,60539,8247,49052
8600000US49053,5409,2592,2817,61382,85730,8987,49053
8600000US49055,4755,2278,2477,56483,69200,5146,49055
8600000US49056,2771,1440,1331,40944,53510,7380,49056
8600000US49057,4620,2306,2314,45669,56397,4372,49057
8600000US49058,15005,7346,7659,56344,66955,2806,49058
8600000US49060,1340,685,655,63750,128836,52984,49060
8600000US49061,1304,723,581,70667,75408,9710,49061
8600000US49064,2935,1567,1368,56458,67598,7213,49064
8600000US49065,5143,2609,2534,53270,68348,4574,49065
8600000US49066,489,264,225,49728,53216,6273,49066
8600000US49067,3496,1773,1723,57589,77572,9977,49067
8600000US49068,11583,5568,6015,57394,74769,3730,49068
8600000US49070,2003,1000,1003,56667,64434,6272,49070
8600000US49071,7053,3213,3840,80987,97724,7112,49071
8600000US49072,2323,1225,1098,61739,74224,8726,49072
8600000US49073,3922,1990,1932,46587,59023,3940,49073
8600000US49074,135,24,111,25682,24300,5783,49074
8600000US49075,62,24,38,45625,42467,11009,49075
8600000US49076,3570,1787,1783,58576,70364,4189,49076
8600000US49078,7195,3332,3863,52795,64375,3533,49078
8600000US49079,10370,5222,5148,60852,73487,5819,49079
8600000US49080,12288,5872,6416,59969,73525,4551,49080
8600000US49082,4437,2184,2253,52600,65750,4783,49082
8600000US49083,5968,2896,3072,84905,108113,11075,49083
8600000US49084,23,7,16,,,,49084
8600000US49085,19221,9430,9791,71205,95523,5158,49085
8600000US49087,4861,2426,2435,83242,100307,8857,49087
8600000US49088,2956,1513,1443,83474,87806,9055,49088
8600000US49089,1369,706,663,53929,55492,4665,49089
8600000US49090,11193,5373,5820,47088,74899,6926,49090
8600000US49091,14796,7264,7532,46868,61407,3930,49091
8600000US49092,1492,729,763,44257,54446,3313,49092
8600000US49093,13788,6598,7190,51609,65322,3672,49093
8600000US49094,3188,1569,1619,49219,57742,4372,49094
8600000US49095,1677,845,832,66591,86815,12187,49095
8600000US49096,2401,1214,1187,56569,66605,3703,49096
8600000US49097,8479,4366,4113,68618,87744,5814,49097
8600000US49098,4434,1960,2474,43558,68731,8945,49098
8600000US49099,4360,2142,2218,49258,58270,3794,49099
8600000US49101,2326,1168,1158,54848,75139,7354,49101
8600000US49102,1285,621,664,64931,66191,9931,49102
8600000US49103,8586,4393,4193,44784,63044,5324,49103
8600000US49104,733,318,415,,,,49104
8600000US49106,4183,1990,2193,62266,81219,9813,49106
8600000US49107,7938,4004,3934,48548,63074,4239,49107
8600000US49111,2800,1434,1366,57896,66883,5456,49111
8600000US49112,7708,3738,3970,64331,82341,8057,49112
8600000US49113,1460,757,703,53143,67663,8253,49113
8600000US49115,447,221,226,67283,101446,39875,49115
8600000US49116,225,114,111,,226024,158018,49116
8600000US49117,3009,1397,1612,56190,106332,12307,49117
8600000US49119,107,58,49,88958,71619,26842,49119
8600000US49120,28257,13711,14546,47348,63420,3265,49120
8600000US49125,1966,915,1051,52457,78874,12344,49125
8600000US49126,872,391,481,55815,59107,4514,49126
8600000US49127,8197,4040,4157,66235,96462,7640,49127
8600000US49128,2754,1393,1361,53779,77310,11593,49128
8600000US49129,545,299,246,72917,120018,35874,49129
8600000US49130,1249,662,587,65431,81554,10352,49130
8600000US49201,37212,21906,15306,56212,73562,4204,49201
8600000US49202,14571,6415,8156,34505,46954,4412,49202
8600000US49203,28527,13283,15244,42512,58882,3757,49203
8600000US49220,1902,979,923,49000,57886,5443,49220
8600000US49221,32266,16489,15777,47350,61400,4113,49221
8600000US49224,10784,5043,5741,37416,52011,3054,49224
8600000US49227,908,470,438,51146,61587,6781,49227
8600000US49228,4086,2077,2009,57895,69397,4587,49228
8600000US49229,2603,1265,1338,79583,85773,8415,49229
8600000US49230,8280,4039,4241,62014,73220,3887,49230
8600000US49232,1897,940,957,50093,59543,5064,49232
8600000US49233,2162,1063,1099,57071,69912,7412,49233
8600000US49234,2406,1207,1199,76771,100102,11475,49234
8600000US49235,1584,765,819,49904,62483,6482,49235
8600000US49236,3595,1873,1722,63051,78068,7355,49236
8600000US49237,2204,1134,1070,57553,65921,4972,49237
8600000US49238,1268,628,640,62727,81970,15750,49238
8600000US49240,7532,3906,3626,83568,95661,7632,49240
8600000US49241,1958,929,1029,54506,85705,17419,49241
8600000US49242,11820,5522,6298,43014,58646,4581,49242
8600000US49245,3613,1775,1838,51642,61485,3616,49245
8600000US49246,2513,1207,1306,65893,74239,7453,49246
8600000US49247,4289,2069,2220,48834,60386,3990,49247
8600000US49248,590,319,271,56875,65063,8494,49248
8600000US49249,2998,1513,1485,54750,68580,7380,49249
8600000US49250,4702,2440,2262,51816,65096,4664,49250
8600000US49251,4696,2332,2364,64110,73491,4799,49251
8600000US49252,1856,956,900,41544,51065,3496,49252
8600000US49253,2394,1208,1186,57170,74571,11472,49253
8600000US49254,2234,1097,1137,48010,58865,10387,49254
8600000US49255,1486,753,733,45577,54096,4361,49255
8600000US49256,2889,1495,1394,42125,51981,3336,49256
8600000US49259,1691,890,801,56691,65586,8648,49259
8600000US49261,162,75,87,,78359,42853,49261
8600000US49262,904,470,434,46563,53159,5118,49262
8600000US49263,82,29,53,,51648,24062,49263
8600000US49264,1564,765,799,66042,76341,9298,49264
8600000US49265,4116,2077,2039,73594,92462,10270,49265
8600000US49266,2591,1312,1279,55880,61305,5503,49266
8600000US49267,3140,1652,1488,67857,77222,6541,49267
8600000US49268,951,479,472,50530,65505,9249,49268
8600000US49269,4653,2376,2277,58750,70956,7616,49269
8600000US49270,4624,2410,2214,75833,84462,6502,49270
8600000US49271,1557,799,758,47111,80392,24917,49271
8600000US49272,1918,970,948,61300,80321,19579,49272
8600000US49274,2593,1311,1282,48783,58053,3645,49274
8600000US49276,677,353,324,49226,83791,24105,49276
8600000US49277,2766,1376,1390,55398,64986,5609,49277
8600000US49279,625,289,336,49107,64158,13932,49279
8600000US49282,245,134,111,,44303,10922,49282
8600000US49283,3378,1524,1854,73160,71928,7964,49283
8600000US49284,2400,1279,1121,57000,69184,9319,49284
8600000US49285,4659,2294,2365,59661,73025,5332,49285
8600000US49286,11176,5310,5866,62470,76301,5098,49286
8600000US49287,1665,836,829,68264,77645,7322,49287
8600000US49288,1099,562,537,46979,57091,5535,49288
8600000US49289,121,61,60,,46887,19419,49289
8600000US49301,14636,7278,7358,127342,174720,13766,49301
8600000US49302,6321,3280,3041,86625,110237,9919,49302
8600000US49303,714,362,352,48684,60341,7316,49303
8600000US49304,3439,1766,1673,30208,42039,3774,49304
8600000US49305,1770,899,871,39028,57663,9544,49305
8600000US49306,8061,4239,3822,81279,99662,8888,49306
8600000US49307,17219,8658,8561,40089,56101,3984,49307
8600000US49309,1347,730,617,36208,50588,5870,49309
8600000US49310,2381,1171,1210,49717,60076,4138,49310
8600000US49312,231,112,119,32500,43623,8180,49312
8600000US49315,16564,8127,8437,77270,104502,8359,49315
8600000US49316,16534,8003,8531,84726,104524,7448,49316
8600000US49318,1224,651,573,52130,71723,10320,49318
8600000US49319,12577,6470,6107,65102,72606,4181,49319
8600000US49320,59,26,33,72625,64977,12732,49320
8600000US49321,13361,6772,6589,53686,68495,3776,49321
8600000US49322,1094,573,521,49773,60894,9519,49322
8600000US49323,7626,3909,3717,73387,82974,6685,49323
8600000US49325,1345,685,660,64821,72802,7512,49325
8600000US49326,3231,1692,1539,54850,85863,34259,49326
8600000US49327,6145,2980,3165,47347,59547,4626,49327
8600000US49328,3044,1579,1465,59338,71275,5061,49328
8600000US49329,6356,3150,3206,53654,65399,5051,49329
8600000US49330,4001,2015,1986,61591,70603,5923,49330
8600000US49331,13658,6554,7104,75728,90489,7718,49331
8600000US49332,2339,1151,1188,45074,57373,4605,49332
8600000US49333,8302,4063,4239,70032,79438,4319,49333
8600000US49335,279,197,82,43674,48606,10298,49335
8600000US49336,3185,1572,1613,44179,59975,7238,49336
8600000US49337,9423,4773,4650,44061,60871,5746,49337
8600000US49338,1372,760,612,49643,61836,9022,49338
8600000US49339,1596,838,758,56509,74705,19261,49339
8600000US49340,2168,1071,1097,43750,57944,6304,49340
8600000US49341,26384,12956,13428,92699,113085,6354,49341
8600000US49342,1515,761,754,52188,59193,4986,49342
8600000US49343,4318,2176,2142,62671,68646,5859,49343
8600000US49344,2586,1320,1266,62135,77659,8256,49344
8600000US49345,11039,5384,5655,61975,74117,5985,49345
8600000US49346,4706,2312,2394,56282,74826,6556,49346
8600000US49347,1056,551,505,54196,61927,5601,49347
8600000US49348,8963,4299,4664,63380,72058,4813,49348
8600000US49349,6166,3218,2948,42726,54326,3666,49349
8600000US49401,20298,9179,11119,44260,62456,3953,49401
8600000US49402,1063,562,501,39205,49638,4246,49402
8600000US49403,2024,1034,990,72188,92874,10313,49403
8600000US49404,6382,3116,3266,63472,76737,4873,49404
8600000US49405,1171,619,552,48846,57072,5260,49405
8600000US49406,656,308,348,82917,88920,14100,49406
8600000US49408,7576,3905,3671,58763,71827,4232,49408
8600000US49410,1468,722,746,36023,47032,5547,49410
8600000US49411,1240,636,604,52904,59084,4803,49411
8600000US49412,8696,4120,4576,53271,63483,3507,49412
8600000US49415,5424,2499,2925,61136,76981,6773,49415
8600000US49417,24497,12016,12481,64393,87727,4786,49417
8600000US49418,21413,10191,11222,66486,86001,5181,49418
8600000US49419,5945,3032,2913,73831,82646,4341,49419
8600000US49420,4926,2511,2415,42898,57757,6625,49420
8600000US49421,4445,2250,2195,43558,50508,4036,49421
8600000US49423,35358,17081,18277,56981,73737,2842,49423
8600000US49424,35861,17537,18324,66948,84550,3734,49424
8600000US49425,2841,1451,1390,52602,57687,3451,49425
8600000US49426,25992,12990,13002,80861,96029,3523,49426
8600000US49428,20298,9798,10500,73713,81831,3519,49428
8600000US49431,13953,6690,7263,50635,73868,6553,49431
8600000US49434,6,6,0,,,,49434
8600000US49435,3026,1458,1568,87979,98869,16084,49435
8600000US49436,1272,642,630,45759,55501,4588,49436
8600000US49437,5398,2636,2762,57599,67408,3750,49437
8600000US49440,857,341,516,14649,29104,8124,49440
8600000US49441,28268,13433,14835,48991,66809,3502,49441
8600000US49442,30942,14463,16479,37332,46870,1821,49442
8600000US49444,22831,12747,10084,39596,54249,3123,49444
8600000US49445,16339,8208,8131,63059,80401,3468,49445
8600000US49446,1983,982,1001,58092,72576,10643,49446
8600000US49448,2885,1548,1337,63182,82651,10739,49448
8600000US49449,2179,1057,1122,57569,73362,6471,49449
8600000US49450,2013,878,1135,41881,55923,14632,49450
8600000US49451,4337,2156,2181,58719,69399,4234,49451
8600000US49452,1496,777,719,50500,58029,4530,49452
8600000US49453,2130,1054,1076,76250,86375,10759,49453
8600000US49454,3594,1836,1758,51348,62160,6154,49454
8600000US49455,3509,1749,1760,44007,57040,4451,49455
8600000US49456,14807,7190,7617,66810,91997,4995,49456
8600000US49457,7692,3827,3865,56919,65753,3980,49457
8600000US49458,74,44,30,37500,41531,9877,49458
8600000US49459,1055,550,505,40625,47661,5082,49459
8600000US49460,6545,3461,3084,74500,93277,9487,49460
8600000US49461,7050,3373,3677,60428,72222,3652,49461
8600000US49464,20686,9871,10815,74663,85568,3787,49464
8600000US49503,29848,15213,14635,45660,66046,4158,49503
8600000US49504,30784,15358,15426,48604,63841,3253,49504
8600000US49505,25330,12228,13102,49322,62204,2967,49505
8600000US49506,25891,12295,13596,77004,110188,5843,49506
8600000US49507,25441,12314,13127,39788,49713,2171,49507
8600000US49508,30773,14204,16569,55580,66201,2398,49508
8600000US49509,20223,9599,10624,45645,57977,5069,49509
8600000US49512,13534,6569,6965,50216,67040,4127,49512
8600000US49519,22435,11214,11221,52368,65108,4048,49519
8600000US49525,22490,10451,12039,68695,96949,4735,49525
8600000US49534,16873,8271,8602,64806,76624,5234,49534
8600000US49544,8080,3583,4497,55486,65586,4830,49544
8600000US49546,26928,12624,14304,73079,108042,6265,49546
8600000US49548,24536,12092,12444,48314,54986,2278,49548
8600000US49601,16789,8337,8452,44614,59095,3180,49601
8600000US49611,167,88,79,38269,44266,13754,49611
8600000US49612,1004,508,496,51050,69269,10805,49612
8600000US49613,598,293,305,56000,73835,10201,49613
8600000US49614,2234,1110,1124,51094,62498,4220,49614
8600000US49615,3268,1620,1648,52321,70859,5488,49615
8600000US49616,1750,804,946,41585,53870,5094,49616
8600000US49617,2714,1460,1254,59440,65898,5175,49617
8600000US49618,556,310,246,44375,50663,5488,49618
8600000US49619,815,444,371,40750,56592,8403,49619
8600000US49620,2025,1038,987,54375,67490,8225,49620
8600000US49621,2860,1452,1408,63198,90563,10630,49621
8600000US49622,2078,1009,1069,50786,65302,7912,49622
8600000US49623,958,490,468,38125,42680,3702,49623
8600000US49625,983,500,483,44259,58263,8883,49625
8600000US49626,304,141,163,34821,43680,7335,49626
8600000US49627,147,85,62,44875,46970,15144,49627
8600000US49628,125,51,74,55000,50900,12963,49628
8600000US49629,1751,768,983,59091,80428,15899,49629
8600000US49630,1174,560,614,65817,82063,8227,49630
8600000US49631,4734,2378,2356,41315,52038,3825,49631
8600000US49632,823,425,398,44318,51556,3982,49632
8600000US49633,3033,1551,1482,45163,57262,4210,49633
8600000US49634,81,48,33,,81159,45239,49634
8600000US49635,3061,1440,1621,52222,72742,6585,49635
8600000US49636,381,192,189,76250,145543,39321,49636
8600000US49637,2774,1415,1359,45114,71584,18416,49637
8600000US49638,710,382,328,40625,48736,4468,49638
8600000US49639,1776,911,865,48203,56279,4698,49639
8600000US49640,1363,686,677,50446,65881,7542,49640
8600000US49642,608,285,323,19464,28242,4973,49642
8600000US49643,5429,2719,2710,62500,72470,5734,49643
8600000US49644,1984,1058,926,36875,46779,4583,49644
8600000US49645,1278,617,661,42361,54501,4384,49645
8600000US49646,6617,3305,3312,46947,59445,3897,49646
8600000US49648,1888,938,950,71289,99704,12029,49648
8600000US49649,5643,3337,2306,58371,76417,13439,49649
8600000US49650,2393,1173,1220,75110,74770,7204,49650
8600000US49651,6204,3154,3050,42909,53924,2725,49651
8600000US49653,1618,807,811,65341,84032,10134,49653
8600000US49654,488,234,254,61438,90515,22888,49654
8600000US49655,2523,1271,1252,45536,59306,5637,49655
8600000US49656,1295,633,662,38214,48722,3840,49656
8600000US49657,2650,1333,1317,55071,65894,4647,49657
8600000US49659,5137,2503,2634,41529,51911,4117,49659
8600000US49660,11859,6276,5583,48563,62157,3003,49660
8600000US49663,4579,2226,2353,43839,51154,2150,49663
8600000US49664,1645,835,810,57250,75538,5657,49664
8600000US49665,3200,1591,1609,39500,49799,3240,49665
8600000US49666,144,75,69,,,,49666
8600000US49667,463,225,238,39423,48532,4936,49667
8600000US49668,2487,1274,1213,41930,48437,3466,49668
8600000US49670,1768,878,890,51652,92486,15877,49670
8600000US49674,77,35,42,108571,108232,12227,49674
8600000US49675,832,411,421,60417,77565,9603,49675
8600000US49676,2891,1482,1409,54792,78424,9575,49676
8600000US49677,5611,2687,2924,39961,51434,3185,49677
8600000US49679,1001,501,500,46583,55633,5801,49679
8600000US49680,1534,775,759,47868,58277,4910,49680
8600000US49682,3374,1588,1786,66885,97464,13292,49682
8600000US49683,1665,910,755,43226,53954,4466,49683
8600000US49684,31828,15325,16503,60444,80179,4977,49684
8600000US49686,26676,12683,13993,63945,84871,4379,49686
8600000US49688,1937,1021,916,52218,66887,7160,49688
8600000US49689,1199,622,577,39833,58774,10519,49689
8600000US49690,5579,2634,2945,68176,95777,8322,49690
8600000US49701,852,418,434,39125,59989,10904,49701
8600000US49705,744,359,385,45000,50094,5257,49705
8600000US49706,3533,1685,1848,52305,57463,4390,49706
8600000US49707,17839,8687,9152,40994,54875,2359,49707
8600000US49709,3076,1574,1502,39809,48258,3555,49709
8600000US49710,432,246,186,39625,67670,18022,49710
8600000US49712,6350,3093,3257,58827,77357,4767,49712
8600000US49713,1616,854,762,54293,60659,4343,49713
8600000US49715,2645,1255,1390,55862,71165,7899,49715
8600000US49716,733,360,373,62000,87328,10525,49716
8600000US49717,137,66,71,132841,121088,64343,49717
8600000US49718,557,263,294,46471,52316,5570,49718
8600000US49719,1027,554,473,49076,62340,10109,49719
8600000US49720,7180,3474,3706,49939,76597,5447,49720
8600000US49721,11742,5759,5983,43191,55785,2256,49721
8600000US49722,269,146,123,51375,48319,18641,49722
8600000US49724,890,446,444,60313,63042,5726,49724
8600000US49725,592,292,300,40833,48182,6058,49725
8600000US49726,978,501,477,45455,50212,3916,49726
8600000US49727,5894,2920,2974,50742,68912,6807,49727
8600000US49728,224,119,105,41250,49116,8255,49728
8600000US49729,1265,653,612,54805,70563,6764,49729
8600000US49730,1797,919,878,51901,62621,8033,49730
8600000US49733,1708,855,853,49821,55683,4813,49733
8600000US49735,15378,7449,7929,53222,66544,3630,49735
8600000US49736,395,220,175,35813,53063,12640,49736
8600000US49738,7814,4018,3796,48431,58439,3754,49738
8600000US49740,5812,2897,2915,63617,89566,5276,49740
8600000US49743,611,319,292,38750,54151,13825,49743
8600000US49744,679,340,339,46625,54573,6521,49744
8600000US49745,850,418,432,50521,69149,15130,49745
8600000US49746,2816,1375,1441,44042,55040,5114,49746
8600000US49747,1576,787,789,40887,54561,3974,49747
8600000US49748,159,78,81,43750,47645,7126,49748
8600000US49749,3397,1763,1634,49688,61395,5654,49749
8600000US49751,1788,925,863,53438,59654,4145,49751
8600000US49752,643,462,181,55156,128519,115716,49752
8600000US49753,1623,853,770,48969,61724,5616,49753
8600000US49755,1630,838,792,42115,56633,5095,49755
8600000US49756,2989,1537,1452,41076,54809,8779,49756
8600000US49757,863,388,475,51141,64749,12758,49757
8600000US49759,1296,653,643,44722,56312,3796,49759
8600000US49760,596,315,281,47237,74939,20335,49760
8600000US49762,564,281,283,45938,49229,5450,49762
8600000US49764,167,75,92,42130,42582,14839,49764
8600000US49765,3057,1547,1510,43226,54533,4447,49765
8600000US49766,1710,798,912,46176,67367,13245,49766
8600000US49768,346,157,189,36857,46366,7371,49768
8600000US49769,1243,629,614,44655,50885,3631,49769
8600000US49770,13556,6448,7108,54941,76291,3714,49770
8600000US49774,1423,760,663,52826,57845,4099,49774
8600000US49775,78,44,34,39167,41874,8319,49775
8600000US49776,1528,758,770,43333,52356,3478,49776
8600000US49777,1537,753,784,63068,83928,11402,49777
8600000US49779,3742,1822,1920,45250,52503,3986,49779
8600000US49780,1501,720,781,53350,59480,4306,49780
8600000US49781,3013,1438,1575,43227,58714,4567,49781
8600000US49782,501,250,251,56500,72682,8106,49782
8600000US49783,15718,8080,7638,42209,58356,3353,49783
8600000US49788,4972,3879,1093,35907,44616,4329,49788
8600000US49791,278,129,149,60714,65338,11809,49791
8600000US49793,229,98,131,31429,44218,6753,49793
8600000US49795,1649,904,745,41923,51781,5433,49795
8600000US49796,320,173,147,54000,78375,19146,49796
8600000US49799,1775,913,862,44375,49380,3061,49799
8600000US49801,9035,4596,4439,53343,70438,6274,49801
8600000US49802,4822,2187,2635,41218,51299,4452,49802
8600000US49805,246,135,111,77292,77646,11881,49805
8600000US49806,419,196,223,66111,82615,28140,49806
8600000US49807,2702,1389,1313,56774,70467,8712,49807
8600000US49808,203,108,95,57656,62259,18884,49808
8600000US49812,698,361,337,47031,57876,6104,49812
8600000US49814,1117,541,576,55000,60146,4068,49814
8600000US49815,301,164,137,46250,47010,6427,49815
8600000US49816,619,362,257,56667,61208,6661,49816
8600000US49817,513,251,262,46250,60958,9584,49817
8600000US49818,802,411,391,58897,78245,15460,49818
8600000US49819,11,4,7,41875,38344,15636,49819
8600000US49820,240,118,122,,48121,12099,49820
8600000US49821,1063,551,512,46917,51245,4844,49821
8600000US49822,222,101,121,63500,66501,15852,49822
8600000US49825,124,66,58,38125,53696,13555,49825
8600000US49826,165,87,78,51705,48162,11152,49826
8600000US49827,733,378,355,51641,64041,9287,49827
8600000US49829,13681,6637,7044,39167,52839,2854,49829
8600000US49831,666,342,324,59688,78880,16040,49831
8600000US49833,255,139,116,85952,79415,13075,49833
8600000US49834,150,81,69,48500,53815,14515,49834
8600000US49835,714,370,344,47344,60524,7610,49835
8600000US49836,692,375,317,38854,46060,5510,49836
8600000US49837,7376,3689,3687,55914,69216,6912,49837
8600000US49838,404,236,168,31369,48898,10376,49838
8600000US49839,356,179,177,26806,35236,7364,49839
8600000US49840,519,264,255,47083,63554,8154,49840
8600000US49841,5583,2728,2855,44368,58116,3683,49841
8600000US49847,821,367,454,41571,51961,4596,49847
8600000US49848,71,29,42,38438,54180,16046,49848
8600000US49849,9841,4907,4934,51554,65102,4395,49849
8600000US49852,84,46,38,41250,54738,16458,49852
8600000US49853,1002,524,478,44583,58690,8535,49853
8600000US49854,5094,2453,2641,39240,52419,3706,49854
8600000US49855,28277,14301,13976,49155,65042,2949,49855
8600000US49858,9640,4776,4864,44959,62070,6757,49858
8600000US49861,477,236,241,51875,65690,8854,49861
8600000US49862,4394,2637,1757,43092,55261,3725,49862
8600000US49863,111,62,49,22813,23283,6417,49863
8600000US49864,61,30,31,28393,29378,4723,49864
8600000US49866,6021,2990,3031,56412,67775,3225,49866
8600000US49868,4365,2686,1679,42207,53466,3922,49868
8600000US49870,2764,1395,1369,48974,63162,10502,49870
8600000US49871,446,220,226,49896,56326,9658,49871
8600000US49872,154,74,80,47917,55714,11301,49872
8600000US49873,82,41,41,55833,58120,12310,49873
8600000US49874,792,364,428,40917,52239,7968,49874
8600000US49876,941,511,430,66979,62026,9905,49876
8600000US49877,14,8,6,,27113,20173,49877
8600000US49878,2792,1342,1450,51822,57667,2931,49878
8600000US49879,780,378,402,34737,44667,4889,49879
8600000US49880,817,400,417,54427,65965,9510,49880
8600000US49881,238,114,124,47875,57534,11832,49881
8600000US49883,135,77,58,,37492,19970,49883
8600000US49884,278,142,136,39519,51257,11453,49884
8600000US49885,1936,1035,901,60547,69738,5272,49885
8600000US49886,447,254,193,43929,48885,4172,49886
8600000US49887,2040,1037,1003,43973,53281,2954,49887
8600000US49891,459,239,220,51750,56893,11414,49891
8600000US49892,1509,792,717,61389,64972,3962,49892
8600000US49893,1238,694,544,52813,65161,7831,49893
8600000US49894,503,237,266,51417,70516,18887,49894
8600000US49895,656,293,363,41250,53582,8226,49895
8600000US49896,1271,625,646,47500,58985,4968,49896
8600000US49901,169,77,92,31042,41126,9047,49901
8600000US49902,120,48,72,28472,37275,11041,49902
8600000US49903,96,49,47,37500,43820,11502,49903
8600000US49905,1276,689,587,57904,62903,7668,49905
8600000US49908,2874,1923,951,41731,55073,6246,49908
8600000US49910,306,178,128,42031,59911,10544,49910
8600000US49911,2202,1115,1087,40563,56235,10535,49911
8600000US49912,824,456,368,34792,40562,3506,49912
8600000US49913,5366,2659,2707,39867,54027,7563,49913
8600000US49915,336,170,166,33077,39407,7291,49915
8600000US49916,2145,1129,1016,54943,73371,6213,49916
8600000US49917,169,79,90,40833,38017,6049,49917
8600000US49918,84,48,36,50000,68034,15810,49918
8600000US49919,185,99,86,43750,60624,16368,49919
8600000US49920,3552,1782,1770,41659,52199,4129,49920
8600000US49921,375,230,145,,43404,12787,49921
8600000US49922,551,296,255,46705,49693,8645,49922
8600000US49925,420,210,210,46979,51463,8297,49925
8600000US49927,420,223,197,46750,50309,8700,49927
8600000US49929,131,62,69,46250,47997,5684,49929
8600000US49930,5637,2862,2775,47153,61111,5376,49930
8600000US49931,8535,5397,3138,32527,48908,3845,49931
8600000US49934,644,322,322,49688,59311,11512,49934
8600000US49935,4810,2386,2424,37753,50956,4048,49935
8600000US49938,6295,3170,3125,36993,52943,5738,49938
8600000US49942,175,82,93,27112,45630,15762,49942
8600000US49945,2169,1120,1049,53304,75787,12288,49945
8600000US49946,2983,1429,1554,41739,56073,4762,49946
8600000US49947,1582,1346,236,47000,61366,7714,49947
8600000US49948,429,233,196,39500,45821,5161,49948
8600000US49950,1073,561,512,48500,65180,11826,49950
8600000US49952,86,50,36,60781,55304,10987,49952
8600000US49953,2194,1066,1128,40208,50592,4788,49953
8600000US49955,326,182,144,52946,54568,7388,49955
8600000US49958,658,344,314,50893,63588,11688,49958
8600000US49959,293,149,144,37083,53782,16969,49959
8600000US49960,151,70,81,34375,36570,5878,49960
8600000US49961,64,29,35,27917,40600,11735,49961
8600000US49962,218,105,113,42917,50410,10146,49962
8600000US49963,747,352,395,35441,75172,29745,49963
8600000US49965,417,183,234,38333,49231,9057,49965
8600000US49967,403,218,185,39464,55271,7484,49967
8600000US49968,1701,845,856,38580,57609,13706,49968
8600000US49969,1028,484,544,41375,54380,6324,49969
8600000US49970,259,152,107,46250,49089,7617,49970
8600000US49971,397,215,182,36328,43954,5390,49971
8600000US50001,527,238,289,90250,102824,23280,50001
8600000US50002,1116,579,537,53750,71370,12947,50002
8600000US50003,5183,2456,2727,85357,106681,9622,50003
8600000US50005,729,373,356,61161,67388,5390,50005
8600000US50006,1281,657,624,60568,69661,6082,50006
8600000US50007,344,174,170,93438,111329,22219,50007
8600000US50008,676,334,342,39353,46783,4929,50008
8600000US50009,14049,6792,7257,80181,95765,5252,50009
8600000US50010,28359,14659,13700,53887,69656,3235,50010
8600000US50011,1488,883,605,,,,50011
8600000US50012,4800,2724,2076,,,,50012
8600000US50014,26841,14829,12012,42342,64535,3963,50014
8600000US50020,1044,474,570,51250,62707,7938,50020
8600000US50021,20103,10000,10103,81186,103934,7803,50021
8600000US50022,6560,3288,3272,45951,59927,5052,50022
8600000US50023,26674,12944,13730,83054,101903,7690,50023
8600000US50025,2555,1217,1338,50599,63522,4476,50025
8600000US50026,484,237,247,51667,60058,12179,50026
8600000US50027,260,162,98,45893,52415,12058,50027
8600000US50028,1210,600,610,62837,81047,9535,50028
8600000US50029,437,236,201,53500,59907,7549,50029
8600000US50032,209,76,133,41311,43538,12615,50032
8600000US50033,24,9,15,108750,103088,36082,50033
8600000US50034,292,145,147,57125,73788,9200,50034
8600000US50035,4940,2319,2621,87292,98123,7710,50035
8600000US50036,12813,6330,6483,57151,71093,3573,50036
8600000US50038,67,36,31,,19446,12917,50038
8600000US50039,318,168,150,71477,83955,17456,50039
8600000US50041,70,35,35,,,,50041
8600000US50042,211,107,104,51786,53772,8299,50042
8600000US50044,695,325,370,52500,60387,7572,50044
8600000US50046,1138,519,619,73231,80871,8986,50046
8600000US50047,4332,2100,2232,68702,79483,6530,50047
8600000US50048,633,322,311,49417,58250,8368,50048
8600000US50049,4885,2397,2488,50015,68118,9793,50049
8600000US50050,544,260,284,46979,59786,8117,50050
8600000US50051,233,121,112,39750,61512,32379,50051
8600000US50052,114,60,54,53750,60860,16892,50052
8600000US50054,2290,1158,1132,64196,81903,10130,50054
8600000US50055,609,291,318,62656,75493,9363,50055
8600000US50056,1034,517,517,63125,79373,9226,50056
8600000US50057,159,94,65,55893,42721,13871,50057
8600000US50058,1417,684,733,54583,78217,13034,50058
8600000US50060,1964,943,1021,53042,64960,6385,50060
8600000US50061,1249,594,655,147578,195629,52491,50061
8600000US50062,491,230,261,41250,50844,7559,50062
8600000US50063,1790,933,857,72039,100824,25277,50063
8600000US50064,156,86,70,75625,66813,12494,50064
8600000US50065,558,291,267,30474,38965,8022,50065
8600000US50066,163,72,91,56250,76233,15280,50066
8600000US50067,197,100,97,46845,46056,7757,50067
8600000US50068,230,106,124,60000,67327,15641,50068
8600000US50069,725,374,351,67386,80690,10732,50069
8600000US50070,1149,567,582,70809,88182,11158,50070
8600000US50071,866,454,412,55694,68830,8364,50071
8600000US50072,1789,829,960,71759,91651,12102,50072
8600000US50073,862,427,435,62823,73966,12600,50073
8600000US50074,385,214,171,70156,121402,39534,50074
8600000US50075,631,323,308,71667,80187,12931,50075
8600000US50076,1168,556,612,48973,59095,6475,50076
8600000US50078,149,66,83,45625,48910,10379,50078
8600000US50101,17,7,10,,62318,45563,50101
8600000US50102,102,55,47,66667,67592,24459,50102
8600000US50103,339,177,162,57727,67627,11357,50103
8600000US50104,60,29,31,45313,57851,18644,50104
8600000US50105,662,313,349,87375,93316,7955,50105
8600000US50106,705,340,365,64286,66880,8992,50106
8600000US50107,877,421,456,50313,62295,6693,50107
8600000US50108,360,195,165,47798,57886,10860,50108
8600000US50109,2201,1179,1022,90952,108245,11649,50109
8600000US50111,9549,4783,4766,91265,116268,22426,50111
8600000US50112,9587,4315,5272,50625,74558,6129,50112
8600000US50115,2046,966,1080,53603,65494,7156,50115
8600000US50116,191,100,91,44167,51817,15605,50116
8600000US50117,99,45,54,,44640,20743,50117
8600000US50118,701,374,327,74583,80204,10489,50118
8600000US50119,323,156,167,61500,72129,22161,50119
8600000US50120,252,131,121,60625,67083,13768,50120
8600000US50122,1002,487,515,63984,74605,6319,50122
8600000US50123,554,319,235,48092,91780,46744,50123
8600000US50124,2802,1274,1528,90679,103061,13429,50124
8600000US50125,15631,7227,8404,65243,79056,4314,50125
8600000US50126,5474,2662,2812,51183,65218,7394,50126
8600000US50127,17,9,8,,,,50127
8600000US50128,314,165,149,48654,70686,17387,50128
8600000US50129,3782,1714,2068,56046,65887,4735,50129
8600000US50130,1162,597,565,62866,74345,10681,50130
8600000US50131,15462,7117,8345,98057,123139,8279,50131
8600000US50132,195,106,89,47500,59944,9168,50132
8600000US50133,286,138,148,44750,79843,39387,50133
8600000US50134,579,313,266,78500,89225,17137,50134
8600000US50135,1230,628,602,62500,74727,8801,50135
8600000US50136,318,159,159,52500,67452,19027,50136
8600000US50138,8954,4323,4631,53576,63893,4744,50138
8600000US50139,978,506,472,65000,79968,20393,50139
8600000US50140,2389,1164,1225,37072,55533,7411,50140
8600000US50141,411,233,178,53393,65973,10103,50141
8600000US50142,675,306,369,52202,65874,10408,50142
8600000US50143,547,266,281,65938,88166,19681,50143
8600000US50144,1966,973,993,44643,53168,5158,50144
8600000US50146,363,189,174,42039,56803,12086,50146
8600000US50147,245,136,109,57500,60409,16067,50147
8600000US50148,303,152,151,70054,68143,12310,50148
8600000US50149,703,364,339,47917,68363,14096,50149
8600000US50150,760,419,341,53828,58346,6514,50150
8600000US50151,474,233,241,77019,87686,16853,50151
8600000US50153,687,353,334,67500,98642,26196,50153
8600000US50154,296,137,159,63750,71417,9423,50154
8600000US50155,242,114,128,37750,43116,9419,50155
8600000US50156,3740,1803,1937,70788,83948,9349,50156
8600000US50157,632,336,296,52115,67059,13730,50157
8600000US50158,23266,11613,11653,52676,64032,2534,50158
8600000US50160,335,166,169,56429,57007,8127,50160
8600000US50161,1429,716,713,75250,89019,12516,50161
8600000US50162,940,516,424,58000,76512,14525,50162
8600000US50163,637,272,365,39375,47409,6655,50163
8600000US50164,374,180,194,61042,70045,12223,50164
8600000US50165,78,54,24,31486,42252,13218,50165
8600000US50166,1194,632,562,72031,80081,7438,50166
8600000US50167,487,242,245,59643,77994,21086,50167
8600000US50168,581,298,283,62813,72839,14215,50168
8600000US50169,2627,919,1708,61250,79845,12498,50169
8600000US50170,2119,1086,1033,65233,73820,7368,50170
8600000US50171,2044,1064,980,68690,81512,10513,50171
8600000US50173,709,371,338,51389,68018,15668,50173
8600000US50174,1049,533,516,47446,66511,8910,50174
8600000US50201,6123,2934,3189,64335,76127,5609,50201
8600000US50206,361,181,180,65536,79749,16514,50206
8600000US50207,1680,814,866,60227,89646,16586,50207
8600000US50208,16162,8300,7862,49576,60730,3173,50208
8600000US50210,1257,692,565,71667,81042,10795,50210
8600000US50211,9449,4657,4792,85935,101675,5875,50211
8600000US50212,2378,1186,1192,61891,79468,9399,50212
8600000US50213,5108,2494,2614,51688,65541,5843,50213
8600000US50214,523,234,289,69545,87366,25374,50214
8600000US50216,1994,1009,985,60927,75283,6938,50216
8600000US50217,496,260,236,67500,77970,12853,50217
8600000US50218,128,64,64,54013,55369,8007,50218
8600000US50219,10617,5287,5330,71068,82288,6159,50219
8600000US50220,6534,3214,3320,47727,62993,7116,50220
8600000US50222,391,169,222,66250,71026,16457,50222
8600000US50223,438,250,188,49732,52047,7640,50223
8600000US50225,2144,1109,1035,54295,69471,6429,50225
8600000US50226,4152,2103,2049,101111,115495,11684,50226
8600000US50227,16,7,9,76875,58311,24493,50227
8600000US50228,2015,949,1066,73047,80321,7388,50228
8600000US50229,678,357,321,103646,116948,13912,50229
8600000US50230,824,422,402,63889,72907,7822,50230
8600000US50231,122,70,52,58750,58635,9829,50231
8600000US50232,277,117,160,61000,70698,15817,50232
8600000US50233,1080,558,522,74265,76459,9451,50233
8600000US50234,456,238,218,64750,93076,25235,50234
8600000US50235,307,166,141,56563,56251,5440,50235
8600000US50236,1074,539,535,74583,93334,18425,50236
8600000US50237,2638,1366,1272,88583,99530,10513,50237
8600000US50238,938,473,465,49500,65701,9017,50238
8600000US50239,62,26,36,46250,50746,17718,50239
8600000US50240,2282,1180,1102,75512,89454,14930,50240
8600000US50242,374,193,181,61094,66491,14661,50242
8600000US50243,138,71,67,63125,69195,10491,50243
8600000US50244,1308,648,660,79107,87404,7916,50244
8600000US50246,499,262,237,59250,67833,7265,50246
8600000US50247,1873,927,946,64415,90064,17555,50247
8600000US50248,3307,1466,1841,74000,81374,9278,50248
8600000US50249,1008,541,467,57216,69854,6909,50249
8600000US50250,1711,795,916,55189,62679,5946,50250
8600000US50251,1054,531,523,65795,69737,4118,50251
8600000US50252,128,64,64,,78225,29070,50252
8600000US50254,208,100,108,73500,87336,20163,50254
8600000US50255,57,30,27,45625,56824,17186,50255
8600000US50256,325,141,184,63854,71609,11557,50256
8600000US50257,764,364,400,54814,62494,7408,50257
8600000US50258,769,371,398,62531,68118,8645,50258
8600000US50261,1845,937,908,106696,125942,16622,50261
8600000US50262,328,148,180,70938,77976,14975,50262
8600000US50263,16671,8051,8620,94103,119271,6856,50263
8600000US50264,328,177,151,43333,52735,10801,50264
8600000US50265,24647,12161,12486,70558,97138,5991,50265
8600000US50266,22602,10690,11912,76124,105051,6315,50266
8600000US50268,782,380,402,41534,52708,4940,50268
8600000US50271,459,225,234,57159,62470,8242,50271
8600000US50272,89,53,36,42500,53481,17715,50272
8600000US50273,6144,3057,3087,61655,82721,14150,50273
8600000US50274,198,72,126,49321,67992,21063,50274
8600000US50275,470,242,228,46250,54058,9648,50275
8600000US50276,1976,1057,919,72692,91621,11770,50276
8600000US50277,280,170,110,44500,56022,11953,50277
8600000US50278,619,315,304,59559,77825,16361,50278
8600000US50309,6500,3361,3139,44804,59344,6355,50309
8600000US50310,24886,12080,12806,61636,73232,3156,50310
8600000US50311,12483,5958,6525,47182,65568,4488,50311
8600000US50312,13273,6210,7063,63826,102527,7439,50312
8600000US50313,14254,7540,6714,53082,63709,4382,50313
8600000US50314,8164,3747,4417,39683,53227,5711,50314
8600000US50315,26862,12683,14179,48438,61210,4885,50315
8600000US50316,12305,6206,6099,44599,54837,4392,50316
8600000US50317,28703,14492,14211,52681,60336,2237,50317
8600000US50319,0,0,0,,,,50319
8600000US50320,15405,7439,7966,59073,70494,4320,50320
8600000US50321,6421,3005,3416,59059,86687,6830,50321
8600000US50322,24022,11703,12319,68845,88424,4186,50322
8600000US50323,9506,4694,4812,138333,158615,12878,50323
8600000US50324,3900,1743,2157,64337,81428,11374,50324
8600000US50325,12373,6096,6277,100574,128648,7141,50325
8600000US50327,8602,3942,4660,83237,95894,5164,50327
8600000US50401,22965,11064,11901,50722,65223,2879,50401
8600000US50420,229,113,116,59375,71046,18512,50420
8600000US50421,2304,1098,1206,47917,58867,5587,50421
8600000US50423,2030,962,1068,51500,59879,5234,50423
8600000US50424,1108,539,569,60484,69373,6041,50424
8600000US50426,43,24,19,40278,50817,22518,50426
8600000US50428,7528,3492,4036,57039,81661,9634,50428
8600000US50430,360,199,161,47955,60933,8941,50430
8600000US50431,140,76,64,50417,56171,14991,50431
8600000US50432,204,116,88,37115,46980,8284,50432
8600000US50433,216,95,121,66250,60077,11500,50433
8600000US50434,314,167,147,39821,59208,8047,50434
8600000US50435,534,275,259,63664,70215,14370,50435
8600000US50436,4586,2309,2277,51901,65749,5381,50436
8600000US50438,3139,1549,1590,67500,74977,4744,50438
8600000US50439,140,75,65,45000,54091,10357,50439
8600000US50440,445,234,211,65250,88697,13590,50440
8600000US50441,3999,1808,2191,53172,68981,9557,50441
8600000US50444,278,133,145,69167,77333,9340,50444
8600000US50446,392,206,186,61875,78882,16976,50446
8600000US50447,936,470,466,54219,63530,8586,50447
8600000US50448,550,301,249,42054,57990,10632,50448
8600000US50449,583,303,280,58553,68823,16653,50449
8600000US50450,2164,1073,1091,51250,63099,5093,50450
8600000US50451,388,215,173,40972,69069,26418,50451
8600000US50452,698,356,342,51667,59772,7459,50452
8600000US50453,423,209,214,59464,70238,14723,50453
8600000US50454,73,32,41,80441,59015,23068,50454
8600000US50455,377,194,183,54375,64643,9475,50455
8600000US50456,1394,635,759,55833,61449,5113,50456
8600000US50457,316,146,170,64028,81611,23495,50457
8600000US50458,1714,864,850,60893,75455,9431,50458
8600000US50459,2355,1191,1164,52238,68666,6136,50459
8600000US50460,266,169,97,79048,98904,25321,50460
8600000US50461,4383,2111,2272,56620,69414,6265,50461
8600000US50464,426,205,221,59667,89803,26784,50464
8600000US50465,132,53,79,24844,36127,10114,50465
8600000US50466,1116,559,557,53523,68238,9588,50466
8600000US50467,76,41,35,,61116,18206,50467
8600000US50468,1092,535,557,57125,71832,12414,50468
8600000US50469,1094,549,545,65938,76180,11323,50469
8600000US50470,192,93,99,34875,54343,14535,50470
8600000US50471,468,207,261,43063,53434,8299,50471
8600000US50472,1734,833,901,54145,68322,7854,50472
8600000US50473,227,111,116,88141,74715,12270,50473
8600000US50475,1225,632,593,52423,68801,8190,50475
8600000US50476,629,313,316,45625,61980,9665,50476
8600000US50477,197,100,97,57500,63524,12527,50477
8600000US50478,599,311,288,46406,57705,9539,50478
8600000US50479,421,211,210,42188,50228,5749,50479
8600000US50480,674,324,350,58021,63765,7595,50480
8600000US50482,686,330,356,66250,73798,8784,50482
8600000US50483,516,274,242,67500,70736,8891,50483
8600000US50484,335,163,172,57500,55621,8146,50484
8600000US50501,22225,11535,10690,41563,58731,2832,50501
8600000US50510,815,371,444,58214,73073,8258,50510
8600000US50511,5550,2576,2974,54905,67109,3965,50511
8600000US50514,1127,540,587,45143,53385,4857,50514
8600000US50515,196,92,104,30903,57754,23420,50515
8600000US50516,452,193,259,61364,69598,9963,50516
8600000US50517,836,431,405,51389,60999,6325,50517
8600000US50518,303,161,142,61250,57397,9285,50518
8600000US50519,457,244,213,50096,60128,7469,50519
8600000US50520,75,37,38,73750,72390,14299,50520
8600000US50521,213,111,102,21296,37658,18746,50521
8600000US50522,743,375,368,67500,76882,9425,50522
8600000US50523,537,299,238,44514,53682,13095,50523
8600000US50524,454,216,238,60694,78920,13515,50524
8600000US50525,2689,1319,1370,52426,68686,7542,50525
8600000US50527,186,107,79,47917,65029,18310,50527
8600000US50528,235,138,97,60625,80593,18053,50528
8600000US50529,584,290,294,47813,59351,7769,50529
8600000US50530,895,457,438,58333,62296,6794,50530
8600000US50531,212,108,104,102813,124653,51764,50531
8600000US50532,680,356,324,48000,64641,10213,50532
8600000US50533,2941,1459,1482,49593,63615,6614,50533
8600000US50535,738,385,353,51964,64617,10150,50535
8600000US50536,3530,1700,1830,52531,68923,6259,50536
8600000US50538,374,175,199,48500,58751,7244,50538
8600000US50539,411,218,193,54000,75446,16384,50539
8600000US50540,692,356,336,61534,65854,8043,50540
8600000US50541,625,314,311,54732,60449,6924,50541
8600000US50542,716,386,330,50673,68149,8815,50542
8600000US50543,1041,489,552,44792,58038,7151,50543
8600000US50544,286,163,123,59375,69988,11983,50544
8600000US50545,147,78,69,33558,122247,104820,50545
8600000US50546,197,99,98,38750,52634,15591,50546
8600000US50548,4388,2057,2331,54338,68149,4949,50548
8600000US50551,92,48,44,62917,61951,13921,50551
8600000US50554,1222,584,638,49417,61275,6459,50554
8600000US50556,180,85,95,47132,84751,46023,50556
8600000US50557,587,323,264,52045,56085,6539,50557
8600000US50558,457,241,216,57083,77633,25389,50558
8600000US50559,247,142,105,55208,60614,10926,50559
8600000US50560,507,269,238,47054,72130,16782,50560
8600000US50561,290,145,145,50357,76024,17340,50561
8600000US50562,299,146,153,53654,109467,37863,50562
8600000US50563,1901,933,968,50121,64952,7780,50563
8600000US50565,339,185,154,56250,75716,24595,50565
8600000US50566,337,177,160,62639,65146,11309,50566
8600000US50567,236,140,96,58500,63827,15704,50567
8600000US50568,1250,651,599,60917,72664,5805,50568
8600000US50569,548,242,306,45288,52133,5520,50569
8600000US50570,158,80,78,65875,70536,11671,50570
8600000US50571,324,148,176,60962,68219,11033,50571
8600000US50573,51,35,16,32375,46351,21590,50573
8600000US50574,1660,791,869,52188,60342,5416,50574
8600000US50575,798,379,419,51328,69175,11884,50575
8600000US50576,262,129,133,55577,57235,8960,50576
8600000US50577,323,163,160,52500,70545,16319,50577
8600000US50578,477,249,228,38281,49809,7486,50578
8600000US50579,2278,1373,905,46458,62547,5607,50579
8600000US50581,705,339,366,42823,59648,8089,50581
8600000US50582,210,98,112,38333,49887,11038,50582
8600000US50583,2124,1006,1118,51966,69060,6618,50583
8600000US50585,962,485,477,65081,71952,6964,50585
8600000US50586,206,118,88,52813,55501,7614,50586
8600000US50588,9251,4705,4546,52610,70520,5917,50588
8600000US50590,655,323,332,38864,51473,5492,50590
8600000US50591,307,163,144,59792,69871,7107,50591
8600000US50593,25,13,12,40000,40000,12762,50593
8600000US50594,172,103,69,44583,62550,17883,50594
8600000US50595,6968,3263,3705,52854,63335,4928,50595
8600000US50597,974,504,470,47500,58813,7247,50597
8600000US50598,687,367,320,61250,65045,6747,50598
8600000US50599,351,194,157,67750,71144,10270,50599
8600000US50601,2005,997,1008,51950,66875,5298,50601
8600000US50602,1170,605,565,56698,72544,10685,50602
8600000US50603,430,222,208,50625,58879,9635,50603
8600000US50604,1414,721,693,56483,73540,11229,50604
8600000US50605,239,149,90,60682,60323,9099,50605
8600000US50606,618,322,296,42344,61302,15792,50606
8600000US50607,329,170,159,62969,95831,43565,50607
8600000US50609,378,200,178,85909,91092,16591,50609
8600000US50611,267,115,152,57727,60861,10632,50611
8600000US50612,327,151,176,74750,126637,51921,50612
8600000US50613,35874,16536,19338,61379,85967,4944,50613
8600000US50616,7985,3842,4143,44417,62701,5400,50616
8600000US50619,1880,979,901,58523,80203,17160,50619
8600000US50620,36,17,19,59464,62174,22590,50620
8600000US50621,1194,531,663,56328,71247,9158,50621
8600000US50622,2405,1147,1258,78224,104998,13272,50622
8600000US50624,1216,582,634,84861,107905,13836,50624
8600000US50625,804,455,349,55167,61350,6957,50625
8600000US50626,1330,660,670,68929,76683,6061,50626
8600000US50627,2462,1189,1273,53067,62336,5633,50627
8600000US50628,919,462,457,54934,79684,26718,50628
8600000US50629,1650,819,831,70694,93292,15001,50629
8600000US50630,1418,694,724,55708,70973,11324,50630
8600000US50632,814,431,383,56875,72797,7597,50632
8600000US50633,338,187,151,76012,79140,14282,50633
8600000US50634,702,361,341,59773,71118,11871,50634
8600000US50635,1214,620,594,59338,70458,6493,50635
8600000US50636,1419,701,718,41985,60464,8852,50636
8600000US50638,2540,1199,1341,64231,78299,8205,50638
8600000US50641,1135,575,560,55000,109963,50716,50641
8600000US50642,379,187,192,68194,68278,13653,50642
8600000US50643,2193,1148,1045,85905,94240,6986,50643
8600000US50644,6636,3122,3514,59257,79543,10471,50644
8600000US50645,878,433,445,58182,70709,8958,50645
8600000US50647,1546,764,782,78898,80862,6712,50647
8600000US50648,3058,1585,1473,73536,78718,4348,50648
8600000US50650,667,334,333,47250,61786,9608,50650
8600000US50651,2626,1278,1348,63971,72896,6110,50651
8600000US50652,68,42,26,35313,36856,7987,50652
8600000US50653,443,219,224,57679,65063,9251,50653
8600000US50654,355,179,176,68750,78817,12531,50654
8600000US50655,574,294,280,53750,57959,5767,50655
8600000US50658,1784,873,911,63155,75083,7700,50658
8600000US50659,4142,2099,2043,53725,64627,4283,50659
8600000US50660,966,495,471,61250,72635,6911,50660
8600000US50662,5212,2438,2774,41609,56783,6313,50662
8600000US50664,76,38,38,61125,61692,4176,50664
8600000US50665,2192,1042,1150,60878,68450,5314,50665
8600000US50666,840,448,392,71625,77124,10759,50666
8600000US50667,547,252,295,69028,76691,8142,50667
8600000US50668,870,448,422,72875,68330,4871,50668
8600000US50669,1760,864,896,61429,87310,11976,50669
8600000US50670,1684,769,915,61210,76078,13442,50670
8600000US50671,150,71,79,50625,94494,68040,50671
8600000US50672,485,249,236,55481,60856,7543,50672
8600000US50673,136,71,65,62188,63591,10834,50673
8600000US50674,2931,1313,1618,67582,81653,7221,50674
8600000US50675,1824,866,958,58229,66926,6008,50675
8600000US50676,1547,804,743,56193,69655,8094,50676
8600000US50677,9861,4853,5008,68370,81315,4121,50677
8600000US50680,953,474,479,64632,87403,16935,50680
8600000US50681,354,181,173,59904,77022,15828,50681
8600000US50682,1335,667,668,67031,74974,8219,50682
8600000US50701,24309,12127,12182,54297,76431,3469,50701
8600000US50702,14963,7488,7475,49745,57605,2944,50702
8600000US50703,14337,7073,7264,33285,45390,3376,50703
8600000US50707,6592,3327,3265,49223,54324,3127,50707
8600000US50801,7337,3515,3822,45280,58822,4045,50801
8600000US50830,1378,656,722,54000,66098,5832,50830
8600000US50833,1810,864,946,54722,70191,11379,50833
8600000US50835,73,36,37,61964,64109,15975,50835
8600000US50836,209,89,120,35938,55263,21469,50836
8600000US50837,275,147,128,50000,62349,15033,50837
8600000US50839,37,21,16,47500,52723,21885,50839
8600000US50840,397,177,220,43393,50670,7316,50840
8600000US50841,2027,1022,1005,49276,63878,5890,50841
8600000US50842,80,40,40,50000,59673,12293,50842
8600000US50843,364,184,180,56250,59508,11195,50843
8600000US50845,625,309,316,53355,61811,6890,50845
8600000US50846,698,356,342,51125,67344,15183,50846
8600000US50847,74,38,36,36528,42812,10867,50847
8600000US50848,287,154,133,38125,48336,7105,50848
8600000US50849,1973,922,1051,50917,66155,6030,50849
8600000US50851,1528,756,772,46852,66232,7745,50851
8600000US50853,502,249,253,53214,55792,6997,50853
8600000US50854,2006,896,1110,48036,63351,6229,50854
8600000US50857,209,108,101,58162,60166,12261,50857
8600000US50858,581,298,283,53750,63158,9791,50858
8600000US50859,443,214,229,45714,65887,13390,50859
8600000US50860,157,77,80,46250,55643,19574,50860
8600000US50861,188,95,93,70139,112347,45219,50861
8600000US50862,137,75,62,78750,93383,33922,50862
8600000US50863,185,94,91,59375,74618,13080,50863
8600000US50864,1570,778,792,49886,60212,6580,50864
8600000US51001,1702,821,881,60547,70507,7862,51001
8600000US51002,2121,1027,1094,57774,79759,15272,51002
8600000US51003,1298,613,685,77857,82613,6560,51003
8600000US51004,780,404,376,53056,65183,10009,51004
8600000US51005,1147,589,558,69519,80213,6573,51005
8600000US51006,773,383,390,55833,72491,13197,51006
8600000US51007,374,192,182,77222,92874,18614,51007
8600000US51008,105,49,56,79107,84675,12642,51008
8600000US51009,100,57,43,42143,48482,12273,51009
8600000US51010,291,145,146,49531,59182,9934,51010
8600000US51011,68,32,36,54063,54682,15092,51011
8600000US51012,4915,2361,2554,51474,71301,8430,51012
8600000US51014,352,186,166,62188,80265,15657,51014
8600000US51016,967,461,506,46033,58239,6074,51016
8600000US51018,203,104,99,51875,58799,11524,51018
8600000US51019,670,326,344,62198,88475,27810,51019
8600000US51020,465,225,240,57188,67074,9084,51020
8600000US51022,486,260,226,61250,77155,10990,51022
8600000US51023,2312,1073,1239,54189,64707,6451,51023
8600000US51024,1486,706,780,73846,95142,11301,51024
8600000US51025,1536,771,765,58899,77396,9876,51025
8600000US51026,596,307,289,61979,73730,10259,51026
8600000US51027,961,461,500,65700,83284,20734,51027
8600000US51028,1642,735,907,62981,85043,11383,51028
8600000US51029,249,141,108,63015,70634,14878,51029
8600000US51030,1303,628,675,83542,85466,6143,51030
8600000US51031,9075,4374,4701,62269,76719,5385,51031
8600000US51033,295,168,127,43214,45597,6884,51033
8600000US51034,1401,672,729,50000,57218,4493,51034
8600000US51035,1320,678,642,57466,79375,9009,51035
8600000US51036,665,348,317,62466,79759,13489,51036
8600000US51037,283,162,121,40833,56016,15205,51037
8600000US51038,1375,769,606,63277,68145,7123,51038
8600000US51039,1846,876,970,69750,80633,5502,51039
8600000US51040,2855,1333,1522,38073,58463,6537,51040
8600000US51041,5636,2689,2947,74317,80985,7738,51041
8600000US51044,193,94,99,37212,54372,18131,51044
8600000US51046,1372,680,692,65793,69595,7131,51046
8600000US51047,560,298,262,48875,62662,8871,51047
8600000US51048,430,221,209,53646,61978,8324,51048
8600000US51049,378,193,185,51250,54550,10487,51049
8600000US51050,1916,909,1007,67881,79056,7779,51050
8600000US51051,74,43,31,31250,49800,22268,51051
8600000US51052,672,389,283,60917,74422,13343,51052
8600000US51053,777,384,393,57240,65192,5880,51053
8600000US51054,3894,1858,2036,80017,98559,16199,51054
8600000US51055,1144,539,605,64375,75669,7372,51055
8600000US51056,317,146,171,57188,64252,13809,51056
8600000US51058,638,341,297,54013,76303,21276,51058
8600000US51060,498,235,263,48000,64709,13448,51060
8600000US51061,321,167,154,59250,60666,9379,51061
8600000US51062,341,221,120,37083,57117,17591,51062
8600000US51063,871,416,455,56103,81194,19322,51063
8600000US51101,771,521,250,18143,29497,10836,51101
8600000US51103,12006,5677,6329,43161,53293,2640,51103
8600000US51104,16562,8128,8434,63592,79891,4709,51104
8600000US51105,7101,3458,3643,40171,47647,4507,51105
8600000US51106,20774,10210,10564,56795,75464,4865,51106
8600000US51108,3955,1894,2061,59983,80144,10511,51108
8600000US51109,2328,1194,1134,61429,61090,6308,51109
8600000US51111,108,64,44,58214,54848,17286,51111
8600000US51201,4672,2414,2258,49403,66446,8562,51201
8600000US51230,236,124,112,58857,65721,8862,51230
8600000US51231,250,131,119,65000,62891,15272,51231
8600000US51232,543,256,287,52734,60828,8491,51232
8600000US51234,946,472,474,58464,70764,8738,51234
8600000US51235,1005,525,480,78650,84224,9151,51235
8600000US51237,1265,589,676,58148,69346,9918,51237
8600000US51238,881,417,464,55592,61899,5893,51238
8600000US51239,2156,1111,1045,66429,74006,5780,51239
8600000US51240,1462,786,676,68623,73973,8980,51240
8600000US51241,1276,672,604,68098,81377,9875,51241
8600000US51242,151,77,74,69375,85381,47573,51242
8600000US51243,628,313,315,69375,66783,5197,51243
8600000US51244,66,29,37,62500,73772,26474,51244
8600000US51245,1017,517,500,49806,69919,9884,51245
8600000US51246,2432,1153,1279,60642,75454,6664,51246
8600000US51247,3510,1739,1771,71335,93155,13824,51247
8600000US51248,1441,696,745,62083,75561,9787,51248
8600000US51249,2517,1218,1299,56010,67035,5171,51249
8600000US51250,6120,3194,2926,75063,84126,6283,51250
8600000US51301,9546,4568,4978,46569,59588,4236,51301
8600000US51331,1066,562,504,48555,64701,8098,51331
8600000US51333,427,217,210,47448,62592,10218,51333
8600000US51334,5601,2843,2758,51549,77248,16307,51334
8600000US51338,728,373,355,50341,64197,7466,51338
8600000US51341,25,19,6,24375,32538,17083,51341
8600000US51342,923,467,456,54559,62671,5848,51342
8600000US51343,332,153,179,69625,82022,22837,51343
8600000US51345,350,186,164,69167,81448,17497,51345
8600000US51346,1674,792,882,51339,60769,5272,51346
8600000US51347,1184,583,601,67614,79157,8244,51347
8600000US51350,432,242,190,60000,62606,10038,51350
8600000US51351,3388,1682,1706,56848,80114,9350,51351
8600000US51354,754,370,384,55063,66441,12942,51354
8600000US51355,832,343,489,64722,109580,21124,51355
8600000US51357,413,202,211,54063,60182,6317,51357
8600000US51358,956,472,484,47241,56128,4171,51358
8600000US51360,6764,3285,3479,58818,81180,7038,51360
8600000US51363,152,80,72,42750,51918,9685,51363
8600000US51364,525,284,241,56875,66691,12783,51364
8600000US51365,209,96,113,46250,60297,10128,51365
8600000US51366,228,123,105,49474,72348,15251,51366
8600000US51401,9154,4376,4778,54327,69070,4160,51401
8600000US51430,621,300,321,62188,73033,5999,51430
8600000US51431,350,160,190,57250,68369,10951,51431
8600000US51433,420,197,223,53313,63399,14533,51433
8600000US51436,628,313,315,64167,75978,12849,51436
8600000US51439,752,396,356,50179,53605,4986,51439
8600000US51440,257,125,132,56250,68695,11528,51440
8600000US51441,351,161,190,30417,38930,8147,51441
8600000US51442,7220,3704,3516,53224,86537,25455,51442
8600000US51443,1226,663,563,67115,70432,7210,51443
8600000US51444,196,109,87,61964,66813,10037,51444
8600000US51445,2165,1056,1109,51875,81356,14909,51445
8600000US51446,438,178,260,48500,57991,9977,51446
8600000US51447,197,125,72,79875,76572,14800,51447
8600000US51448,369,184,185,41406,62656,9561,51448
8600000US51449,1730,810,920,50625,66833,7045,51449
8600000US51450,1251,598,653,64028,76314,8889,51450
8600000US51451,107,59,48,42188,58546,24819,51451
8600000US51453,534,254,280,54219,65343,8487,51453
8600000US51454,1092,546,546,52833,66462,10126,51454
8600000US51455,1784,859,925,60086,82232,9375,51455
8600000US51458,1112,547,565,50859,66486,11393,51458
8600000US51459,47,22,25,28750,50474,25910,51459
8600000US51461,885,475,410,61016,70587,6679,51461
8600000US51462,817,430,387,50759,68604,8847,51462
8600000US51463,407,198,209,65682,90184,16491,51463
8600000US51465,626,314,312,57143,68689,7825,51465
8600000US51466,763,344,419,68125,72577,8306,51466
8600000US51467,508,265,243,58750,75672,11824,51467
8600000US51501,26843,13123,13720,47036,55970,2709,51501
8600000US51503,28846,13782,15064,67555,81126,2333,51503
8600000US51510,2614,1259,1355,49028,86505,18518,51510
8600000US51520,178,103,75,59375,59121,11469,51520
8600000US51521,1406,685,721,62596,81717,9878,51521
8600000US51523,294,149,145,53750,79062,18162,51523
8600000US51525,886,419,467,61154,83192,13178,51525
8600000US51526,1366,636,730,73664,88028,10663,51526
8600000US51527,372,184,188,63750,70572,9115,51527
8600000US51528,588,273,315,44236,53038,7436,51528
8600000US51529,1350,696,654,57813,63777,5579,51529
8600000US51530,512,252,260,52564,69448,14271,51530
8600000US51531,560,254,306,60536,70661,8121,51531
8600000US51532,531,263,268,55625,58264,6745,51532
8600000US51533,684,329,355,60417,67849,8100,51533
8600000US51534,6992,3487,3505,72528,85315,5112,51534
8600000US51535,1288,664,624,58375,67698,8444,51535
8600000US51536,330,154,176,56696,67170,15759,51536
8600000US51537,5233,2513,2720,55063,71902,6146,51537
8600000US51540,302,150,152,50417,64697,16236,51540
8600000US51541,247,115,132,58333,61556,10345,51541
8600000US51542,862,442,420,103421,123575,25964,51542
8600000US51543,381,186,195,44125,53347,8045,51543
8600000US51544,559,278,281,62679,64216,8609,51544
8600000US51545,238,122,116,28125,41274,8585,51545
8600000US51546,2014,994,1020,66576,75606,5463,51546
8600000US51548,337,178,159,75625,83309,12746,51548
8600000US51549,404,197,207,65625,95850,17338,51549
8600000US51550,132,65,67,51250,66953,14329,51550
8600000US51551,1423,724,699,81875,103347,18551,51551
8600000US51552,233,105,128,48750,56520,16918,51552
8600000US51553,828,403,425,62768,81495,15905,51553
8600000US51554,150,75,75,62917,70604,20251,51554
8600000US51555,3755,1767,1988,60212,72970,5180,51555
8600000US51556,352,182,170,57500,74687,13044,51556
8600000US51557,668,380,288,72778,78368,11577,51557
8600000US51558,326,177,149,40000,53950,10677,51558
8600000US51559,1247,627,620,69028,81036,9304,51559
8600000US51560,1587,845,742,69375,84732,10954,51560
8600000US51561,1067,529,538,58523,82917,12708,51561
8600000US51562,296,137,159,67500,72314,13869,51562
8600000US51563,572,289,283,53125,68818,10961,51563
8600000US51564,341,159,182,43889,49945,7497,51564
8600000US51565,339,172,167,46354,68987,18511,51565
8600000US51566,4978,2359,2619,42395,62680,12785,51566
8600000US51570,788,368,420,54886,72592,11051,51570
8600000US51571,395,203,192,82813,100026,18928,51571
8600000US51572,362,167,195,41563,53286,10512,51572
8600000US51573,842,402,440,72417,86406,17045,51573
8600000US51575,1102,567,535,77875,102937,13110,51575
8600000US51576,1504,717,787,105147,109106,12963,51576
8600000US51577,894,443,451,54286,79899,11530,51577
8600000US51578,45,22,23,42500,63200,30361,51578
8600000US51579,1782,874,908,63580,74893,6775,51579
8600000US51601,4542,2153,2389,44746,56895,4611,51601
8600000US51630,180,87,93,60250,62811,8663,51630
8600000US51631,214,109,105,48333,99949,75925,51631
8600000US51632,5556,3059,2497,52576,64153,6089,51632
8600000US51636,333,172,161,63304,61896,7753,51636
8600000US51637,154,74,80,36023,41538,7504,51637
8600000US51638,1047,510,537,53417,73174,10274,51638
8600000US51639,604,294,310,46667,60784,6067,51639
8600000US51640,1149,560,589,47667,64276,7253,51640
8600000US51645,249,116,133,111964,119930,40032,51645
8600000US51646,584,346,238,51042,58110,6095,51646
8600000US51647,110,53,57,35179,49788,17551,51647
8600000US51648,210,103,107,76250,85464,14669,51648
8600000US51649,221,99,122,66705,68898,9156,51649
8600000US51650,265,144,121,49625,63990,10060,51650
8600000US51652,1267,682,585,51473,62917,6709,51652
8600000US51653,1227,590,637,65057,71712,6998,51653
8600000US51654,311,149,162,69107,78046,14778,51654
8600000US51656,49,22,27,42083,53743,18147,51656
8600000US52001,34432,16723,17709,49639,61587,2262,52001
8600000US52002,12362,5879,6483,72607,91805,7105,52002
8600000US52003,10424,4959,5465,72649,96191,6866,52003
8600000US52030,309,140,169,47750,56719,8251,52030
8600000US52031,3982,1983,1999,62647,82096,7052,52031
8600000US52032,1240,699,541,73684,80936,9901,52032
8600000US52033,2389,1116,1273,64180,72913,8233,52033
8600000US52035,802,429,373,59408,60676,7124,52035
8600000US52037,854,424,430,63333,79217,12004,52037
8600000US52038,432,220,212,76875,87235,33298,52038
8600000US52039,774,386,388,91250,98287,15188,52039
8600000US52040,4491,2300,2191,64688,69738,5767,52040
8600000US52041,1258,677,581,60625,69990,6460,52041
8600000US52042,1107,486,621,57679,67136,7599,52042
8600000US52043,1747,826,921,50625,59866,4930,52043
8600000US52044,97,50,47,74250,80125,15629,52044
8600000US52045,1823,930,893,75086,77558,7363,52045
8600000US52046,1890,954,936,71027,84859,9936,52046
8600000US52047,491,247,244,54583,67557,20394,52047
8600000US52048,302,158,144,59643,70808,19446,52048
8600000US52049,1219,624,595,56917,69912,6809,52049
8600000US52050,357,179,178,67813,87637,20012,52050
8600000US52052,2597,1344,1253,50625,63560,5583,52052
8600000US52053,848,448,400,74750,77928,6625,52053
8600000US52054,712,385,327,83438,83851,11613,52054
8600000US52057,5926,2884,3042,57083,81370,15598,52057
8600000US52060,6421,3050,3371,46772,59187,4918,52060
8600000US52064,746,369,377,58929,81731,14594,52064
8600000US52065,785,401,384,61786,74504,9594,52065
8600000US52066,55,25,30,29375,35692,10825,52066
8600000US52068,3073,1602,1471,92257,128021,33758,52068
8600000US52069,1145,593,552,59297,66378,6009,52069
8600000US52070,715,383,332,51964,58096,7588,52070
8600000US52072,155,74,81,62396,73995,10238,52072
8600000US52073,1024,523,501,82500,87920,9155,52073
8600000US52074,261,134,127,56875,55201,12345,52074
8600000US52076,1773,905,868,50839,58735,5200,52076
8600000US52077,254,119,135,62500,65638,13753,52077
8600000US52078,542,267,275,64091,69471,9562,52078
8600000US52079,704,454,250,52609,76422,15691,52079
8600000US52101,11244,5371,5873,64406,75844,3785,52101
8600000US52132,1413,719,694,56029,76150,12709,52132
8600000US52133,477,227,250,63333,68237,7893,52133
8600000US52134,274,139,135,39167,55721,14909,52134
8600000US52135,564,251,313,46696,53231,5566,52135
8600000US52136,4437,2175,2262,52377,66377,4415,52136
8600000US52140,559,273,286,43906,58870,17192,52140
8600000US52141,1025,545,480,54338,66977,7135,52141
8600000US52142,1558,887,671,46346,76843,30424,52142
8600000US52144,1032,550,482,66855,74676,8949,52144
8600000US52146,834,468,366,52083,64842,8113,52146
8600000US52147,875,467,408,65909,78481,11130,52147
8600000US52151,1393,713,680,54286,66187,6936,52151
8600000US52154,668,350,318,54219,83130,30263,52154
8600000US52155,1050,523,527,55000,71986,11603,52155
8600000US52156,440,240,200,56136,97834,36000,52156
8600000US52157,1456,709,747,41107,62622,10384,52157
8600000US52158,217,124,93,45962,48048,7053,52158
8600000US52159,1777,844,933,53056,69519,7153,52159
8600000US52160,698,382,316,41591,56853,10231,52160
8600000US52161,1136,594,542,63482,83845,16295,52161
8600000US52162,2366,1277,1089,47000,60602,6243,52162
8600000US52163,246,114,132,47500,53534,7752,52163
8600000US52164,270,129,141,68958,81713,22575,52164
8600000US52165,556,295,261,51923,59502,9301,52165
8600000US52166,98,46,52,46667,52272,9875,52166
8600000US52168,197,115,82,41953,53714,12533,52168
8600000US52169,269,141,128,68194,70881,16404,52169
8600000US52170,439,240,199,66181,86601,21347,52170
8600000US52171,710,356,354,63646,79914,11596,52171
8600000US52172,4664,2227,2437,49640,63698,6780,52172
8600000US52175,2764,1349,1415,51234,62057,7203,52175
8600000US52201,1129,616,513,77734,77734,7196,52201
8600000US52202,732,375,357,80179,86975,10774,52202
8600000US52203,1587,819,768,74500,96677,16957,52203
8600000US52205,7247,4082,3165,53887,64874,4386,52205
8600000US52206,1795,932,863,95938,133475,35485,52206
8600000US52207,320,174,146,57188,95028,31442,52207
8600000US52208,2350,1128,1222,52656,63205,6706,52208
8600000US52209,762,373,389,69167,72059,7785,52209
8600000US52210,480,241,239,55156,112893,68005,52210
8600000US52211,1959,1068,891,56860,73276,6391,52211
8600000US52212,207,114,93,48393,60556,23856,52212
8600000US52213,2994,1440,1554,76518,83471,6729,52213
8600000US52214,2769,1333,1436,72917,91035,8398,52214
8600000US52215,583,334,249,66875,72514,11033,52215
8600000US52216,1003,502,501,52188,67385,10255,52216
8600000US52217,455,211,244,51488,58623,11044,52217
8600000US52218,1421,707,714,65536,70338,8883,52218
8600000US52219,160,98,62,48750,60047,14845,52219
8600000US52220,221,113,108,58571,56840,15822,52220
8600000US52221,196,120,76,65156,60439,9769,52221
8600000US52222,426,188,238,45000,52685,9667,52222
8600000US52223,1084,546,538,39831,60018,9528,52223
8600000US52224,1644,834,810,68667,75232,6993,52224
8600000US52225,227,120,107,50781,53417,7528,52225
8600000US52227,2219,1116,1103,100234,112508,13290,52227
8600000US52228,2271,1167,1104,93664,105874,10822,52228
8600000US52229,542,290,252,63393,93956,36999,52229
8600000US52231,154,81,73,64531,69577,11663,52231
8600000US52232,132,63,69,54500,56338,13478,52232
8600000US52233,5432,2667,2765,43406,62985,5386,52233
8600000US52235,649,314,335,57344,67722,6595,52235
8600000US52236,527,261,266,56154,75103,13800,52236
8600000US52237,1192,670,522,80833,84960,20719,52237
8600000US52240,29453,14474,14979,42964,69143,5448,52240
8600000US52241,16082,8436,7646,65635,98349,9433,52241
8600000US52242,1567,811,756,,,,52242
8600000US52245,20536,10431,10105,64224,84727,5176,52245
8600000US52246,19228,9392,9836,49030,77681,5110,52246
8600000US52247,4072,1856,2216,63074,72655,6553,52247
8600000US52248,1315,640,675,56979,82140,16076,52248
8600000US52249,727,360,367,65938,69693,8461,52249
8600000US52251,442,238,204,63000,85493,31502,52251
8600000US52253,2450,1209,1241,71875,88647,15058,52253
8600000US52254,671,359,312,52115,58724,5858,52254
8600000US52255,1116,576,540,62898,70899,11190,52255
8600000US52257,199,101,98,78167,79299,14183,52257
8600000US52301,2773,1340,1433,50250,68250,8897,52301
8600000US52302,30514,14336,16178,70347,85910,2955,52302
8600000US52305,430,206,224,53000,77294,22900,52305
8600000US52306,1288,612,676,61111,73047,11036,52306
8600000US52307,163,103,60,,130433,102896,52307
8600000US52308,122,66,56,61875,60037,14593,52308
8600000US52309,340,175,165,62917,74424,20010,52309
8600000US52310,4871,2317,2554,56646,83283,7510,52310
8600000US52312,67,27,40,29444,33769,8931,52312
8600000US52313,256,136,120,69531,67816,12205,52313
8600000US52314,4410,2260,2150,81280,94274,14806,52314
8600000US52315,935,449,486,57955,69165,9500,52315
8600000US52316,1123,532,591,57788,74078,12415,52316
8600000US52317,14408,6491,7917,82835,97888,7907,52317
8600000US52318,622,340,282,64732,78927,15184,52318
8600000US52320,936,481,455,50476,60231,9932,52320
8600000US52321,328,154,174,55278,52159,7359,52321
8600000US52322,2058,1031,1027,64482,79969,10022,52322
8600000US52323,735,381,354,60917,64587,10966,52323
8600000US52324,1536,834,702,93333,105768,15873,52324
8600000US52325,640,382,258,49550,79646,26489,52325
8600000US52326,440,243,197,59375,64503,8443,52326
8600000US52327,2334,1165,1169,75313,95251,12454,52327
8600000US52328,2242,1164,1078,129205,162602,17941,52328
8600000US52329,683,343,340,64861,92060,39785,52329
8600000US52330,577,278,299,62143,72577,11644,52330
8600000US52332,1553,700,853,65268,73821,7342,52332
8600000US52333,5098,2500,2598,104899,118464,20901,52333
8600000US52334,137,80,57,59659,54203,34586,52334
8600000US52335,558,286,272,41818,57892,8833,52335
8600000US52336,1728,873,855,64087,73906,6568,52336
8600000US52337,516,254,262,50577,60299,9619,52337
8600000US52338,2589,1339,1250,101513,124333,8913,52338
8600000US52339,2950,1428,1522,51356,57825,4445,52339
8600000US52340,2309,1071,1238,76133,84760,11931,52340
8600000US52341,920,477,443,98313,123721,39617,52341
8600000US52342,2488,1171,1317,52283,64178,6095,52342
8600000US52345,1116,571,545,85057,87548,6606,52345
8600000US52346,914,447,467,72292,80508,10588,52346
8600000US52347,1041,532,509,66389,70630,5978,52347
8600000US52348,54,25,29,52500,57879,20342,52348
8600000US52349,6011,2949,3062,54576,76538,7951,52349
8600000US52351,1040,546,494,105729,118017,11710,52351
8600000US52352,1149,583,566,80139,85790,11042,52352
8600000US52353,7038,3372,3666,55141,67970,5489,52353
8600000US52354,312,160,152,70179,86780,20030,52354
8600000US52355,226,113,113,54688,63962,11248,52355
8600000US52356,1952,954,998,68836,81238,8101,52356
8600000US52358,2841,1431,1410,72000,84851,9209,52358
8600000US52359,185,107,78,39330,60538,21639,52359
8600000US52361,3610,1695,1915,58365,82260,19486,52361
8600000US52362,662,308,354,54107,62155,7614,52362
8600000US52401,1737,1076,661,37188,58734,19997,52401
8600000US52402,32139,15576,16563,63690,83151,4927,52402
8600000US52403,18169,8725,9444,62506,86860,5283,52403
8600000US52404,29814,14610,15204,52539,66345,3302,52404
8600000US52405,20044,9666,10378,62014,70231,2251,52405
8600000US52411,5927,3011,2916,127361,154804,10633,52411
8600000US52501,22935,11255,11680,43600,59311,4221,52501
8600000US52530,872,417,455,49886,59680,8473,52530
8600000US52531,4423,2133,2290,46809,64642,8792,52531
8600000US52533,1053,552,501,52321,65033,11162,52533
8600000US52534,284,168,116,36500,47422,10835,52534
8600000US52535,771,393,378,45917,55847,6790,52535
8600000US52536,723,350,373,39375,57252,11647,52536
8600000US52537,5198,2606,2592,59787,72526,5096,52537
8600000US52540,1061,554,507,48438,55012,7016,52540
8600000US52542,286,153,133,47083,72831,35039,52542
8600000US52543,236,125,111,93636,89705,18953,52543
8600000US52544,5734,2704,3030,36725,61859,10617,52544
8600000US52548,80,38,42,52500,62058,21687,52548
8600000US52549,656,307,349,50089,59398,8020,52549
8600000US52550,332,150,182,36050,45214,10999,52550
8600000US52551,425,195,230,65673,81870,20579,52551
8600000US52552,650,331,319,52411,61963,11305,52552
8600000US52553,1449,764,685,56429,63124,6559,52553
8600000US52554,1082,521,561,44875,52105,5860,52554
8600000US52555,301,147,154,49688,54008,8381,52555
8600000US52556,11351,5628,5723,41382,64832,9567,52556
8600000US52557,64,64,0,,,,52557
8600000US52560,242,118,124,28393,53897,21830,52560
8600000US52561,679,352,327,53750,62873,8326,52561
8600000US52563,1120,583,537,65184,71633,11740,52563
8600000US52565,1352,652,700,44265,61123,9267,52565
8600000US52566,158,74,84,58438,56467,9888,52566
8600000US52567,619,351,268,59338,68802,14579,52567
8600000US52569,512,293,219,43000,52697,7252,52569
8600000US52570,664,342,322,48958,99119,47510,52570
8600000US52571,1284,609,675,49023,63268,7922,52571
8600000US52572,712,387,325,40417,50339,5921,52572
8600000US52573,154,79,75,83125,213009,209554,52573
8600000US52574,597,326,271,38889,48056,5426,52574
8600000US52576,471,289,182,38750,53544,10500,52576
8600000US52577,11526,5663,5863,50394,62156,4311,52577
8600000US52580,486,259,227,56429,59521,11648,52580
8600000US52581,264,139,125,51250,76912,28947,52581
8600000US52583,242,105,137,53571,65389,22831,52583
8600000US52584,412,200,212,74000,80184,26709,52584
8600000US52585,775,394,381,62361,72960,9783,52585
8600000US52586,371,198,173,49375,60948,10497,52586
8600000US52588,34,25,9,,,,52588
8600000US52590,836,373,463,40000,49253,9180,52590
8600000US52591,2336,1143,1193,52283,74466,12203,52591
8600000US52593,142,74,68,71563,130756,90949,52593
8600000US52594,234,117,117,62813,78908,29494,52594
8600000US52595,288,153,135,41058,47897,8309,52595
8600000US52601,22336,10778,11558,48419,64566,3820,52601
8600000US52619,563,290,273,49464,57064,13276,52619
8600000US52620,617,305,312,51167,62276,10884,52620
8600000US52621,549,285,264,60000,81982,17911,52621
8600000US52623,1427,724,703,57500,74010,8083,52623
8600000US52624,203,104,99,43672,53941,14847,52624
8600000US52625,2105,1043,1062,55382,64080,6679,52625
8600000US52626,953,478,475,43750,51285,6476,52626
8600000US52627,9879,5080,4799,45413,61203,3980,52627
8600000US52630,361,200,161,48438,60365,9520,52630
8600000US52632,9651,4614,5037,40933,56300,3254,52632
8600000US52635,674,330,344,37188,50621,12922,52635
8600000US52637,1918,881,1037,61892,67345,5521,52637
8600000US52638,444,219,225,64375,70129,8989,52638
8600000US52639,1703,876,827,62139,69380,7422,52639
8600000US52640,1082,509,573,57174,72670,7526,52640
8600000US52641,9794,5119,4675,53922,72170,5803,52641
8600000US52644,319,164,155,66607,78078,12777,52644
8600000US52645,2584,1294,1290,53250,59315,3934,52645
8600000US52646,227,112,115,45750,50631,9264,52646
8600000US52647,150,74,76,57500,56126,9201,52647
8600000US52649,676,334,342,39338,69254,26282,52649
8600000US52650,600,300,300,72578,66921,13289,52650
8600000US52651,627,381,246,44239,54364,8746,52651
8600000US52653,2603,1286,1317,60885,77950,9405,52653
8600000US52654,1177,576,601,53542,65616,7647,52654
8600000US52655,3347,1567,1780,48468,65477,9779,52655
8600000US52656,2001,1011,990,65477,84491,16022,52656
8600000US52657,59,27,32,59107,66448,10252,52657
8600000US52658,672,358,314,60360,67383,12043,52658
8600000US52659,1089,522,567,49375,66607,8391,52659
8600000US52660,108,68,40,32188,33963,10130,52660
8600000US52701,63,33,30,56750,59286,9124,52701
8600000US52720,752,379,373,66722,75726,15110,52720
8600000US52721,622,348,274,73750,96201,20292,52721
8600000US52722,27714,13023,14691,78557,100457,4484,52722
8600000US52726,3744,1926,1818,84214,94173,8914,52726
8600000US52727,328,178,150,50167,82473,25118,52727
8600000US52728,840,428,412,55083,62135,10587,52728
8600000US52729,618,350,268,60000,66418,7001,52729
8600000US52730,3761,1978,1783,49782,62747,6225,52730
8600000US52731,576,295,281,63015,67122,8810,52731
8600000US52732,21344,9902,11442,43709,59577,2322,52732
8600000US52737,343,168,175,56250,57295,7827,52737
8600000US52738,2874,1458,1416,46650,59841,6912,52738
8600000US52739,414,215,199,42188,54786,14187,52739
8600000US52742,5525,2697,2828,63722,83133,8476,52742
8600000US52745,436,252,184,54583,64552,13867,52745
8600000US52746,833,423,410,72500,94894,19800,52746
8600000US52747,1407,643,764,61964,73434,6892,52747
8600000US52748,7279,3771,3508,74931,90867,8655,52748
8600000US52749,751,383,368,80625,87235,14413,52749
8600000US52750,403,212,191,81250,89811,12295,52750
8600000US52751,800,424,376,69643,73441,8618,52751
8600000US52752,396,201,195,55500,62871,9607,52752
8600000US52753,4026,1967,2059,92073,128168,21710,52753
8600000US52754,1177,562,615,60313,81285,14668,52754
8600000US52755,1356,674,682,70972,72060,5962,52755
8600000US52756,1584,826,758,104375,116393,13981,52756
8600000US52757,157,84,73,52083,57903,11343,52757
8600000US52758,158,78,80,72292,81785,15440,52758
8600000US52760,233,64,169,50063,52084,23039,52760
8600000US52761,22825,11155,11670,55132,69280,4187,52761
8600000US52765,273,152,121,51406,76843,14772,52765
8600000US52766,669,344,325,56500,67355,10281,52766
8600000US52767,182,72,110,,63046,29260,52767
8600000US52768,1338,700,638,69135,80549,9490,52768
8600000US52769,498,247,251,75714,78729,12846,52769
8600000US52772,3962,1890,2072,66483,71071,5437,52772
8600000US52773,1854,935,919,62895,70559,5293,52773
8600000US52774,102,54,48,61250,78156,19281,52774
8600000US52776,3637,1924,1713,61588,76167,10271,52776
8600000US52777,861,419,442,58021,68691,6698,52777
8600000US52778,3486,1743,1743,59442,80118,12253,52778
8600000US52801,1068,707,361,28625,42012,8059,52801
8600000US52802,7622,4001,3621,39173,53091,5587,52802
8600000US52803,17181,8216,8965,48117,69889,5297,52803
8600000US52804,22086,10834,11252,49051,60268,3277,52804
8600000US52806,20859,9452,11407,53609,65074,3752,52806
8600000US52807,12084,5925,6159,60783,84224,6691,52807
8600000US53001,1486,751,735,71389,91157,10116,53001
8600000US53002,1899,977,922,82137,91708,10799,53002
8600000US53003,158,104,54,50417,70906,20219,53003
8600000US53004,2584,1304,1280,79360,87007,5151,53004
8600000US53005,15234,7483,7751,101528,136053,9741,53005
8600000US53006,1357,711,646,68929,80195,7238,53006
8600000US53007,1536,793,743,42250,55599,5204,53007
8600000US53010,6030,3107,2923,67852,81667,4498,53010
8600000US53011,1730,891,839,77188,94067,9550,53011
8600000US53012,14410,6979,7431,90671,120464,10470,53012
8600000US53013,2601,1283,1318,66917,82321,6582,53013
8600000US53014,6128,3161,2967,59978,72459,4414,53014
8600000US53015,2049,1120,929,71827,83696,5200,53015
8600000US53016,294,151,143,53958,62229,8900,53016
8600000US53017,4470,2297,2173,108561,135359,15696,53017
8600000US53018,6120,2945,3175,1e+05,132029,17340,53018
8600000US53019,1495,776,719,73929,80843,5560,53019
8600000US53020,3056,1575,1481,73690,94640,8325,53020
8600000US53021,3872,2002,1870,85823,103223,13613,53021
8600000US53022,14540,6967,7573,80015,103876,6657,53022
8600000US53023,2164,1643,521,73750,99546,20443,53023
8600000US53024,13262,6448,6814,79300,98157,6073,53024
8600000US53027,17460,8887,8573,68080,81209,3472,53027
8600000US53029,16235,7942,8293,98768,137065,7469,53029
8600000US53031,0,0,0,,,,53031
8600000US53032,3549,1796,1753,63587,78230,12971,53032
8600000US53033,4176,2105,2071,95000,121186,12644,53033
8600000US53034,1322,639,683,64083,72399,6204,53034
8600000US53035,1906,970,936,65707,78918,6733,53035
8600000US53036,2264,1143,1121,76563,84555,8324,53036
8600000US53037,7514,3490,4024,81136,94209,7602,53037
8600000US53038,3167,1539,1628,81058,90059,7438,53038
8600000US53039,3703,1935,1768,63304,70164,3891,53039
8600000US53040,6221,3155,3066,72614,90266,12001,53040
8600000US53042,5179,2527,2652,61466,71403,4226,53042
8600000US53044,1742,835,907,83750,122889,14280,53044
8600000US53045,16839,7944,8895,105706,147213,8331,53045
8600000US53046,956,471,485,60227,77765,10075,53046
8600000US53047,31,16,15,128750,297040,311309,53047
8600000US53048,2585,1314,1271,54429,65424,4619,53048
8600000US53049,2295,1208,1087,82731,86774,6914,53049
8600000US53050,5201,2524,2677,56329,62821,4060,53050
8600000US53051,28600,13543,15057,79257,104962,3824,53051
8600000US53057,1237,633,604,68796,80312,8763,53057
8600000US53058,2707,1365,1342,90903,136295,12930,53058
8600000US53059,1511,807,704,72143,85148,7218,53059
8600000US53061,4023,2161,1862,59052,67920,5849,53061
8600000US53063,1214,648,566,69044,83467,9598,53063
8600000US53065,1763,873,890,68750,83635,7164,53065
8600000US53066,26591,13298,13293,92221,118869,6197,53066
8600000US53069,528,271,257,118125,102142,17457,53069
8600000US53070,3653,1786,1867,64764,79346,5345,53070
8600000US53072,20191,9798,10393,85631,124329,6997,53072
8600000US53073,11849,5450,6399,60278,76710,3833,53073
8600000US53074,10237,5009,5228,68273,80578,4989,53074
8600000US53075,2554,1298,1256,68438,78761,5401,53075
8600000US53076,3076,1503,1573,105562,128085,14308,53076
8600000US53078,1396,754,642,77105,87572,7924,53078
8600000US53079,1161,591,570,71563,76326,4826,53079
8600000US53080,4518,2199,2319,54127,73160,12748,53080
8600000US53081,32621,16507,16114,48407,57639,1752,53081
8600000US53083,15240,7462,7778,70110,83525,4320,53083
8600000US53085,9082,4451,4631,57193,71819,4210,53085
8600000US53086,6175,3162,3013,80434,98944,8049,53086
8600000US53088,347,175,172,58092,64677,9303,53088
8600000US53089,14445,7066,7379,91826,110296,5982,53089
8600000US53090,16894,8394,8500,69807,78542,2420,53090
8600000US53091,1534,773,761,60781,68278,3638,53091
8600000US53092,16292,7793,8499,102628,158757,12925,53092
8600000US53093,1528,792,736,80139,87497,8286,53093
8600000US53094,14769,7140,7629,53697,65182,3584,53094
8600000US53095,21780,10599,11181,62705,84218,6337,53095
8600000US53097,5097,2386,2711,121818,185059,21635,53097
8600000US53098,9309,4559,4750,54355,68467,3402,53098
8600000US53103,3105,1638,1467,93348,121778,22437,53103
8600000US53104,4267,2224,2043,78804,94832,7981,53104
8600000US53105,22968,11287,11681,70857,86004,4168,53105
8600000US53108,2668,1320,1348,70329,81204,10583,53108
8600000US53110,14787,7080,7707,52594,64009,4686,53110
8600000US53114,2222,1189,1033,70667,82888,7640,53114
8600000US53115,12356,6129,6227,57243,71480,3822,53115
8600000US53118,5768,2772,2996,81250,97439,7315,53118
8600000US53119,4385,2162,2223,91875,104143,8355,53119
8600000US53120,7544,3710,3834,71226,85443,6232,53120
8600000US53121,14445,7181,7264,69335,82365,5017,53121
8600000US53122,4726,2032,2694,115972,165129,22535,53122
8600000US53125,1495,730,765,83250,114105,8375,53125
8600000US53126,5463,2797,2666,81995,98608,8587,53126
8600000US53128,6551,3239,3312,62105,71475,4915,53128
8600000US53129,10998,5197,5801,71584,87989,5985,53129
8600000US53130,6033,3023,3010,72349,95675,11381,53130
8600000US53132,28318,14616,13702,80193,103848,4977,53132
8600000US53137,1315,638,677,81912,94382,14501,53137
8600000US53139,2074,1021,1053,76500,90049,12965,53139
8600000US53140,22982,11194,11788,41727,56060,3500,53140
8600000US53142,24766,12092,12674,71615,88420,4368,53142
8600000US53143,17432,8235,9197,47298,64211,5580,53143
8600000US53144,20461,10161,10300,58939,79324,5884,53144
8600000US53146,6627,3346,3281,85819,115863,14838,53146
8600000US53147,12912,6258,6654,60554,84354,5569,53147
8600000US53149,15209,7481,7728,94046,104892,4298,53149
8600000US53150,19540,9646,9894,89371,107962,4866,53150
8600000US53151,25564,12465,13099,79438,101616,5715,53151
8600000US53153,1876,926,950,94583,116706,12182,53153
8600000US53154,27710,13781,13929,72705,89594,5828,53154
8600000US53156,2356,1120,1236,61250,72638,6263,53156
8600000US53158,13129,6320,6809,81897,99086,6492,53158
8600000US53167,557,243,314,52754,58636,18125,53167
8600000US53168,6500,3325,3175,74236,87741,5267,53168
8600000US53170,1759,942,817,64720,89473,11670,53170
8600000US53172,16647,8003,8644,52048,64517,3882,53172
8600000US53177,6947,4281,2666,69420,79596,4705,53177
8600000US53178,2260,1106,1154,62305,71914,5515,53178
8600000US53179,5454,2658,2796,71034,88660,7528,53179
8600000US53181,5889,2869,3020,67868,94572,10689,53181
8600000US53182,7585,3452,4133,67823,91539,6936,53182
8600000US53183,2166,1076,1090,97768,136101,23980,53183
8600000US53184,3172,1522,1650,54342,66809,4559,53184
8600000US53185,14631,7430,7201,92159,107411,5094,53185
8600000US53186,27165,13107,14058,59353,73533,2620,53186
8600000US53188,28393,13483,14910,65043,87078,4437,53188
8600000US53189,20081,9876,10205,90017,105226,4903,53189
8600000US53190,16884,8730,8154,45551,58541,3054,53190
8600000US53191,2276,1026,1250,58188,78266,8699,53191
8600000US53192,51,0,51,,,,53192
8600000US53195,107,66,41,53750,50366,15868,53195
8600000US53202,24276,12452,11824,53695,85580,6097,53202
8600000US53203,1458,840,618,63036,99549,16373,53203
8600000US53204,25446,13071,12375,29641,43460,2717,53204
8600000US53205,5963,2337,3626,21510,32394,2624,53205
8600000US53206,15614,6822,8792,23491,34352,2332,53206
8600000US53207,29926,14793,15133,60697,69549,1894,53207
8600000US53208,21149,10329,10820,32440,51061,2783,53208
8600000US53209,33040,14760,18280,34342,50143,2271,53209
8600000US53210,18054,7460,10594,35833,48164,2450,53210
8600000US53211,30947,15826,15121,61450,95917,4496,53211
8600000US53212,23535,11365,12170,36147,54236,3989,53212
8600000US53213,21242,9968,11274,78304,101093,4980,53213
8600000US53214,28007,13951,14056,45721,55696,2037,53214
8600000US53215,41859,20768,21091,37223,47282,2050,53215
8600000US53216,24497,10496,14001,35674,48145,2583,53216
8600000US53217,21948,10470,11478,105358,147628,5694,53217
8600000US53218,28225,11771,16454,38818,50207,3426,53218
8600000US53219,27066,13020,14046,54849,64792,4013,53219
8600000US53220,21043,9674,11369,53328,68125,4980,53220
8600000US53221,30478,14415,16063,49354,62483,2671,53221
8600000US53222,20061,9411,10650,58574,69576,2702,53222
8600000US53223,21651,9351,12300,48222,55783,2666,53223
8600000US53224,15336,7070,8266,48684,61920,3980,53224
8600000US53225,18998,8364,10634,43304,54091,2523,53225
8600000US53226,15201,7191,8010,72381,93861,5161,53226
8600000US53227,19341,8942,10399,50809,61010,2580,53227
8600000US53228,12148,5813,6335,64255,76840,3558,53228
8600000US53233,13812,7471,6341,14700,26102,3940,53233
8600000US53235,8187,3990,4197,43207,59395,5767,53235
8600000US53295,181,163,18,,,,53295
8600000US53402,25217,12349,12868,60482,77498,3049,53402
8600000US53403,19263,9431,9832,42877,59000,3252,53403
8600000US53404,11092,5474,5618,38873,54357,5239,53404
8600000US53405,18872,9026,9846,54119,63981,2976,53405
8600000US53406,20696,9285,11411,61017,79893,3588,53406
8600000US53501,109,55,54,,,,53501
8600000US53502,1917,966,951,56488,69677,4263,53502
8600000US53503,1511,771,740,59200,75952,8091,53503
8600000US53504,1536,813,723,56944,73052,6768,53504
8600000US53505,327,169,158,72500,125871,44194,53505
8600000US53506,887,459,428,43125,61508,11825,53506
8600000US53507,1559,754,805,90870,100957,7533,53507
8600000US53508,4262,2100,2162,85464,96944,5217,53508
8600000US53510,1066,501,565,64152,69593,5270,53510
8600000US53511,37251,18014,19237,46025,58628,2146,53511
8600000US53515,1818,924,894,70774,92514,11063,53515
8600000US53516,1775,875,900,67438,79872,5914,53516
8600000US53517,1441,735,706,80938,94937,6817,53517
8600000US53518,1039,544,495,50500,59714,4367,53518
8600000US53520,5151,2582,2569,57207,66483,3568,53520
8600000US53521,2960,1483,1477,87593,99957,6059,53521
8600000US53522,815,417,398,58571,69758,5109,53522
8600000US53523,4153,2015,2138,81327,99806,8390,53523
8600000US53525,3060,1515,1545,69777,73265,4834,53525
8600000US53526,497,245,252,56346,75517,9034,53526
8600000US53527,7832,3908,3924,93510,107290,7193,53527
8600000US53528,4715,2386,2329,86326,104205,7034,53528
8600000US53529,1757,957,800,81838,93983,6672,53529
8600000US53530,3290,1622,1668,57179,68881,3582,53530
8600000US53531,3605,1923,1682,81063,100534,9863,53531
8600000US53532,11307,5464,5843,83263,100368,7672,53532
8600000US53533,5481,2754,2727,61875,86582,8355,53533
8600000US53534,9477,4856,4621,66468,75962,5712,53534
8600000US53536,6414,3050,3364,68394,77643,5751,53536
8600000US53537,683,316,367,51797,62973,8886,53537
8600000US53538,14372,6930,7442,60289,76478,5937,53538
8600000US53540,174,85,89,36136,47131,10043,53540
8600000US53541,725,368,357,65208,80094,9990,53541
8600000US53543,1340,689,651,57000,71904,5261,53543
8600000US53544,618,315,303,75313,97932,9914,53544
8600000US53545,18640,9070,9570,52571,68569,3917,53545
8600000US53546,23517,11275,12242,62368,74934,4958,53546
8600000US53548,13658,6447,7211,50993,66277,3873,53548
8600000US53549,8245,4171,4074,60051,70823,3922,53549
8600000US53550,847,427,420,63977,74056,8408,53550
8600000US53551,6601,3392,3209,69913,80128,4582,53551
8600000US53553,449,194,255,50536,59066,10706,53553
8600000US53554,837,445,392,56000,64656,5842,53554
8600000US53555,6630,3425,3205,78358,94566,7112,53555
8600000US53556,2059,1056,1003,50769,63894,4873,53556
8600000US53557,303,153,150,52813,59185,6649,53557
8600000US53558,9013,4339,4674,91772,101401,6517,53558
8600000US53559,4605,2306,2299,70958,81592,6570,53559
8600000US53560,2952,1482,1470,71477,87600,6375,53560
8600000US53561,1495,768,727,78365,104228,14293,53561
8600000US53562,19777,9571,10206,83871,127850,9182,53562
8600000US53563,8344,4104,4240,74518,89728,5753,53563
8600000US53565,3618,1804,1814,62500,76656,5234,53565
8600000US53566,11878,5699,6179,53176,69331,3695,53566
8600000US53569,925,488,437,56667,82922,19733,53569
8600000US53570,1965,1022,943,66750,78795,7351,53570
8600000US53571,117,60,57,101354,95982,18586,53571
8600000US53572,7633,3865,3768,77003,92199,5955,53572
8600000US53573,2470,1267,1203,47462,58790,3980,53573
8600000US53574,2917,1393,1524,78031,94186,5444,53574
8600000US53575,12671,6594,6077,92091,112148,6430,53575
8600000US53576,1735,901,834,63553,73142,5819,53576
8600000US53577,1110,569,541,65341,83832,8324,53577
8600000US53578,4619,2279,2340,65845,82899,6055,53578
8600000US53579,1407,751,656,60655,69184,6281,53579
8600000US53580,424,223,201,57734,65747,8036,53580
8600000US53581,7942,3862,4080,51539,61464,3187,53581
8600000US53582,859,421,438,61250,75057,6264,53582
8600000US53583,4754,2353,2401,70929,83316,6037,53583
8600000US53585,1713,821,892,49875,65049,6229,53585
8600000US53586,1740,917,823,56036,67650,6642,53586
8600000US53587,938,482,456,59063,71474,8073,53587
8600000US53588,3348,1636,1712,61898,76291,4156,53588
8600000US53589,15501,7505,7996,70585,88703,5975,53589
8600000US53590,29408,14120,15288,75287,87792,2877,53590
8600000US53593,16916,8132,8784,103281,134694,7016,53593
8600000US53594,4073,2169,1904,75709,78372,7320,53594
8600000US53597,13785,6496,7289,104489,123032,6231,53597
8600000US53598,1981,1021,960,91921,111240,17727,53598
8600000US53599,39,18,21,31250,31930,12380,53599
8600000US53702,107,53,54,,,,53702
8600000US53703,32573,16947,15626,39367,63728,2925,53703
8600000US53704,36593,17563,19030,60257,75351,2492,53704
8600000US53705,20741,9803,10938,67786,96238,4379,53705
8600000US53706,5996,2935,3061,9856,11931,6045,53706
8600000US53711,39012,18729,20283,77652,101943,3971,53711
8600000US53713,17037,8744,8293,42094,58261,4498,53713
8600000US53714,12934,6226,6708,55783,65394,3142,53714
8600000US53715,13579,7568,6011,30561,52199,7043,53715
8600000US53716,14654,7007,7647,71298,88370,5403,53716
8600000US53717,10115,4586,5529,80125,112271,8951,53717
8600000US53718,11189,5059,6130,81826,93390,5469,53718
8600000US53719,24442,12769,11673,80805,97895,5697,53719
8600000US53726,4744,2419,2325,41653,92023,15367,53726
8600000US53792,0,0,0,,,,53792
8600000US53801,674,371,303,49167,55839,4497,53801
8600000US53802,29,17,12,15625,25770,8082,53802
8600000US53803,965,474,491,56875,69615,7520,53803
8600000US53804,1028,509,519,51364,65444,6254,53804
8600000US53805,4114,2218,1896,45964,62860,6064,53805
8600000US53806,1360,689,671,52500,59858,4056,53806
8600000US53807,3677,1833,1844,67712,74291,3286,53807
8600000US53808,922,462,460,55000,61811,6065,53808
8600000US53809,3129,1602,1527,57500,68204,3846,53809
8600000US53810,280,135,145,56406,76381,12377,53810
8600000US53811,2594,1146,1448,61375,69808,4663,53811
8600000US53813,4493,2240,2253,55992,68103,5087,53813
8600000US53816,555,278,277,59821,71463,6834,53816
8600000US53817,137,69,68,53125,57027,9411,53817
8600000US53818,13886,7645,6241,49898,61760,2949,53818
8600000US53820,1859,954,905,56563,68296,6313,53820
8600000US53821,6699,3577,3122,48361,62527,4654,53821
8600000US53825,346,185,161,48958,62656,11749,53825
8600000US53826,902,474,428,49219,57869,5660,53826
8600000US53827,201,98,103,58125,62448,9242,53827
8600000US53901,11846,6274,5572,49990,67172,3650,53901
8600000US53910,2608,1340,1268,33915,47176,4350,53910
8600000US53911,917,464,453,83512,87181,5113,53911
8600000US53913,16213,7855,8358,50309,64483,4130,53913
8600000US53916,17498,8803,8695,53997,68963,3612,53916
8600000US53919,2097,1046,1051,69200,79565,5692,53919
8600000US53920,364,206,158,46875,58178,6185,53920
8600000US53922,738,384,354,66985,81786,7860,53922
8600000US53923,1418,705,713,64853,73715,5563,53923
8600000US53924,1105,544,561,51450,61657,5039,53924
8600000US53925,5951,2926,3025,65361,81674,6424,53925
8600000US53926,1103,553,550,56875,69923,9502,53926
8600000US53928,75,35,40,61875,57326,9272,53928
8600000US53929,2009,1005,1004,51982,64459,3856,53929
8600000US53930,1019,516,503,57500,68648,4622,53930
8600000US53931,202,133,69,67500,67806,8240,53931
8600000US53932,1930,967,963,74537,84539,5040,53932
8600000US53933,3795,2657,1138,55495,68435,6449,53933
8600000US53934,3748,1944,1804,38320,49406,2574,53934
8600000US53935,195,90,105,56042,63784,17450,53935
8600000US53936,2265,1621,644,41546,51578,4614,53936
8600000US53937,781,412,369,56667,67102,5094,53937
8600000US53939,198,109,89,51250,65235,15232,53939
8600000US53941,2309,1172,1137,59447,71301,4323,53941
8600000US53943,802,412,390,58750,80768,8878,53943
8600000US53944,1621,871,750,51509,66416,6468,53944
8600000US53946,3339,1705,1634,59557,71817,4556,53946
8600000US53947,124,61,63,47679,54644,16716,53947
8600000US53948,6547,3398,3149,50363,63621,4836,53948
8600000US53949,4925,2510,2415,46859,55606,2468,53949
8600000US53950,4586,2804,1782,52813,75416,8582,53950
8600000US53951,1710,883,827,50238,65151,5187,53951
8600000US53952,2650,1323,1327,49851,64857,6293,53952
8600000US53953,177,93,84,33750,42866,7583,53953
8600000US53954,5214,2663,2551,68316,78025,3476,53954
8600000US53955,4485,2292,2193,78063,92728,6569,53955
8600000US53956,2484,1243,1241,56008,71890,5082,53956
8600000US53959,10361,5108,5253,59589,72778,5841,53959
8600000US53960,2738,1378,1360,70156,78680,4644,53960
8600000US53961,678,354,324,63194,77656,9883,53961
8600000US53963,11079,6340,4739,57184,67123,4192,53963
8600000US53964,2723,1331,1392,49444,58819,2753,53964
8600000US53965,8280,4166,4114,51806,67784,5701,53965
8600000US53968,1722,860,862,52250,66564,5509,53968
8600000US53969,342,155,187,54297,60069,9984,53969
8600000US54001,6098,2947,3151,60442,70483,3814,54001
8600000US54002,4693,2226,2467,65788,77271,5903,54002
8600000US54003,793,421,372,85000,97997,15902,54003
8600000US54004,1798,956,842,53710,65641,4476,54004
8600000US54005,2234,1201,1033,59597,68147,4233,54005
8600000US54006,548,288,260,46912,61358,9439,54006
8600000US54007,868,475,393,60789,69488,6462,54007
8600000US54009,1963,1015,948,71406,79536,4313,54009
8600000US54010,8,0,8,,,,54010
8600000US54011,5226,2683,2543,80466,88034,6189,54011
8600000US54013,2617,1300,1317,62926,75312,4311,54013
8600000US54014,1651,883,768,73393,86487,6195,54014
8600000US54015,2581,1288,1293,80395,88292,3755,54015
8600000US54016,24025,11843,12182,94004,113762,4372,54016
8600000US54017,13028,6512,6516,73115,86881,7019,54017
8600000US54020,5313,2484,2829,64196,76931,3772,54020
8600000US54021,5072,2717,2355,84866,98008,6387,54021
8600000US54022,18665,8554,10111,71281,89449,3769,54022
8600000US54023,2946,1507,1439,82917,91130,4486,54023
8600000US54024,3911,1916,1995,54702,69442,3535,54024
8600000US54025,5401,2737,2664,78011,89100,6784,54025
8600000US54026,1450,777,673,61550,81611,9083,54026
8600000US54027,774,389,385,71375,82005,7748,54027
8600000US54028,1798,904,894,56458,70218,5311,54028
8600000US54082,1123,594,529,116250,143126,26288,54082
8600000US54101,2096,1066,1030,75234,79858,4727,54101
8600000US54102,728,382,346,35598,44240,5090,54102
8600000US54103,441,257,184,42250,54301,5369,54103
8600000US54104,1024,547,477,42019,52140,5853,54104
8600000US54106,4003,2113,1890,66218,71900,3921,54106
8600000US54107,2732,1377,1355,60500,71024,3570,54107
8600000US54110,3951,1938,2013,66537,76265,4023,54110
8600000US54111,1819,897,922,62761,71935,5521,54111
8600000US54112,1806,964,842,52045,59160,4182,54112
8600000US54113,2618,1213,1405,69423,85951,10231,54113
8600000US54114,4264,2089,2175,44496,55531,3489,54114
8600000US54115,34224,16744,17480,76267,91632,3958,54115
8600000US54119,691,354,337,43462,57461,6410,54119
8600000US54120,214,111,103,35000,41043,6162,54120
8600000US54121,2457,1276,1181,51136,74322,11019,54121
8600000US54123,203,109,94,50278,59253,11504,54123
8600000US54124,2813,1520,1293,47500,60283,4746,54124
8600000US54125,455,217,238,37188,57793,12843,54125
8600000US54126,2752,1489,1263,71738,87654,6128,54126
8600000US54127,55,31,24,,79638,48028,54127
8600000US54128,1260,650,610,57250,62691,4855,54128
8600000US54129,2360,1231,1129,67356,83251,6744,54129
8600000US54130,19485,9792,9693,66193,79772,3985,54130
8600000US54135,2226,1009,1217,45476,69770,11430,54135
8600000US54136,4695,2217,2478,49291,59805,4023,54136
8600000US54137,838,416,422,57155,73524,12399,54137
8600000US54138,728,384,344,42202,56089,8526,54138
8600000US54139,2483,1268,1215,65982,75702,4334,54139
8600000US54140,7382,3546,3836,59371,66427,3987,54140
8600000US54141,1725,919,806,63194,71848,7344,54141
8600000US54143,11936,5879,6057,48310,60938,3610,54143
8600000US54149,1135,597,538,44598,61115,5940,54149
8600000US54150,773,397,376,31250,43945,8234,54150
8600000US54151,2705,1316,1389,51422,59861,3237,54151
8600000US54153,5673,2882,2791,51150,63344,3848,54153
8600000US54154,4484,2149,2335,53000,65578,4345,54154
8600000US54155,5351,2548,2803,66530,115208,40482,54155
8600000US54156,1239,621,618,38946,49741,4654,54156
8600000US54157,4410,2165,2245,52093,66148,7288,54157
8600000US54159,1061,574,487,54602,71304,6979,54159
8600000US54160,232,122,110,66563,72222,7134,54160
8600000US54161,2251,1150,1101,52645,59396,3039,54161
8600000US54162,6679,3277,3402,68601,77218,4044,54162
8600000US54165,6136,2963,3173,66069,82687,10145,54165
8600000US54166,13095,6394,6701,50560,64153,4134,54166
8600000US54169,2097,1044,1053,102228,108954,7380,54169
8600000US54170,2793,1428,1365,65625,78990,5675,54170
8600000US54171,2720,1330,1390,86875,101218,12489,54171
8600000US54173,3172,1644,1528,78025,107420,14517,54173
8600000US54174,2493,1288,1205,47414,57423,3383,54174
8600000US54175,817,430,387,53173,59833,5682,54175
8600000US54177,2401,1236,1165,41078,53470,3549,54177
8600000US54180,2258,1075,1183,76941,86635,5466,54180
8600000US54201,4153,2152,2001,53108,61998,2948,54201
8600000US54202,1132,579,553,57150,71020,7667,54202
8600000US54204,1350,649,701,68889,74319,7601,54204
8600000US54205,1584,794,790,65000,74320,6738,54205
8600000US54207,108,60,48,70938,78959,15946,54207
8600000US54208,4815,2371,2444,75463,89004,6660,54208
8600000US54209,1155,538,617,70184,94923,12543,54209
8600000US54210,764,361,403,59375,85810,24691,54210
8600000US54211,249,104,145,81563,95590,19496,54211
8600000US54212,993,444,549,81806,105842,11725,54212
8600000US54213,972,490,482,53646,66426,7632,54213
8600000US54214,185,86,99,53750,78827,24105,54214
8600000US54216,5008,2447,2561,58909,68981,5248,54216
8600000US54217,5544,2817,2727,69821,83862,4435,54217
8600000US54220,30924,14913,16011,48867,62100,2400,54220
8600000US54227,1238,636,602,72292,81408,6524,54227
8600000US54228,2156,1103,1053,60833,69659,3926,54228
8600000US54229,3730,1913,1817,75682,83507,5422,54229
8600000US54230,3583,1879,1704,61541,77414,3888,54230
8600000US54232,635,318,317,46111,65714,10396,54232
8600000US54234,1438,661,777,52619,63327,6977,54234
8600000US54235,13679,6838,6841,56544,75563,5162,54235
8600000US54241,11577,5667,5910,46752,60296,4242,54241
8600000US54245,1690,839,851,64602,71783,4174,54245
8600000US54246,735,366,369,55341,78152,10693,54246
8600000US54247,1715,934,781,66750,74550,5329,54247
8600000US54301,16892,8152,8740,57213,73988,4103,54301
8600000US54302,23015,11493,11522,41402,56551,4030,54302
8600000US54303,20705,9941,10764,40238,48584,2314,54303
8600000US54304,21664,10572,11092,48685,58562,1997,54304
8600000US54307,1105,1105,0,,,,54307
8600000US54311,27812,13535,14277,63930,82501,4658,54311
8600000US54313,28849,14085,14764,84405,96497,3855,54313
8600000US54401,23845,11388,12457,49238,72536,4052,54401
8600000US54403,19304,9660,9644,51300,73932,6134,54403
8600000US54405,2177,1106,1071,50054,70660,10406,54405
8600000US54406,2604,1371,1233,69679,75759,3999,54406
8600000US54407,1159,610,549,71500,95182,12161,54407
8600000US54408,817,440,377,50972,56949,4475,54408
8600000US54409,10048,5027,5021,44972,56365,3231,54409
8600000US54410,1746,875,871,62685,73546,3992,54410
8600000US54411,3792,1973,1819,58153,73633,4436,54411
8600000US54412,1593,842,751,61731,77143,7723,54412
8600000US54413,128,68,60,58750,56119,7800,54413
8600000US54414,2690,1351,1339,56912,70478,4988,54414
8600000US54416,1403,730,673,48594,58053,5272,54416
8600000US54417,27,13,14,34063,44027,16402,54417
8600000US54418,762,379,383,62656,76086,6882,54418
8600000US54420,878,460,418,57411,74154,9759,54420
8600000US54421,2461,1226,1235,52321,69108,6611,54421
8600000US54422,798,418,380,48958,62576,7213,54422
8600000US54423,1832,911,921,77768,88513,5969,54423
8600000US54424,1318,664,654,63636,70579,4992,54424
8600000US54425,1412,723,689,54837,68220,6046,54425
8600000US54426,3251,1638,1613,66414,75551,3336,54426
8600000US54427,869,454,415,51447,63218,6792,54427
8600000US54428,852,456,396,47794,54645,4478,54428
8600000US54430,139,74,65,51250,61421,12354,54430
8600000US54433,1379,724,655,49441,62384,4130,54433
8600000US54435,1644,862,782,55875,70637,6354,54435
8600000US54436,1590,804,786,53333,69366,7414,54436
8600000US54437,2107,1078,1029,51790,63655,3620,54437
8600000US54440,2260,1167,1093,61823,77757,12861,54440
8600000US54441,671,332,339,86750,107163,23778,54441
8600000US54442,825,434,391,60547,70261,6596,54442
8600000US54443,1675,862,813,62188,77301,6780,54443
8600000US54446,2145,1091,1054,53917,67672,5598,54446
8600000US54447,348,166,182,40000,47743,4746,54447
8600000US54448,3418,1675,1743,74715,84634,4235,54448
8600000US54449,20524,9961,10563,57293,79826,4158,54449
8600000US54450,288,140,148,41875,52597,15279,54450
8600000US54451,8913,4467,4446,53016,66780,2993,54451
8600000US54452,14844,7431,7413,57949,68224,2431,54452
8600000US54454,1034,527,507,54917,67148,7275,54454
8600000US54455,13885,7133,6752,74959,90907,9176,54455
8600000US54456,4628,2306,2322,49160,59824,2852,54456
8600000US54457,6400,3210,3190,50253,69861,6646,54457
8600000US54458,55,27,28,49375,58471,19185,54458
8600000US54459,1052,515,537,47976,57868,4391,54459
8600000US54460,1913,972,941,49946,65621,7704,54460
8600000US54462,320,164,156,42375,55910,15079,54462
8600000US54463,510,261,249,53125,64347,9648,54463
8600000US54465,495,250,245,40486,49456,5652,54465
8600000US54466,2229,1141,1088,53021,63385,3741,54466
8600000US54467,10856,5313,5543,61226,76354,4642,54467
8600000US54469,1287,594,693,55216,66262,6821,54469
8600000US54470,1463,751,712,48258,57530,4396,54470
8600000US54471,1412,741,671,78958,92641,5975,54471
8600000US54473,2120,1136,984,57941,71939,4987,54473
8600000US54474,3108,1481,1627,57219,73170,9276,54474
8600000US54475,1298,690,608,64107,74795,9943,54475
8600000US54476,14507,7249,7258,64546,76871,5533,54476
8600000US54479,2824,1413,1411,58359,72328,7510,54479
8600000US54480,1033,511,522,52188,57198,5009,54480
8600000US54481,24465,11908,12557,48826,62124,2855,54481
8600000US54482,7592,3932,3660,68170,88343,6948,54482
8600000US54484,3696,1902,1794,65029,77615,4691,54484
8600000US54485,273,127,146,40000,52674,10056,54485
8600000US54486,1732,891,841,48665,58312,4348,54486
8600000US54487,8059,3978,4081,54988,65549,2715,54487
8600000US54488,882,463,419,46094,62792,5062,54488
8600000US54489,1208,630,578,61111,72701,6491,54489
8600000US54490,678,374,304,57019,62817,4264,54490
8600000US54491,1337,675,662,40789,53116,6319,54491
8600000US54493,481,261,220,49063,62881,10059,54493
8600000US54494,21006,10129,10877,55094,66771,2906,54494
8600000US54495,5979,2927,3052,43203,51919,2554,54495
8600000US54498,1658,823,835,51008,58582,3720,54498
8600000US54499,2323,1085,1238,53188,69444,6998,54499
8600000US54501,16025,7894,8131,54342,70570,3709,54501
8600000US54511,1022,525,497,47115,59731,7430,54511
8600000US54512,757,378,379,53036,69802,9484,54512
8600000US54513,348,178,170,45250,52730,7412,54513
8600000US54514,1487,746,741,51488,64719,7072,54514
8600000US54515,375,195,180,41250,50389,5319,54515
8600000US54517,93,51,42,33977,54792,16262,54517
8600000US54519,1092,519,573,46389,69110,9464,54519
8600000US54520,3283,1659,1624,42938,52875,3313,54520
8600000US54521,6503,3229,3274,45783,67892,5736,54521
8600000US54524,443,224,219,56705,58984,6359,54524
8600000US54525,180,92,88,40833,59648,27018,54525
8600000US54526,605,320,285,43654,48492,5072,54526
8600000US54527,735,369,366,39531,48707,5256,54527
8600000US54529,1017,516,501,55625,66563,5662,54529
8600000US54530,699,387,312,41510,52071,7208,54530
8600000US54531,1083,532,551,60781,71072,7211,54531
8600000US54534,1967,959,1008,35762,48228,3409,54534
8600000US54536,161,86,75,26563,42284,8852,54536
8600000US54537,387,201,186,45938,53797,10100,54537
8600000US54538,2527,1301,1226,31435,48947,4457,54538
8600000US54539,1091,595,496,52750,71684,9479,54539
8600000US54540,797,440,357,44700,62300,10157,54540
8600000US54541,979,436,543,50000,56309,4728,54541
8600000US54542,366,194,172,31422,39058,6019,54542
8600000US54545,741,366,375,58036,83557,14661,54545
8600000US54546,983,496,487,38500,48943,3767,54546
8600000US54547,1239,658,581,45781,55356,5576,54547
8600000US54548,4108,2069,2039,55513,94812,12679,54548
8600000US54550,512,256,256,41797,54198,7502,54550
8600000US54552,3501,1736,1765,44405,57065,3712,54552
8600000US54554,832,440,392,41786,66367,11308,54554
8600000US54555,3908,2019,1889,49198,62102,3734,54555
8600000US54556,946,448,498,44066,54996,4131,54556
8600000US54557,779,391,388,65288,76720,8535,54557
8600000US54558,1723,825,898,41308,58968,8475,54558
8600000US54559,651,346,305,49167,54649,4984,54559
8600000US54560,487,267,220,59792,66971,9022,54560
8600000US54561,0,0,0,,,,54561
8600000US54562,1746,873,873,51292,71869,8432,54562
8600000US54563,578,295,283,51875,59341,5081,54563
8600000US54564,335,175,160,43542,51077,7885,54564
8600000US54565,44,28,16,30000,31953,6587,54565
8600000US54566,1064,532,532,47188,56537,6761,54566
8600000US54568,3976,1916,2060,41582,57777,7284,54568
8600000US54601,43157,19997,23160,48073,68414,2621,54601
8600000US54603,11464,6214,5250,47083,59174,4440,54603
8600000US54610,1315,659,656,56250,69431,6554,54610
8600000US54611,887,442,445,52115,64982,5963,54611
8600000US54612,3530,1892,1638,52898,72699,5256,54612
8600000US54613,1443,800,643,40809,47086,4369,54613
8600000US54614,2204,1097,1107,67829,82803,7212,54614
8600000US54615,8366,4579,3787,50949,64850,3450,54615
8600000US54616,1942,971,971,51813,63663,4857,54616
8600000US54618,1678,871,807,65000,71707,4908,54618
8600000US54619,2555,1326,1229,62056,70244,4510,54619
8600000US54621,977,497,480,64712,78828,10172,54621
8600000US54622,1619,816,803,58409,71854,5954,54622
8600000US54623,1615,831,784,66711,80636,5481,54623
8600000US54624,1199,631,568,55000,66176,5312,54624
8600000US54625,184,105,79,48571,54312,9112,54625
8600000US54626,1121,596,525,53462,70360,8116,54626
8600000US54627,1363,700,663,64643,69606,5916,54627
8600000US54628,737,395,342,51058,62012,7629,54628
8600000US54629,2050,1033,1017,58083,66021,3728,54629
8600000US54630,3244,1588,1656,58919,70696,3618,54630
8600000US54631,1317,649,668,49107,61571,5296,54631
8600000US54632,879,453,426,59886,69966,8190,54632
8600000US54634,3168,1588,1580,47500,58120,4408,54634
8600000US54635,1436,755,681,58828,66200,4595,54635
8600000US54636,10295,4986,5309,84410,95085,7557,54636
8600000US54637,171,88,83,27708,48877,12318,54637
8600000US54638,1150,582,568,48125,58370,4335,54638
8600000US54639,1802,952,850,45000,56072,4161,54639
8600000US54641,4,2,2,,,,54641
8600000US54642,1635,841,794,63380,74363,5394,54642
8600000US54643,2,0,2,,,,54643
8600000US54644,1086,547,539,59412,64795,6502,54644
8600000US54645,47,24,23,30833,46738,20175,54645
8600000US54646,3207,1675,1532,48505,57048,5635,54646
8600000US54648,1146,581,565,54700,65207,4773,54648
8600000US54650,18385,8703,9682,62155,90506,5024,54650
8600000US54651,988,491,497,47109,52431,3833,54651
8600000US54652,684,348,336,45223,55775,6175,54652
8600000US54653,636,318,318,62679,67565,6923,54653
8600000US54654,56,20,36,51250,47271,14807,54654
8600000US54655,1403,683,720,43317,64869,8016,54655
8600000US54656,13470,6764,6706,58204,69303,4166,54656
8600000US54657,254,121,133,46563,57845,7807,54657
8600000US54658,2040,981,1059,55884,69617,4960,54658
8600000US54659,1022,550,472,58333,62827,5057,54659
8600000US54660,12133,6149,5984,56699,69986,3960,54660
8600000US54661,2765,1380,1385,61607,71927,3268,54661
8600000US54664,1188,611,577,44943,56518,4575,54664
8600000US54665,6417,3150,3267,47257,71377,18369,54665
8600000US54666,2129,1136,993,62197,72989,6066,54666
8600000US54667,3568,1682,1886,55754,67220,4425,54667
8600000US54669,6113,2952,3161,70638,85129,5501,54669
8600000US54670,1139,587,552,57778,69948,5877,54670
8600000US54701,32377,15006,17371,56810,74624,3336,54701
8600000US54703,35683,17841,17842,53539,67263,3082,54703
8600000US54720,5759,2955,2804,54097,73546,9398,54720
8600000US54721,1016,535,481,54659,68980,6769,54721
8600000US54722,2964,1496,1468,59259,70033,9186,54722
8600000US54723,960,515,445,63750,73628,7026,54723
8600000US54724,5470,2672,2798,57029,64822,3832,54724
8600000US54725,2148,1093,1055,52734,68648,5209,54725
8600000US54726,1313,712,601,52214,63271,4483,54726
8600000US54727,3851,1941,1910,54031,65269,3802,54727
8600000US54728,5051,2487,2564,54706,68545,4691,54728
8600000US54729,25075,12783,12292,58948,72873,3324,54729
8600000US54730,3821,1869,1952,67958,81527,5110,54730
8600000US54731,527,304,223,50417,57793,7366,54731
8600000US54732,2332,1174,1158,50655,64254,8429,54732
8600000US54733,993,487,506,62125,75748,8537,54733
8600000US54734,667,347,320,63594,71816,7242,54734
8600000US54736,3149,1578,1571,53882,68831,5121,54736
8600000US54737,442,235,207,70357,80267,9681,54737
8600000US54738,2506,1275,1231,68309,87154,6534,54738
8600000US54739,3819,1919,1900,72531,86454,6667,54739
8600000US54740,1542,776,766,61250,71605,6366,54740
8600000US54741,1193,626,567,41458,53704,3621,54741
8600000US54742,3508,1711,1797,64375,78020,7598,54742
8600000US54745,1634,826,808,55000,67908,6434,54745
8600000US54746,536,276,260,57578,59200,5244,54746
8600000US54747,2047,1037,1010,54191,63152,4546,54747
8600000US54748,1160,565,595,47396,61914,13426,54748
8600000US54749,959,496,463,54922,73776,10864,54749
8600000US54750,847,418,429,67656,79459,9338,54750
8600000US54751,21590,10691,10899,52474,65806,3995,54751
8600000US54754,1425,791,634,44250,58787,5934,54754
8600000US54755,5470,2779,2691,57362,67988,3114,54755
8600000US54756,735,380,355,56250,74308,11812,54756
8600000US54757,2610,1359,1251,57721,68189,3488,54757
8600000US54758,3440,1728,1712,58179,68780,3483,54758
8600000US54759,1183,583,600,51250,61638,4410,54759
8600000US54760,236,108,128,36250,50313,9498,54760
8600000US54761,887,441,446,53382,61802,5843,54761
8600000US54762,978,515,463,51731,66228,7421,54762
8600000US54763,871,483,388,55625,72479,7673,54763
8600000US54765,2,2,0,,,,54765
8600000US54766,1259,640,619,46613,54389,4346,54766
8600000US54767,2582,1249,1333,67143,82733,10084,54767
8600000US54768,4748,3121,1627,49534,64642,4130,54768
8600000US54769,565,284,281,58056,78111,9725,54769
8600000US54770,1590,860,730,62143,72520,4812,54770
8600000US54771,2945,1524,1421,50221,63052,3723,54771
8600000US54772,803,405,398,51442,61014,5920,54772
8600000US54773,2586,1321,1265,53095,65360,3471,54773
8600000US54801,5300,2535,2765,50163,65600,4555,54801
8600000US54805,1032,518,514,45583,62500,6701,54805
8600000US54806,9070,4504,4566,46011,59826,3061,54806
8600000US54810,1812,942,870,54896,72590,5363,54810
8600000US54812,4053,1950,2103,46157,60355,4986,54812
8600000US54813,452,238,214,47639,60730,9459,54813
8600000US54814,2186,1067,1119,54050,61023,4065,54814
8600000US54817,1818,926,892,53795,67632,4604,54817
8600000US54819,1950,1024,926,43714,58153,4199,54819
8600000US54820,629,350,279,50357,60343,5522,54820
8600000US54821,1095,550,545,46406,65992,8280,54821
8600000US54822,3395,1696,1699,53988,72989,8308,54822
8600000US54824,1722,920,802,52782,63133,5502,54824
8600000US54826,568,288,280,52500,65043,8044,54826
8600000US54827,233,134,99,49773,53334,9153,54827
8600000US54828,570,305,265,37917,61327,11720,54828
8600000US54829,4212,2048,2164,50294,66549,4218,54829
8600000US54830,2439,1212,1227,46801,59254,3266,54830
8600000US54832,341,170,171,45938,58775,8511,54832
8600000US54835,772,421,351,47000,58097,6761,54835
8600000US54836,768,401,367,70673,94513,19406,54836
8600000US54837,3029,1591,1438,48352,63818,4045,54837
8600000US54838,1079,604,475,56667,67719,6731,54838
8600000US54839,194,92,102,37750,45943,7318,54839
8600000US54840,3430,1779,1651,54767,61511,2920,54840
8600000US54841,233,111,122,45417,57829,7323,54841
8600000US54842,109,53,56,75455,81705,12808,54842
8600000US54843,9125,4566,4559,45718,72315,8528,54843
8600000US54844,200,108,92,43125,58738,7087,54844
8600000US54845,83,42,41,48125,56846,14488,54845
8600000US54846,374,195,179,54167,56156,6690,54846
8600000US54847,1831,909,922,55179,64885,4474,54847
8600000US54848,4499,2092,2407,40815,48892,3049,54848
8600000US54849,1430,764,666,65694,81304,6973,54849
8600000US54850,186,93,93,56667,72986,15756,54850
8600000US54853,3369,1675,1694,54318,65242,3777,54853
8600000US54854,805,419,386,59896,75543,8470,54854
8600000US54855,519,267,252,55000,65552,6412,54855
8600000US54856,1261,682,579,55662,65008,4745,54856
8600000US54857,37,22,15,,26779,13202,54857
8600000US54858,1344,704,640,43073,58152,6076,54858
8600000US54859,1425,738,687,47159,55171,3691,54859
8600000US54861,91,32,59,30313,47747,15656,54861
8600000US54862,177,90,87,34375,40849,8037,54862
8600000US54864,1013,524,489,64318,72755,5480,54864
8600000US54865,399,206,193,41731,54108,6110,54865
8600000US54867,377,187,190,27132,37431,7113,54867
8600000US54868,12301,6130,6171,49278,67182,6096,54868
8600000US54870,1337,664,673,59135,82944,11690,54870
8600000US54871,2350,1148,1202,43631,60922,7538,54871
8600000US54872,2239,1145,1094,47522,56931,4036,54872
8600000US54873,2419,1185,1234,54775,69182,6903,54873
8600000US54874,2928,1537,1391,69000,80481,5509,54874
8600000US54875,860,461,399,43750,62099,11569,54875
8600000US54876,1112,550,562,47024,62251,6975,54876
8600000US54880,24035,11685,12350,47615,60876,1884,54880
8600000US54888,1086,538,548,47375,61642,4919,54888
8600000US54889,1969,1009,960,50156,60004,3584,54889
8600000US54891,2651,1354,1297,50707,67456,4996,54891
8600000US54893,3010,1475,1535,47653,62943,4922,54893
8600000US54895,766,417,349,50357,70602,16678,54895
8600000US54896,1286,650,636,44006,52154,3602,54896
8600000US54901,32685,17234,15451,47596,59323,2287,54901
8600000US54902,17546,8724,8822,49542,59355,1993,54902
8600000US54904,17101,8467,8634,69850,88977,4016,54904
8600000US54909,1552,815,737,53603,65528,5350,54909
8600000US54911,21267,10440,10827,50234,65982,3677,54911
8600000US54913,15587,7647,7940,82390,111258,5918,54913
8600000US54914,23824,11916,11908,54263,69067,3186,54914
8600000US54915,32167,15527,16640,64761,80160,2889,54915
8600000US54921,915,461,454,49091,61935,6358,54921
8600000US54922,1083,588,495,68125,72220,4497,54922
8600000US54923,6735,3282,3453,52527,64984,3970,54923
8600000US54927,417,232,185,82212,89461,11164,54927
8600000US54928,283,144,139,61250,73213,9435,54928
8600000US54929,6805,3305,3500,53552,62639,3462,54929
8600000US54930,1236,613,623,45461,65869,7643,54930
8600000US54931,240,104,136,63750,76674,17744,54931
8600000US54932,1071,545,526,75750,84581,6855,54932
8600000US54933,234,147,87,37500,52720,18067,54933
8600000US54934,400,189,211,32104,50307,13031,54934
8600000US54935,32685,15930,16755,51351,62530,2268,54935
8600000US54937,15428,7336,8092,65972,89840,7034,54937
8600000US54940,3342,1737,1605,74087,84559,3840,54940
8600000US54941,2071,1090,981,53886,74856,6915,54941
8600000US54942,6867,3321,3546,99911,105604,6502,54942
8600000US54943,1543,764,779,44777,55636,5961,54943
8600000US54944,6734,3424,3310,85727,98068,6506,54944
8600000US54945,2751,1418,1333,54205,70837,8927,54945
8600000US54946,96,76,20,,,,54946
8600000US54947,2103,1104,999,82684,90433,8497,54947
8600000US54948,207,103,104,45625,53251,7540,54948
8600000US54949,2578,1350,1228,56447,67267,4352,54949
8600000US54950,2231,1148,1083,48583,62825,4551,54950
8600000US54952,20242,9850,10392,57418,77002,5275,54952
8600000US54956,33319,16182,17137,64994,108619,6821,54956
8600000US54960,2171,1140,1031,49630,62263,6210,54960
8600000US54961,10649,5332,5317,58626,73610,3553,54961
8600000US54962,919,500,419,55231,61580,4942,54962
8600000US54963,5107,2685,2422,61341,79424,9471,54963
8600000US54964,760,381,379,84464,92980,10913,54964
8600000US54965,1129,568,561,65652,76802,7571,54965
8600000US54966,1529,743,786,55455,70142,6504,54966
8600000US54967,302,171,131,43750,55389,12743,54967
8600000US54968,2242,1119,1123,46635,58022,3201,54968
8600000US54970,3197,2129,1068,48571,58233,5804,54970
8600000US54971,8390,3797,4593,54336,74096,9196,54971
8600000US54974,1111,539,572,66875,76242,6659,54974
8600000US54977,1214,636,578,63828,80655,10276,54977
8600000US54979,1206,654,552,66696,76098,8159,54979
8600000US54980,92,37,55,72917,57076,16385,54980
8600000US54981,12551,6399,6152,60644,73825,5225,54981
8600000US54982,5612,2785,2827,50208,64922,6691,54982
8600000US54983,3474,1811,1663,58418,69952,3360,54983
8600000US54984,2731,1377,1354,51326,63409,5929,54984
8600000US54985,411,328,83,,,,54985
8600000US54986,3953,1935,2018,68913,83388,5928,54986
8600000US55001,2409,1229,1180,114453,152271,19841,55001
8600000US55003,3590,2582,1008,79107,100903,9170,55003
8600000US55005,3551,1882,1669,85750,101378,10269,55005
8600000US55006,2993,1522,1471,51031,61611,5275,55006
8600000US55007,1885,968,917,50764,61232,4249,55007
8600000US55008,11718,5529,6189,68265,80440,4041,55008
8600000US55009,6179,3133,3046,72906,87218,3733,55009
8600000US55011,8063,4136,3927,92452,101681,4144,55011
8600000US55012,1702,917,785,79167,88797,5953,55012
8600000US55013,5248,2628,2620,84146,96450,8533,55013
8600000US55014,21433,11222,10211,89089,104057,3635,55014
8600000US55016,25720,12973,12747,94621,108278,3910,55016
8600000US55017,627,333,294,70500,74745,7272,55017
8600000US55018,711,368,343,86023,107243,10397,55018
8600000US55019,1378,640,738,87361,97699,15921,55019
8600000US55020,2678,1389,1289,118558,145665,18056,55020
8600000US55021,23408,12777,10631,60744,73217,3129,55021
8600000US55024,24329,12018,12311,94054,107416,5625,55024
8600000US55025,18882,9538,9344,84981,96536,4318,55025
8600000US55026,303,151,152,64167,102892,30552,55026
8600000US55027,2192,1159,1033,76484,89903,6074,55027
8600000US55029,54,25,29,,67020,36986,55029
8600000US55030,1094,594,500,48646,59791,5909,55030
8600000US55031,1558,820,738,103000,104520,5786,55031
8600000US55032,2756,1420,1336,84643,93986,6136,55032
8600000US55033,23597,11895,11702,75870,91274,3441,55033
8600000US55036,78,45,33,26250,39590,27824,55036
8600000US55037,3684,1811,1873,46250,57177,2603,55037
8600000US55038,15994,7950,8044,98888,116667,6313,55038
8600000US55040,9876,5287,4589,76875,88582,5328,55040
8600000US55041,6313,3065,3248,63418,77651,4753,55041
8600000US55042,7139,3524,3615,115000,155134,13371,55042
8600000US55043,2954,1444,1510,83656,102965,5581,55043
8600000US55044,38095,19038,19057,111551,132531,4117,55044
8600000US55045,5801,3009,2792,86310,96127,5482,55045
8600000US55046,3703,1913,1790,84089,90181,5834,55046
8600000US55047,2015,1084,931,103977,166391,58128,55047
8600000US55049,1739,918,821,69435,75017,3931,55049
8600000US55051,7339,3608,3731,52463,66919,3331,55051
8600000US55052,1566,823,743,63864,71659,4732,55052
8600000US55053,811,431,380,86875,93700,8104,55053
8600000US55054,1645,808,837,130714,128089,10418,55054
8600000US55055,2693,1266,1427,63341,74806,7413,55055
8600000US55056,10619,5205,5414,78503,89081,5422,55056
8600000US55057,20300,9542,10758,71968,91929,3637,55057
8600000US55060,21941,10890,11051,62383,76306,3084,55060
8600000US55063,7623,3875,3748,53537,69668,5048,55063
8600000US55065,890,460,430,83750,89032,6619,55065
8600000US55066,14204,6831,7373,57553,73437,4296,55066
8600000US55068,21039,10169,10870,95940,112041,3878,55068
8600000US55069,4299,2646,1653,57944,69122,4057,55069
8600000US55070,5639,2756,2883,82114,84991,5434,55070
8600000US55071,4334,2171,2163,73165,89041,8694,55071
8600000US55072,3775,2462,1313,40671,53800,3490,55072
8600000US55073,2677,1321,1356,97888,106335,11425,55073
8600000US55074,1746,876,870,80789,86386,5204,55074
8600000US55075,15273,7309,7964,60528,69196,3243,55075
8600000US55076,16911,8244,8667,74531,90731,5915,55076
8600000US55077,10297,5058,5239,75458,124043,13871,55077
8600000US55079,6699,3474,3225,87926,94736,4154,55079
8600000US55080,1945,988,957,74647,84082,5086,55080
8600000US55082,27577,13857,13720,94366,123533,5225,55082
8600000US55084,1297,641,656,63512,83766,6677,55084
8600000US55085,386,189,197,80313,93695,10755,55085
8600000US55087,230,130,100,74375,87928,17933,55087
8600000US55088,1336,726,610,96625,117644,13572,55088
8600000US55089,1480,774,706,90329,109333,12195,55089
8600000US55090,234,123,111,44677,63638,15563,55090
8600000US55092,8409,4343,4066,83074,95314,6170,55092
8600000US55101,6893,3611,3282,51531,76082,11832,55101
8600000US55102,15557,7432,8125,56084,75231,3666,55102
8600000US55103,9856,4700,5156,33849,49797,3894,55103
8600000US55104,35716,17299,18417,60474,80825,3393,55104
8600000US55105,21700,10100,11600,88341,134048,9619,55105
8600000US55106,40171,20275,19896,50193,62252,2603,55106
8600000US55107,10640,5126,5514,51893,68880,5844,55107
8600000US55108,13431,6432,6999,69918,88314,6097,55108
8600000US55109,26150,12584,13566,62858,78812,2869,55109
8600000US55110,31771,15153,16618,81345,103407,4000,55110
8600000US55111,20,15,5,15000,12800,6324,55111
8600000US55112,35444,16597,18847,70842,91192,3098,55112
8600000US55113,33614,15508,18106,66413,85521,3745,55113
8600000US55114,2705,1274,1431,57625,70339,8757,55114
8600000US55115,6777,3121,3656,101217,151195,17443,55115
8600000US55116,19336,9046,10290,69047,99927,5727,55116
8600000US55117,32846,15808,17038,50222,66963,2908,55117
8600000US55118,22548,10660,11888,67866,100589,4178,55118
8600000US55119,31378,15626,15752,56567,74638,3305,55119
8600000US55120,3483,1638,1845,99688,138726,11935,55120
8600000US55121,6776,3263,3513,71503,80287,4475,55121
8600000US55122,25320,12101,13219,78995,98839,3247,55122
8600000US55123,19067,9172,9895,117650,143696,6612,55123
8600000US55124,39333,19169,20164,87164,108851,4120,55124
8600000US55125,32606,15513,17093,99507,119214,3869,55125
8600000US55126,21065,9870,11195,87647,112224,4650,55126
8600000US55127,15060,6923,8137,104079,146436,12465,55127
8600000US55128,22831,10305,12526,68381,84226,2970,55128
8600000US55129,17147,8075,9072,129815,153644,12103,55129
8600000US55130,11832,5936,5896,34520,48930,3144,55130
8600000US55150,177,98,79,67500,200026,163779,55150
8600000US55155,0,0,0,,,,55155
8600000US55301,8711,4229,4482,101021,102610,8788,55301
8600000US55302,5541,2764,2777,65582,83695,5630,55302
8600000US55303,37394,18850,18544,81116,95149,2896,55303
8600000US55304,36112,17985,18127,103709,124940,5647,55304
8600000US55305,17121,8219,8902,75219,115919,8858,55305
8600000US55306,12358,5679,6679,71853,87345,3957,55306
8600000US55307,2575,1278,1297,63678,72401,5077,55307
8600000US55308,7059,3649,3410,94762,104904,7094,55308
8600000US55309,13289,6453,6836,88573,101186,7016,55309
8600000US55310,1087,522,565,62188,85306,15023,55310
8600000US55311,26979,12752,14227,125213,147354,8683,55311
8600000US55312,1161,583,578,72237,77169,6661,55312
8600000US55313,18186,8877,9309,78464,101469,8022,55313
8600000US55314,833,421,412,53365,81781,12805,55314
8600000US55315,4058,2207,1851,111838,129493,7434,55315
8600000US55316,18007,8890,9117,87692,103277,4090,55316
8600000US55317,16064,7846,8218,117031,154349,8115,55317
8600000US55318,20186,9883,10303,89467,117851,8562,55318
8600000US55319,4029,2051,1978,77580,101015,9098,55319
8600000US55320,3912,1944,1968,78600,89005,3955,55320
8600000US55321,3799,1903,1896,60750,73211,4397,55321
8600000US55322,2530,1281,1249,90375,105379,9546,55322
8600000US55324,983,513,470,74091,88354,10086,55324
8600000US55325,3362,1691,1671,65243,78724,5095,55325
8600000US55327,2731,1396,1335,98831,134742,22956,55327
8600000US55328,6643,3376,3267,87781,104026,7645,55328
8600000US55329,1455,743,712,53036,64891,5182,55329
8600000US55330,28028,14321,13707,91811,99577,4418,55330
8600000US55331,14032,6839,7193,120984,177927,9131,55331
8600000US55332,1325,713,612,54107,70687,8982,55332
8600000US55333,625,328,297,52981,66616,9235,55333
8600000US55334,1979,986,993,53188,66441,7170,55334
8600000US55335,1279,641,638,52895,65489,5350,55335
8600000US55336,5775,2846,2929,60569,71611,5015,55336
8600000US55337,34980,16736,18244,69993,85173,2627,55337
8600000US55338,830,431,399,64519,73818,5888,55338
8600000US55339,852,425,427,88333,100360,10322,55339
8600000US55340,5751,2966,2785,125583,202753,24642,55340
8600000US55341,2075,1006,1069,97168,117582,15232,55341
8600000US55342,1454,744,710,61111,77198,7053,55342
8600000US55343,20134,9784,10350,62127,85171,5616,55343
8600000US55344,12782,6286,6496,69264,96739,8302,55344
8600000US55345,16848,8017,8831,103182,132978,4751,55345
8600000US55346,12615,6324,6291,114260,138217,5905,55346
8600000US55347,22902,10934,11968,137804,181659,9405,55347
8600000US55349,2998,1505,1493,63266,79717,4636,55349
8600000US55350,14211,7050,7161,61389,80330,6122,55350
8600000US55352,6631,3347,3284,71603,86365,6574,55352
8600000US55353,2719,1376,1343,73406,84043,7146,55353
8600000US55354,1910,949,961,63811,77314,5373,55354
8600000US55355,7316,3625,3691,60255,80315,6912,55355
8600000US55356,3978,1973,2005,132227,235884,36702,55356
8600000US55357,2357,1183,1174,104821,153376,22255,55357
8600000US55358,4007,1995,2012,72178,95053,9477,55358
8600000US55359,4715,2303,2412,97180,143554,16362,55359
8600000US55360,2009,1048,961,92500,98688,5927,55360
8600000US55362,13716,6987,6729,73001,87228,4560,55362
8600000US55363,3283,1695,1588,74476,78571,4659,55363
8600000US55364,12169,6142,6027,109236,165789,16677,55364
8600000US55366,421,204,217,32089,49088,7557,55366
8600000US55367,745,406,339,72031,79219,6415,55367
8600000US55368,1742,836,906,65938,73627,6249,55368
8600000US55369,28654,13819,14835,83952,100246,4321,55369
8600000US55370,584,289,295,68026,84022,7401,55370
8600000US55371,12489,6263,6226,67113,80012,5146,55371
8600000US55372,24421,12078,12343,109238,127003,5418,55372
8600000US55373,4370,2188,2182,73199,97032,12203,55373
8600000US55374,10656,5136,5520,124214,130445,9659,55374
8600000US55375,3632,1715,1917,101818,109988,7874,55375
8600000US55376,11381,5714,5667,109647,112220,6349,55376
8600000US55378,21298,10534,10764,111355,128935,5676,55378
8600000US55379,31878,15625,16253,84019,102814,3457,55379
8600000US55381,1544,783,761,64408,74263,5250,55381
8600000US55382,2813,1455,1358,74938,85369,7238,55382
8600000US55384,1650,773,877,51738,80048,14401,55384
8600000US55385,977,522,455,55855,70347,6618,55385
8600000US55386,5187,2567,2620,147297,159761,10434,55386
8600000US55387,9408,4492,4916,95530,112903,6000,55387
8600000US55388,4181,1915,2266,85596,95627,8096,55388
8600000US55389,1908,970,938,62978,68704,3764,55389
8600000US55390,1901,982,919,82361,95096,8196,55390
8600000US55391,12663,6267,6396,114414,212110,18778,55391
8600000US55395,2116,1005,1111,60391,66787,4144,55395
8600000US55396,1639,817,822,59063,73061,4441,55396
8600000US55397,2160,1090,1070,80375,95442,17083,55397
8600000US55398,11501,5775,5726,87485,103781,7027,55398
8600000US55401,9165,4703,4462,88584,120072,11611,55401
8600000US55402,408,260,148,53580,59057,19684,55402
8600000US55403,15487,8472,7015,47865,79160,6579,55403
8600000US55404,21503,11312,10191,26908,46219,3068,55404
8600000US55405,13239,7110,6129,57840,101410,7275,55405
8600000US55406,27237,13266,13971,65631,81392,2802,55406
8600000US55407,30151,15466,14685,59767,73431,2660,55407
8600000US55408,26563,14050,12513,54887,77392,3209,55408
8600000US55409,9366,4562,4804,76443,105562,8324,55409
8600000US55410,15453,7417,8036,116851,154242,6756,55410
8600000US55411,20447,9940,10507,39397,54192,2737,55411
8600000US55412,17027,8465,8562,44896,57990,2845,55412
8600000US55413,12117,6080,6037,59907,84054,6106,55413
8600000US55414,32703,17036,15667,37111,60521,3921,55414
8600000US55415,3860,2299,1561,101563,175982,43152,55415
8600000US55416,26929,12690,14239,81532,119495,6054,55416
8600000US55417,20651,9941,10710,85674,104004,4057,55417
8600000US55418,24241,12111,12130,67518,83472,2911,55418
8600000US55419,20173,9600,10573,106280,138558,5916,55419
8600000US55420,17146,8181,8965,56742,71718,2914,55420
8600000US55421,22230,11006,11224,53248,68546,3354,55421
8600000US55422,23652,10983,12669,70528,93228,4660,55422
8600000US55423,28498,14054,14444,63428,80264,3819,55423
8600000US55424,6900,3442,3458,168158,271448,22766,55424
8600000US55425,8051,4315,3736,60181,75457,5332,55425
8600000US55426,21723,10409,11314,72382,90060,5092,55426
8600000US55427,18282,8742,9540,75678,92351,4213,55427
8600000US55428,23191,10824,12367,53786,68858,4137,55428
8600000US55429,20170,9569,10601,49717,64289,3038,55429
8600000US55430,16026,7843,8183,52906,65623,4554,55430
8600000US55431,15077,7114,7963,81622,95051,4527,55431
8600000US55432,23220,11715,11505,60322,71288,2274,55432
8600000US55433,27246,12796,14450,64158,76259,2531,55433
8600000US55434,23054,11078,11976,67887,76774,3477,55434
8600000US55435,11585,5140,6445,67143,103595,9659,55435
8600000US55436,10011,4577,5434,105702,179120,14570,55436
8600000US55437,15135,7335,7800,74650,101960,6336,55437
8600000US55438,13320,6181,7139,85338,117642,7943,55438
8600000US55439,6712,3244,3468,129167,181399,13485,55439
8600000US55441,15107,7818,7289,78081,111717,7349,55441
8600000US55442,10458,4847,5611,108396,138044,10546,55442
8600000US55443,22639,10774,11865,81867,94381,3643,55443
8600000US55444,12253,6089,6164,82083,89980,4982,55444
8600000US55445,8667,4089,4578,83329,100693,9484,55445
8600000US55446,17656,8266,9390,117486,152050,9163,55446
8600000US55447,16647,8329,8318,97184,130436,5960,55447
8600000US55448,21535,10290,11245,76621,89724,3053,55448
8600000US55449,20145,9838,10307,105784,131477,8213,55449
8600000US55450,9,0,9,,,,55450
8600000US55454,7581,3516,4065,21035,29263,3757,55454
8600000US55455,1097,500,597,,,,55455
8600000US55601,62,34,28,63125,78694,17667,55601
8600000US55602,181,99,82,35250,50233,13484,55602
8600000US55603,467,254,213,48690,57694,9596,55603
8600000US55604,2819,1373,1446,52686,70989,8320,55604
8600000US55605,576,269,307,43333,53381,6147,55605
8600000US55606,191,104,87,50179,50078,16948,55606
8600000US55607,157,94,63,56250,70150,18273,55607
8600000US55609,232,111,121,136500,113944,31163,55609
8600000US55612,558,324,234,70652,82826,12760,55612
8600000US55613,173,76,97,41563,57468,11535,55613
8600000US55614,1955,956,999,53417,69366,8737,55614
8600000US55615,178,85,93,52000,55703,7476,55615
8600000US55616,5506,2876,2630,61690,72050,4604,55616
8600000US55702,445,246,199,67083,77527,7250,55702
8600000US55703,528,302,226,48750,59055,5632,55703
8600000US55704,756,400,356,44167,55973,7057,55704
8600000US55705,2606,1322,1284,49863,57830,3823,55705
8600000US55706,1393,726,667,42188,52128,4501,55706
8600000US55707,2574,1336,1238,62765,73719,5148,55707
8600000US55708,583,317,266,39196,45571,6808,55708
8600000US55709,3069,1593,1476,60868,75993,4955,55709
8600000US55710,1036,577,459,72625,77767,9576,55710
8600000US55711,520,304,216,52875,61756,6393,55711
8600000US55712,468,260,208,41964,54504,10908,55712
8600000US55713,926,445,481,42019,49167,5680,55713
8600000US55716,291,167,124,40000,49310,8197,55716
8600000US55717,325,188,137,76705,114889,29598,55717
8600000US55718,2554,1237,1317,59375,81465,9865,55718
8600000US55719,4413,2035,2378,43992,54349,4681,55719
8600000US55720,12702,6337,6365,55394,68484,3972,55720
8600000US55721,2756,1436,1320,65651,77210,6241,55721
8600000US55722,794,338,456,38750,55568,9404,55722
8600000US55723,1839,908,931,55677,66751,3930,55723
8600000US55724,677,378,299,60769,71254,6571,55724
8600000US55725,116,49,67,,50990,22093,55725
8600000US55726,858,431,427,54844,65819,6121,55726
8600000US55731,5170,2674,2496,49587,65624,4778,55731
8600000US55732,1209,665,544,53516,63621,5155,55732
8600000US55733,3549,1752,1797,81333,92591,6286,55733
8600000US55734,4902,2461,2441,57832,67655,5459,55734
8600000US55735,1424,731,693,46000,60013,5934,55735
8600000US55736,1165,595,570,43333,54032,3355,55736
8600000US55738,433,239,194,65625,73204,5739,55738
8600000US55741,2917,1486,1431,57228,70512,5204,55741
8600000US55742,311,159,152,65000,75148,11014,55742
8600000US55744,15861,7812,8049,53079,67567,4673,55744
8600000US55746,12545,5888,6657,47255,60073,4392,55746
8600000US55748,1123,561,562,43472,53262,3681,55748
8600000US55749,359,192,167,60833,65552,7445,55749
8600000US55750,1740,913,827,53507,63632,4410,55750
8600000US55751,1294,710,584,70433,74525,5534,55751
8600000US55752,327,164,163,47500,56924,6352,55752
8600000US55753,752,385,367,45114,50251,5098,55753
8600000US55756,313,156,157,62250,67485,7463,55756
8600000US55757,600,309,291,54821,58472,5094,55757
8600000US55758,111,58,53,48438,49857,14917,55758
8600000US55760,2553,1269,1284,46552,60955,5325,55760
8600000US55763,470,249,221,56250,70023,20515,55763
8600000US55764,411,191,220,37031,42300,5743,55764
8600000US55765,634,318,316,45288,56183,6080,55765
8600000US55766,20,9,11,,90033,64132,55766
8600000US55767,3996,2664,1332,53516,64707,5119,55767
8600000US55768,2321,1192,1129,50313,61231,4928,55768
8600000US55769,1898,910,988,56205,64580,5229,55769
8600000US55771,1379,752,627,43333,53655,5209,55771
8600000US55772,79,37,42,44375,43874,13399,55772
8600000US55775,1298,667,631,66207,74371,9751,55775
8600000US55779,3102,1696,1406,78214,87599,5824,55779
8600000US55780,176,87,89,54250,77799,19255,55780
8600000US55781,659,353,306,54167,77281,12019,55781
8600000US55782,351,193,158,61389,66859,9313,55782
8600000US55783,1912,1033,879,58816,71889,7070,55783
8600000US55784,97,51,46,55000,57588,13939,55784
8600000US55785,178,100,78,35750,50925,11596,55785
8600000US55786,286,160,126,46875,55592,18195,55786
8600000US55787,455,237,218,49063,62872,10335,55787
8600000US55790,1716,861,855,60033,72084,6380,55790
8600000US55792,8064,3933,4131,42946,57369,3844,55792
8600000US55793,507,240,267,55804,65573,6787,55793
8600000US55795,1325,754,571,47721,57566,4487,55795
8600000US55797,1230,657,573,64531,74913,6053,55797
8600000US55798,492,241,251,61875,73385,9346,55798
8600000US55802,2211,1100,1111,35083,54259,7244,55802
8600000US55803,14442,7105,7337,76142,95722,4475,55803
8600000US55804,11209,5573,5636,77972,97205,5376,55804
8600000US55805,8271,3994,4277,29821,43051,3287,55805
8600000US55806,6836,3566,3270,36080,48194,3668,55806
8600000US55807,7594,3752,3842,46883,57434,3472,55807
8600000US55808,4513,2269,2244,42310,51602,4379,55808
8600000US55810,6762,3446,3316,60755,78349,6851,55810
8600000US55811,22329,10477,11852,64220,81769,4522,55811
8600000US55812,10313,5241,5072,49336,86792,9378,55812
8600000US55814,644,644,0,,,,55814
8600000US55901,41371,19347,22024,71941,86193,3154,55901
8600000US55902,19056,8923,10133,89792,141196,6265,55902
8600000US55904,20547,10360,10187,59026,74928,3203,55904
8600000US55905,0,0,0,,,,55905
8600000US55906,14705,7496,7209,80566,115269,6947,55906
8600000US55909,1205,606,599,68929,81037,7347,55909
8600000US55910,967,477,490,64732,77116,8535,55910
8600000US55912,21554,10771,10783,48995,70176,3248,55912
8600000US55917,2718,1331,1387,65750,79668,4560,55917
8600000US55918,685,319,366,62813,68827,5439,55918
8600000US55919,826,419,407,61500,70790,6868,55919
8600000US55920,5459,2598,2861,90307,109498,7644,55920
8600000US55921,3642,1774,1868,56950,66431,4045,55921
8600000US55922,655,338,317,57750,60777,6045,55922
8600000US55923,3441,1694,1747,74200,88996,3768,55923
8600000US55924,1088,585,503,61625,79339,10505,55924
8600000US55925,873,464,409,68750,85849,8850,55925
8600000US55926,673,331,342,67250,80840,11381,55926
8600000US55927,3086,1590,1496,65110,77301,4859,55927
8600000US55929,918,472,446,79583,88338,8206,55929
8600000US55931,284,143,141,48594,68737,15208,55931
8600000US55932,1554,759,795,73050,86402,6758,55932
8600000US55933,161,85,76,77813,81901,15482,55933
8600000US55934,2308,1122,1186,79167,88773,5320,55934
8600000US55935,672,359,313,69659,93065,16028,55935
8600000US55936,1311,615,696,66375,77694,8191,55936
8600000US55939,1431,700,731,54271,66806,5828,55939
8600000US55940,2136,1052,1084,60000,74747,4179,55940
8600000US55941,736,378,358,63500,76263,9440,55941
8600000US55943,2315,1177,1138,61010,70528,3728,55943
8600000US55944,5266,2530,2736,73735,81934,4260,55944
8600000US55945,978,530,448,71458,80406,5852,55945
8600000US55946,2648,1376,1272,68235,77083,4566,55946
8600000US55947,5872,2935,2937,63889,83969,5796,55947
8600000US55949,1306,652,654,59453,70645,5131,55949
8600000US55950,116,61,55,27083,40943,15379,55950
8600000US55951,1168,600,568,55994,70376,7067,55951
8600000US55952,1905,1002,903,68750,93702,18851,55952
8600000US55953,612,310,302,44194,58960,5834,55953
8600000US55954,1113,501,612,56667,66406,6723,55954
8600000US55955,1973,967,1006,111477,122185,13947,55955
8600000US55956,1611,869,742,80875,105380,11527,55956
8600000US55957,541,282,259,64375,76007,8189,55957
8600000US55959,1990,1055,935,58036,65878,5481,55959
8600000US55960,2381,1186,1195,96563,115430,10438,55960
8600000US55961,337,166,171,63125,69802,16958,55961
8600000US55962,595,328,267,55368,70307,6777,55962
8600000US55963,3800,1911,1889,72694,83511,5015,55963
8600000US55964,3272,1595,1677,69839,87605,10560,55964
8600000US55965,1934,969,965,56806,70267,4980,55965
8600000US55967,792,407,385,83333,97243,10982,55967
8600000US55968,81,46,35,59583,65535,15922,55968
8600000US55969,781,385,396,67361,76324,5688,55969
8600000US55970,724,358,366,55417,69682,6209,55970
8600000US55971,2201,1059,1142,59091,69556,4303,55971
8600000US55972,3748,1825,1923,71977,87290,6986,55972
8600000US55973,204,104,100,72000,86051,17816,55973
8600000US55974,1607,759,848,49583,58145,3506,55974
8600000US55975,3210,1594,1616,56970,71170,5353,55975
8600000US55976,5454,2557,2897,67217,78256,4453,55976
8600000US55977,139,74,65,81406,78545,11579,55977
8600000US55979,727,382,345,69375,72671,5486,55979
8600000US55981,3277,1590,1687,58457,72396,5173,55981
8600000US55982,357,172,185,75556,90531,14357,55982
8600000US55983,1248,637,611,64861,72759,5395,55983
8600000US55985,1397,745,652,60435,86072,12767,55985
8600000US55987,29870,14550,15320,49761,66084,3136,55987
8600000US55990,744,378,366,59286,69158,8364,55990
8600000US55991,1050,504,546,74853,89686,7679,55991
8600000US55992,3684,1749,1935,64697,78848,5975,55992
8600000US56001,39618,19682,19936,49833,69629,2401,56001
8600000US56003,11110,5578,5532,65351,84921,6855,56003
8600000US56007,16578,7929,8649,48767,61384,2571,56007
8600000US56009,1045,534,511,62065,74189,6076,56009
8600000US56010,951,496,455,62500,79767,7773,56010
8600000US56011,6777,3302,3475,86466,89998,5927,56011
8600000US56013,3450,1675,1775,51462,65859,5820,56013
8600000US56014,541,268,273,53125,67191,10257,56014
8600000US56016,745,404,341,62250,67838,6424,56016
8600000US56017,1234,623,611,74609,93971,10018,56017
8600000US56019,622,303,319,63393,72146,5863,56019
8600000US56020,72,41,31,46250,60860,19255,56020
8600000US56021,820,422,398,72574,90843,12173,56021
8600000US56022,32,18,14,41000,37986,10340,56022
8600000US56023,423,223,200,54861,70411,11590,56023
8600000US56024,2373,1159,1214,72591,82647,6109,56024
8600000US56025,363,186,177,71500,79853,8479,56025
8600000US56026,1499,765,734,66000,82712,6258,56026
8600000US56027,587,301,286,42250,85708,35735,56027
8600000US56028,1029,501,528,70781,85307,7649,56028
8600000US56029,593,306,287,53958,65265,4505,56029
8600000US56031,9358,4604,4754,51261,70138,4950,56031
8600000US56032,212,115,97,52708,54964,9742,56032
8600000US56033,289,148,141,52708,73536,17234,56033
8600000US56034,337,179,158,53036,73053,11543,56034
8600000US56035,280,127,153,52917,59058,9693,56035
8600000US56036,1492,796,696,55000,94582,22574,56036
8600000US56037,1208,605,603,73750,85428,9908,56037
8600000US56039,700,360,340,66765,82662,9880,56039
8600000US56041,810,420,390,66607,75301,5334,56041
8600000US56042,531,297,234,55600,82394,15328,56042
8600000US56043,382,219,163,56875,64217,7408,56043
8600000US56044,1649,866,783,76136,95094,10753,56044
8600000US56045,731,375,356,59417,69481,6813,56045
8600000US56046,69,44,25,38750,47732,9599,56046
8600000US56047,103,56,47,83750,75718,12362,56047
8600000US56048,3036,1529,1507,73148,81619,3710,56048
8600000US56050,1151,579,572,64405,76829,6841,56050
8600000US56051,507,257,250,51538,59089,4943,56051
8600000US56052,623,334,289,63889,76364,8840,56052
8600000US56054,699,361,338,75781,85299,10273,56054
8600000US56055,3020,1548,1472,66712,82140,7440,56055
8600000US56056,64,35,29,48125,71246,25115,56056
8600000US56057,2916,1475,1441,63833,71415,4901,56057
8600000US56058,4429,2216,2213,62471,71357,4013,56058
8600000US56060,314,162,152,53750,61130,9861,56060
8600000US56062,2605,1215,1390,51667,73807,7877,56062
8600000US56063,2289,1175,1114,87903,102852,9565,56063
8600000US56065,2022,961,1061,61594,69990,3735,56065
8600000US56068,797,391,406,62750,75194,5553,56068
8600000US56069,3468,1813,1655,64045,73642,4384,56069
8600000US56071,9333,4619,4714,86155,100455,5565,56071
8600000US56072,1683,854,829,56985,66608,3848,56072
8600000US56073,13207,6437,6770,61215,75596,5153,56073
8600000US56074,1561,797,764,75139,84819,6608,56074
8600000US56075,115,54,61,37500,49005,7816,56075
8600000US56078,368,185,183,69375,86933,16247,56078
8600000US56080,546,254,292,69327,80231,10656,56080
8600000US56081,4475,2213,2262,51723,63386,4839,56081
8600000US56082,11669,5818,5851,61860,75822,4677,56082
8600000US56083,686,347,339,53833,70506,7911,56083
8600000US56085,3999,2026,1973,58791,68308,4056,56085
8600000US56087,2224,1058,1166,54537,63560,3423,56087
8600000US56088,1464,750,714,52868,62615,3535,56088
8600000US56089,127,82,45,37679,43343,6895,56089
8600000US56090,514,282,232,64167,74418,7979,56090
8600000US56091,254,122,132,53750,60158,10736,56091
8600000US56093,9562,4382,5180,51344,65260,3571,56093
8600000US56096,2436,1224,1212,57083,74552,6789,56096
8600000US56097,2716,1360,1356,51688,59930,3772,56097
8600000US56098,1617,793,824,52423,68810,6356,56098
8600000US56101,4493,2237,2256,50302,64524,4423,56101
8600000US56110,1377,715,662,58333,80088,9956,56110
8600000US56111,297,170,127,65938,82968,9802,56111
8600000US56113,160,86,74,60000,75473,15028,56113
8600000US56114,216,125,91,58333,68926,8143,56114
8600000US56115,1085,565,520,61042,76049,10277,56115
8600000US56116,573,306,267,67941,73112,9884,56116
8600000US56117,271,145,126,63750,67983,12003,56117
8600000US56118,315,160,155,72500,82647,14815,56118
8600000US56119,764,383,381,65227,81051,7005,56119
8600000US56120,738,378,360,51750,69058,8020,56120
8600000US56121,480,250,230,50833,66544,8094,56121
8600000US56122,493,263,230,58636,63815,6547,56122
8600000US56123,381,185,196,55625,70900,12223,56123
8600000US56125,55,25,30,49688,55289,13488,56125
8600000US56127,307,156,151,43636,57804,8378,56127
8600000US56128,1497,721,776,57031,74864,9026,56128
8600000US56129,574,272,302,50893,66158,8424,56129
8600000US56131,1817,917,900,55909,71108,4702,56131
8600000US56132,382,217,165,57417,82673,25732,56132
8600000US56134,417,226,191,58214,86733,20063,56134
8600000US56136,873,387,486,49844,57189,4422,56136
8600000US56137,866,423,443,63235,71163,7058,56137
8600000US56138,679,337,342,64625,90357,34275,56138
8600000US56139,310,160,150,56875,69572,7512,56139
8600000US56140,43,22,21,55313,58852,26398,56140
8600000US56141,233,127,106,57750,63871,7452,56141
8600000US56142,760,366,394,47778,56085,4904,56142
8600000US56143,3386,1669,1717,53013,80829,20552,56143
8600000US56144,838,395,443,54766,84150,17533,56144
8600000US56145,406,197,209,51563,60141,8607,56145
8600000US56146,73,36,37,50208,50646,11865,56146
8600000US56147,156,77,79,63125,67322,8591,56147
8600000US56149,885,456,429,54167,67596,8089,56149
8600000US56150,2010,993,1017,56573,68816,3965,56150
8600000US56151,619,307,312,65114,79114,7111,56151
8600000US56152,1084,553,531,57422,70350,6466,56152
8600000US56153,179,93,86,45833,52523,9974,56153
8600000US56155,298,155,143,59063,72176,15058,56155
8600000US56156,4216,2009,2207,58274,72780,6060,56156
8600000US56157,636,332,304,70833,86426,9935,56157
8600000US56158,359,186,173,58594,69302,11514,56158
8600000US56159,2085,1000,1085,52612,58570,4866,56159
8600000US56160,155,75,80,59250,70481,8973,56160
8600000US56161,276,139,137,56667,73799,13045,56161
8600000US56162,175,83,92,63889,78524,17616,56162
8600000US56164,4056,1877,2179,49399,65527,7053,56164
8600000US56165,295,159,136,61250,72129,9555,56165
8600000US56166,173,82,91,56000,69622,17222,56166
8600000US56167,595,345,250,55500,83184,30985,56167
8600000US56168,663,334,329,58125,72614,8058,56168
8600000US56169,479,244,235,62045,79024,8482,56169
8600000US56170,471,244,227,58750,63156,6736,56170
8600000US56171,1419,702,717,58512,75145,5774,56171
8600000US56172,2375,1124,1251,53875,68666,3913,56172
8600000US56173,250,128,122,57411,61372,13237,56173
8600000US56174,259,119,140,48125,61646,11896,56174
8600000US56175,2272,1159,1113,51016,64608,4523,56175
8600000US56176,815,373,442,57019,79631,6773,56176
8600000US56177,41,20,21,51875,60419,22329,56177
8600000US56178,1405,707,698,53229,69168,5985,56178
8600000US56180,882,442,440,54375,63877,4729,56180
8600000US56181,819,396,423,53958,67611,8475,56181
8600000US56183,1015,495,520,53000,64294,5511,56183
8600000US56185,474,252,222,57188,77249,13878,56185
8600000US56186,277,158,119,51563,58357,10209,56186
8600000US56187,10428,5375,5053,51151,63172,3686,56187
8600000US56201,17199,8331,8868,51394,64375,3030,56201
8600000US56207,220,101,119,66250,74335,11045,56207
8600000US56208,1655,861,794,41131,55518,7107,56208
8600000US56209,1689,873,816,59875,85420,12685,56209
8600000US56210,3,0,3,,,,56210
8600000US56211,323,172,151,48750,61548,11981,56211
8600000US56212,368,189,179,50441,63470,6768,56212
8600000US56214,597,309,288,47031,67864,10210,56214
8600000US56215,3346,1583,1763,47076,66883,5327,56215
8600000US56216,572,300,272,67250,74241,4744,56216
8600000US56218,403,217,186,53750,70238,9476,56218
8600000US56219,768,362,406,42188,61375,9275,56219
8600000US56220,2111,1057,1054,51453,63856,5290,56220
8600000US56221,541,258,283,53984,67757,6761,56221
8600000US56222,1509,721,788,62656,70174,8068,56222
8600000US56223,1075,528,547,53702,66403,5664,56223
8600000US56224,200,113,87,59643,75975,14984,56224
8600000US56225,537,259,278,51250,60394,7453,56225
8600000US56226,173,95,78,70250,69479,8810,56226
8600000US56227,149,73,76,66750,96072,39607,56227
8600000US56228,802,426,376,48068,68048,9817,56228
8600000US56229,1279,621,658,57426,75378,6765,56229
8600000US56230,584,294,290,55909,70819,7462,56230
8600000US56231,274,151,123,60521,77466,10038,56231
8600000US56232,1928,906,1022,53269,68484,6295,56232
8600000US56235,417,197,220,63750,89741,18775,56235
8600000US56236,254,134,120,53750,82985,17058,56236
8600000US56237,392,186,206,50156,61177,8751,56237
8600000US56239,448,216,232,74250,92971,19678,56239
8600000US56240,823,384,439,62292,76619,8927,56240
8600000US56241,2986,1455,1531,57417,68624,6372,56241
8600000US56243,1215,661,554,54267,69519,7718,56243
8600000US56244,1109,654,455,61094,116892,43199,56244
8600000US56245,471,246,225,71364,91669,20455,56245
8600000US56248,662,340,322,48493,79698,20622,56248
8600000US56249,235,132,103,69306,90172,18328,56249
8600000US56251,654,324,330,63603,77512,7914,56251
8600000US56252,859,427,432,54531,63665,4444,56252
8600000US56253,972,499,473,65625,84383,9136,56253
8600000US56255,276,149,127,63750,81432,13926,56255
8600000US56256,1996,991,1005,50529,69326,5760,56256
8600000US56257,421,208,213,44375,61562,18528,56257
8600000US56258,11637,5610,6027,52079,77371,9840,56258
8600000US56260,689,344,345,58229,67684,6617,56260
8600000US56262,535,281,254,48438,70845,9988,56262
8600000US56263,386,224,162,63750,68663,6280,56263
8600000US56264,1696,837,859,64531,75641,7471,56264
8600000US56265,5743,2805,2938,52118,73570,6857,56265
8600000US56266,1139,542,597,53086,69932,7338,56266
8600000US56267,5559,2679,2880,54913,77057,7300,56267
8600000US56270,785,417,368,50486,58850,4623,56270
8600000US56271,935,490,445,58750,79356,12521,56271
8600000US56273,3747,1877,1870,64886,82949,7881,56273
8600000US56274,117,59,58,60417,94775,22527,56274
8600000US56276,183,101,82,52250,61823,21602,56276
8600000US56277,2393,1171,1222,61905,75135,7133,56277
8600000US56278,2137,1059,1078,52137,66714,6037,56278
8600000US56279,1025,534,491,68750,92158,18017,56279
8600000US56280,399,215,184,67443,74671,8755,56280
8600000US56281,475,222,253,64107,86103,15713,56281
8600000US56282,1125,593,532,62422,70018,5510,56282
8600000US56283,4742,2374,2368,51995,65314,4557,56283
8600000US56284,1627,832,795,59250,67031,5921,56284
8600000US56285,816,412,404,60179,73471,6999,56285
8600000US56287,48,23,25,44063,49097,8530,56287
8600000US56288,3846,1910,1936,75862,102223,8218,56288
8600000US56289,555,297,258,62083,75500,6986,56289
8600000US56291,321,172,149,59444,68347,8294,56291
8600000US56292,446,201,245,51875,70109,8134,56292
8600000US56293,983,477,506,57679,69098,6716,56293
8600000US56294,60,30,30,41667,50353,10834,56294
8600000US56295,202,99,103,59000,77436,11676,56295
8600000US56296,1567,801,766,45250,63482,5994,56296
8600000US56297,671,386,285,60547,69954,8343,56297
8600000US56301,27888,14363,13525,51722,71645,3567,56301
8600000US56303,19732,10131,9601,49538,65252,3585,56303
8600000US56304,13707,7573,6134,46142,60074,3628,56304
8600000US56307,3965,1935,2030,66964,82335,6066,56307
8600000US56308,19786,9832,9954,60251,81646,6092,56308
8600000US56309,973,502,471,56583,68566,4689,56309
8600000US56310,4206,2153,2053,78885,90884,8988,56310
8600000US56311,577,295,282,56875,67350,14420,56311
8600000US56312,1968,1057,911,63958,79772,5096,56312
8600000US56313,67,29,38,35625,37661,9952,56313
8600000US56314,810,437,373,61750,78092,7315,56314
8600000US56315,1223,625,598,71346,85222,8963,56315
8600000US56316,1107,555,552,50167,65773,8969,56316
8600000US56318,845,441,404,69044,81534,5069,56318
8600000US56319,1000,509,491,70813,86673,10363,56319
8600000US56320,6220,3107,3113,73977,86635,5779,56320
8600000US56321,1512,1458,54,,,,56321
8600000US56323,436,222,214,53833,65559,13646,56323
8600000US56324,901,496,405,62813,74594,6398,56324
8600000US56325,157,75,82,41875,100096,48940,56325
8600000US56326,1199,615,584,55962,66904,5639,56326
8600000US56327,613,327,286,78750,98512,10027,56327
8600000US56328,126,69,57,43636,55492,15002,56328
8600000US56329,5219,2640,2579,70280,79527,3806,56329
8600000US56330,1275,657,618,63393,73909,5611,56330
8600000US56331,1599,824,775,78889,92314,10019,56331
8600000US56332,1204,623,581,64554,79784,8268,56332
8600000US56334,4489,2180,2309,58542,75692,4572,56334
8600000US56335,189,82,107,57708,61018,7642,56335
8600000US56336,1231,621,610,58688,73078,6163,56336
8600000US56338,1322,681,641,60556,72200,4666,56338
8600000US56339,823,442,381,58587,65542,6798,56339
8600000US56340,1764,946,818,63977,74029,4627,56340
8600000US56342,2189,1114,1075,44766,56247,3148,56342
8600000US56343,772,381,391,55000,71574,8543,56343
8600000US56345,11248,5441,5807,50915,68869,6566,56345
8600000US56347,5217,2686,2531,51054,61749,4161,56347
8600000US56349,635,337,298,71375,81108,11357,56349
8600000US56350,406,211,195,56184,61519,6850,56350
8600000US56352,4378,2120,2258,56866,72395,3757,56352
8600000US56353,6900,3477,3423,58390,68458,3691,56353
8600000US56354,1129,570,559,64750,75266,5843,56354
8600000US56355,440,227,213,57813,66339,15141,56355
8600000US56356,215,102,113,48125,57667,8045,56356
8600000US56357,779,398,381,72946,87862,13367,56357
8600000US56358,2544,1328,1216,60000,70946,3857,56358
8600000US56359,2673,1333,1340,41369,56207,3829,56359
8600000US56360,2945,1435,1510,53339,65937,4481,56360
8600000US56361,1773,917,856,56406,60809,3565,56361
8600000US56362,4498,2148,2350,61905,77541,4737,56362
8600000US56363,138,74,64,47083,58116,14054,56363
8600000US56364,4175,2117,2058,59063,73496,2988,56364
8600000US56367,4757,2401,2356,74392,88213,5357,56367
8600000US56368,3561,1731,1830,67500,81696,5781,56368
8600000US56369,452,274,178,43750,57789,12466,56369
8600000US56371,86,41,45,67813,61193,12580,56371
8600000US56373,2328,1219,1109,63125,74653,5664,56373
8600000US56374,8289,3351,4938,67994,80143,5207,56374
8600000US56375,680,362,318,80000,84809,8376,56375
8600000US56376,244,118,126,67917,69135,9760,56376
8600000US56377,13382,6448,6934,75400,96454,5073,56377
8600000US56378,5845,2955,2890,60405,75248,6871,56378
8600000US56379,12733,6358,6375,55417,72467,4312,56379
8600000US56381,1922,957,965,57123,71712,5033,56381
8600000US56382,1092,586,506,61548,69954,4438,56382
8600000US56384,300,144,156,37000,53175,9399,56384
8600000US56385,603,318,285,48750,62537,5884,56385
8600000US56386,531,266,265,39167,59924,9669,56386
8600000US56387,5709,2681,3028,39930,51789,4948,56387
8600000US56389,71,27,44,64500,84786,36589,56389
8600000US56401,22685,10953,11732,51857,70542,5353,56401
8600000US56425,6055,2969,3086,66788,75330,6098,56425
8600000US56431,7332,3659,3673,46724,58355,2233,56431
8600000US56433,1401,737,664,47813,65867,7858,56433
8600000US56434,199,89,110,50000,56443,8593,56434
8600000US56435,1957,993,964,48971,57325,3459,56435
8600000US56436,39,20,19,,60083,33834,56436
8600000US56437,1024,529,495,49167,56291,5234,56437
8600000US56438,2195,1116,1079,57716,68692,4757,56438
8600000US56440,1045,531,514,50116,51449,4394,56440
8600000US56441,3065,1488,1577,43375,64615,7969,56441
8600000US56442,2019,1008,1011,60938,94351,11789,56442
8600000US56443,1113,552,561,58917,68859,4288,56443
8600000US56444,2579,1322,1257,57596,76427,8222,56444
8600000US56446,1121,560,561,41339,54349,5254,56446
8600000US56447,788,387,401,45104,61867,6776,56447
8600000US56448,262,145,117,54583,82351,21669,56448
8600000US56449,1324,731,593,67895,85290,9093,56449
8600000US56450,834,402,432,44583,56874,5503,56450
8600000US56452,1629,835,794,54700,74132,5409,56452
8600000US56453,655,321,334,44286,60480,12585,56453
8600000US56455,1444,740,704,55163,61187,4559,56455
8600000US56456,43,23,20,28438,42086,12104,56456
8600000US56458,311,155,156,66250,77258,11863,56458
8600000US56461,2594,1386,1208,59801,72696,5296,56461
8600000US56464,3208,1672,1536,50160,61082,2866,56464
8600000US56465,1659,898,761,62143,85708,10984,56465
8600000US56466,2446,1204,1242,44357,59066,5527,56466
8600000US56467,2048,1026,1022,55938,68004,4798,56467
8600000US56468,3750,1934,1816,67659,93962,7950,56468
8600000US56469,913,466,447,55398,62343,6481,56469
8600000US56470,8313,4109,4204,53125,66981,3169,56470
8600000US56472,6007,3000,3007,54301,73010,4623,56472
8600000US56473,2654,1350,1304,59770,72832,5420,56473
8600000US56474,3311,1682,1629,45302,57246,3590,56474
8600000US56475,1216,613,603,53897,62644,5278,56475
8600000US56477,2028,1040,988,51295,60043,3790,56477
8600000US56479,4141,2060,2081,43197,59725,4761,56479
8600000US56481,1443,741,702,48125,65420,5362,56481
8600000US56482,5192,2518,2674,46382,60859,7221,56482
8600000US56484,2713,1306,1407,47004,67028,3943,56484
8600000US56501,13570,6540,7030,60092,75857,4645,56501
8600000US56510,1746,810,936,53385,67796,4889,56510
8600000US56511,1473,772,701,65417,79076,6469,56511
8600000US56514,2657,1305,1352,77632,83520,7571,56514
8600000US56515,2527,1226,1301,60000,77665,3610,56515
8600000US56516,193,95,98,63750,77602,17603,56516
8600000US56517,183,87,96,52273,69398,10502,56517
8600000US56518,261,146,115,45750,55455,8003,56518
8600000US56519,194,112,82,60833,67373,11265,56519
8600000US56520,2973,1461,1512,44338,65466,12367,56520
8600000US56521,545,255,290,52578,63678,9313,56521
8600000US56522,354,182,172,61625,76977,9194,56522
8600000US56523,395,203,192,66250,75465,7438,56523
8600000US56524,534,273,261,51250,72574,9293,56524
8600000US56525,77,43,34,71250,75339,17146,56525
8600000US56527,616,321,295,37500,49595,6138,56527
8600000US56528,1337,698,639,58315,71932,7316,56528
8600000US56529,3150,1425,1725,66519,81156,8577,56529
8600000US56531,1551,727,824,58259,74808,8952,56531
8600000US56533,241,136,105,70750,80098,10749,56533
8600000US56534,999,480,519,63750,99958,19158,56534
8600000US56535,1018,503,515,52650,63470,5624,56535
8600000US56536,329,179,150,60125,79773,14165,56536
8600000US56537,14951,7102,7849,54181,69510,3312,56537
8600000US56540,1590,811,779,58426,66660,5398,56540
8600000US56541,16,8,8,,,,56541
8600000US56542,2235,1102,1133,49943,62211,3718,56542
8600000US56543,181,97,84,75833,81463,11551,56543
8600000US56544,3985,2063,1922,62337,70795,3218,56544
8600000US56545,515,275,240,64844,69926,7045,56545
8600000US56546,196,105,91,76250,90042,13754,56546
8600000US56547,1913,1010,903,82292,93704,7156,56547
8600000US56548,624,335,289,48611,62837,10591,56548
8600000US56549,3463,1786,1677,79191,91684,4629,56549
8600000US56550,340,160,180,46875,58701,12458,56550
8600000US56551,1644,825,819,47045,60787,6016,56551
8600000US56552,327,177,150,63750,103169,35064,56552
8600000US56553,162,88,74,59375,90962,18520,56553
8600000US56554,2067,1039,1028,66944,85709,6945,56554
8600000US56556,859,426,433,50893,70382,8132,56556
8600000US56557,2005,970,1035,41422,59099,3913,56557
8600000US56560,33921,16386,17535,61557,72882,3078,56560
8600000US56565,31,14,17,78750,69000,15449,56565
8600000US56566,307,132,175,35000,41990,4157,56566
8600000US56567,2395,1238,1157,55833,65229,4298,56567
8600000US56568,144,76,68,,47325,20312,56568
8600000US56569,928,472,456,42727,58727,8420,56569
8600000US56570,893,493,400,54531,67954,6515,56570
8600000US56571,1479,754,725,58553,71061,6138,56571
8600000US56572,4106,2099,2007,63083,79282,5447,56572
8600000US56573,4796,2401,2395,58060,75215,5058,56573
8600000US56574,156,82,74,64375,73578,13868,56574
8600000US56575,582,315,267,40972,54287,6078,56575
8600000US56576,665,350,315,56406,77521,13455,56576
8600000US56577,4,2,2,,,,56577
8600000US56578,566,303,263,66875,84828,13431,56578
8600000US56579,943,491,452,58125,65463,4285,56579
8600000US56580,1016,523,493,75114,89675,14183,56580
8600000US56581,188,105,83,56750,60903,8277,56581
8600000US56583,83,47,36,84167,77983,16502,56583
8600000US56584,1062,550,512,56136,62259,4436,56584
8600000US56585,834,424,410,57708,71638,9603,56585
8600000US56586,1516,797,719,65781,71176,3538,56586
8600000US56587,1046,538,508,56932,76397,7426,56587
8600000US56588,405,211,194,61250,69924,12064,56588
8600000US56589,1475,757,718,48750,62645,4449,56589
8600000US56590,243,140,103,44286,76163,13852,56590
8600000US56591,127,55,72,40417,53253,9387,56591
8600000US56592,318,162,156,46875,64014,10104,56592
8600000US56593,0,0,0,,,,56593
8600000US56594,371,185,186,70179,110450,40949,56594
8600000US56601,26675,13122,13553,50573,67596,3597,56601
8600000US56621,3545,1773,1772,44093,60977,4895,56621
8600000US56623,2154,1139,1015,48699,58278,5259,56623
8600000US56626,203,94,109,37813,34772,7239,56626
8600000US56627,217,108,109,31188,46283,11527,56627
8600000US56628,1445,711,734,43056,65726,10129,56628
8600000US56629,145,89,56,76750,83074,13446,56629
8600000US56630,1640,793,847,45000,52979,3113,56630
8600000US56633,2999,1439,1560,41444,54171,3385,56633
8600000US56634,1130,560,570,46648,66575,6616,56634
8600000US56636,3813,1941,1872,51358,60405,3801,56636
8600000US56637,157,79,78,66000,75243,11971,56637
8600000US56639,360,195,165,33333,46601,8064,56639
8600000US56641,247,139,108,45000,52374,5850,56641
8600000US56644,604,325,279,47083,60393,5155,56644
8600000US56646,299,170,129,52500,57307,11055,56646
8600000US56647,674,323,351,50000,61940,9556,56647
8600000US56649,7523,3726,3797,47009,65793,7231,56649
8600000US56650,581,309,272,42614,55989,7385,56650
8600000US56651,460,240,220,48281,59769,5859,56651
8600000US56652,485,259,226,67321,76570,12405,56652
8600000US56653,1058,543,515,55078,60947,6652,56653
8600000US56654,111,55,56,50833,58023,22168,56654
8600000US56655,1339,658,681,44375,58929,4191,56655
8600000US56657,290,145,145,38393,53404,7720,56657
8600000US56658,0,0,0,,,,56658
8600000US56659,64,29,35,60625,101207,52149,56659
8600000US56660,238,105,133,55357,58617,13299,56660
8600000US56661,681,352,329,43375,57147,9064,56661
8600000US56662,451,240,211,48750,63127,5968,56662
8600000US56663,137,66,71,45536,42718,7397,56663
8600000US56666,655,319,336,32011,42981,10660,56666
8600000US56667,476,247,229,68333,88167,13174,56667
8600000US56668,136,51,85,65893,92286,36053,56668
8600000US56669,308,175,133,32813,46835,8143,56669
8600000US56670,793,324,469,36875,36714,8309,56670
8600000US56671,1842,991,851,37284,44719,5032,56671
8600000US56672,1666,847,819,43802,58628,5933,56672
8600000US56673,567,307,260,49665,59258,6977,56673
8600000US56676,1223,616,607,53188,63683,5221,56676
8600000US56678,989,519,470,61000,70553,7841,56678
8600000US56680,132,67,65,43750,69472,15850,56680
8600000US56681,220,114,106,50536,58833,25830,56681
8600000US56683,549,266,283,63333,77704,9231,56683
8600000US56684,214,120,94,38333,61658,12187,56684
8600000US56685,87,48,39,,45483,21062,56685
8600000US56686,761,408,353,55673,64690,10898,56686
8600000US56687,43,22,21,34167,47604,15140,56687
8600000US56688,112,64,48,39107,51689,10045,56688
8600000US56701,10007,4899,5108,59180,71656,3595,56701
8600000US56710,447,224,223,52857,61214,6802,56710
8600000US56711,0,0,0,,,,56711
8600000US56713,804,381,423,70000,77333,8343,56713
8600000US56714,903,485,418,54886,58868,3853,56714
8600000US56715,269,135,134,60000,92246,30157,56715
8600000US56716,7146,3641,3505,55389,69138,5965,56716
8600000US56720,18,13,5,,60792,28991,56720
8600000US56721,7584,3724,3860,63891,72463,3769,56721
8600000US56722,276,144,132,57500,90445,24089,56722
8600000US56723,681,334,347,73750,92582,12285,56723
8600000US56724,125,70,55,48500,64362,13131,56724
8600000US56725,726,380,346,61477,75186,8644,56725
8600000US56726,1303,644,659,59167,67882,4616,56726
8600000US56727,518,286,232,52656,65013,8519,56727
8600000US56728,1129,586,543,65278,83400,10095,56728
8600000US56729,95,51,44,43393,50823,10805,56729
8600000US56731,44,23,21,50000,59939,16775,56731
8600000US56732,856,388,468,45500,59003,8331,56732
8600000US56733,294,162,132,56500,70474,11505,56733
8600000US56734,394,197,197,51250,58242,6841,56734
8600000US56735,537,292,245,58375,65441,5224,56735
8600000US56736,828,433,395,60078,77499,9248,56736
8600000US56737,677,331,346,42697,55618,4459,56737
8600000US56738,1119,609,510,64265,79546,6930,56738
8600000US56741,0,0,0,,,,56741
8600000US56742,692,353,339,54250,65541,9438,56742
8600000US56744,382,202,180,59500,82225,14880,56744
8600000US56748,512,264,248,62813,75408,9193,56748
8600000US56750,1740,859,881,61125,69308,4496,56750
8600000US56751,4323,2202,2121,62636,76230,4020,56751
8600000US56754,438,235,203,76250,76120,11916,56754
8600000US56755,72,37,35,65417,73737,19518,56755
8600000US56756,498,238,260,60917,67840,7699,56756
8600000US56757,660,331,329,59444,70671,6325,56757
8600000US56758,290,166,124,53750,62383,9352,56758
8600000US56759,211,114,97,70750,72596,13749,56759
8600000US56760,285,177,108,52857,65933,13822,56760
8600000US56761,358,195,163,65417,79622,12300,56761
8600000US56762,1963,964,999,64038,68655,3677,56762
8600000US56763,3817,2005,1812,58322,66670,7086,56763
8600000US57001,1239,645,594,50208,61537,6875,57001
8600000US57002,718,360,358,71597,76355,10911,57002
8600000US57003,1420,765,655,81750,90447,9411,57003
8600000US57004,2778,1442,1336,65000,78618,5888,57004
8600000US57005,7923,3846,4077,88327,97000,4165,57005
8600000US57006,21693,11222,10471,53111,67922,3539,57006
8600000US57010,318,172,146,72563,91292,35214,57010
8600000US57012,914,443,471,59313,68775,6970,57012
8600000US57013,3998,2036,1962,66250,91632,12133,57013
8600000US57014,1051,513,538,49125,56708,4511,57014
8600000US57015,605,300,305,79896,109620,41627,57015
8600000US57016,535,256,279,76188,100101,21025,57016
8600000US57017,1112,549,563,73563,87335,11486,57017
8600000US57018,1100,581,519,64671,79103,10785,57018
8600000US57020,1003,487,516,99375,104056,7014,57020
8600000US57021,167,96,71,60833,69086,11907,57021
8600000US57022,3524,1851,1673,69398,84885,7236,57022
8600000US57024,341,174,167,56750,66406,12258,57024
8600000US57025,2174,1011,1163,69808,78924,7567,57025
8600000US57026,863,451,412,66250,77748,12169,57026
8600000US57027,101,71,30,,198850,147056,57027
8600000US57028,2517,1231,1286,51250,62465,6845,57028
8600000US57029,1640,807,833,56813,62959,4520,57029
8600000US57030,2118,1051,1067,76010,96336,22447,57030
8600000US57031,636,313,323,62500,91463,28955,57031
8600000US57032,5290,2513,2777,79550,97764,10492,57032
8600000US57033,3888,1943,1945,78222,91446,7658,57033
8600000US57034,662,340,322,67813,98166,21268,57034
8600000US57035,846,469,377,62083,82640,21195,57035
8600000US57036,539,258,281,45000,66288,10100,57036
8600000US57037,766,414,352,70116,74258,8775,57037
8600000US57038,1197,607,590,81250,130725,32755,57038
8600000US57039,2540,1264,1276,57346,69049,5302,57039
8600000US57040,312,160,152,61786,63341,12731,57040
8600000US57041,60,40,20,107778,90073,18407,57041
8600000US57042,7419,3843,3576,56484,74548,10610,57042
8600000US57043,1097,523,574,52500,64797,7419,57043
8600000US57045,858,430,428,40208,62579,8270,57045
8600000US57046,711,338,373,74489,84681,15276,57046
8600000US57047,177,99,78,46250,53150,8833,57047
8600000US57048,791,404,387,65000,81502,15850,57048
8600000US57049,4904,2505,2399,75016,106462,12838,57049
8600000US57050,204,106,98,,60525,23362,57050
8600000US57051,197,105,92,57656,58187,10553,57051
8600000US57052,281,208,73,79688,122855,45631,57052
8600000US57053,1305,637,668,70602,78363,10551,57053
8600000US57054,421,243,178,56354,87173,28581,57054
8600000US57055,954,482,472,71793,89649,12880,57055
8600000US57057,146,80,66,48542,69882,18548,57057
8600000US57058,1527,760,767,61515,74238,9178,57058
8600000US57059,1002,515,487,51635,67297,8776,57059
8600000US57061,50,30,20,,56210,22507,57061
8600000US57062,2077,1674,403,46765,60827,6766,57062
8600000US57063,685,341,344,67650,70582,7843,57063
8600000US57064,4153,2053,2100,84932,101861,10926,57064
8600000US57065,332,178,154,60000,64917,10773,57065
8600000US57066,1261,577,684,49813,57253,6622,57066
8600000US57067,341,140,201,73807,118877,61293,57067
8600000US57068,1083,562,521,64297,92097,13806,57068
8600000US57069,10071,4893,5178,40823,66658,6522,57069
8600000US57070,1198,576,622,41111,55714,6360,57070
8600000US57071,2229,1124,1105,70922,87505,17220,57071
8600000US57072,435,218,217,78438,79764,9290,57072
8600000US57073,529,271,258,47022,83170,21141,57073
8600000US57075,962,532,430,89153,114513,25235,57075
8600000US57076,314,182,132,65263,76154,18402,57076
8600000US57077,1120,568,552,69474,77661,7918,57077
8600000US57078,14992,7787,7205,49530,74607,7736,57078
8600000US57103,26919,13695,13224,58801,73681,2930,57103
8600000US57104,20128,11126,9002,38290,49581,2572,57104
8600000US57105,17928,8435,9493,60159,79587,4583,57105
8600000US57106,34202,16544,17658,62994,74356,2860,57106
8600000US57107,7580,3737,3843,56953,67898,4304,57107
8600000US57108,16340,7768,8572,90987,133061,12467,57108
8600000US57110,12314,5868,6446,73511,87661,4570,57110
8600000US57117,34,34,0,,,,57117
8600000US57197,923,393,530,,,,57197
8600000US57201,19315,9517,9798,52392,69064,4176,57201
8600000US57212,1583,767,816,63611,74516,6315,57212
8600000US57213,546,282,264,67500,73902,11291,57213
8600000US57214,43,26,17,60179,51896,16442,57214
8600000US57216,915,492,423,65774,67035,7677,57216
8600000US57217,211,113,98,49375,54007,8143,57217
8600000US57218,233,124,109,66949,72690,12784,57218
8600000US57219,420,241,179,42125,53760,7246,57219
8600000US57220,512,269,243,73415,78660,11958,57220
8600000US57221,541,275,266,51528,72825,16635,57221
8600000US57223,859,441,418,70197,80418,7005,57223
8600000US57224,141,66,75,75833,176373,114853,57224
8600000US57225,1457,710,747,39291,62727,7769,57225
8600000US57226,1522,794,728,58382,67443,5463,57226
8600000US57227,209,118,91,51979,73850,26150,57227
8600000US57231,1240,623,617,69440,76913,7597,57231
8600000US57232,246,135,111,41250,66174,17927,57232
8600000US57233,107,60,47,56250,107471,37775,57233
8600000US57234,992,515,477,61042,68343,6469,57234
8600000US57235,623,309,314,70000,76394,6837,57235
8600000US57236,118,59,59,34583,56240,16505,57236
8600000US57237,548,266,282,50000,68127,14161,57237
8600000US57238,426,228,198,67596,63212,7587,57238
8600000US57239,197,104,93,46528,76627,26717,57239
8600000US57241,769,372,397,66411,78280,9240,57241
8600000US57242,234,120,114,52813,77363,13880,57242
8600000US57243,567,312,255,64643,77719,16009,57243
8600000US57245,121,65,56,75000,75060,17046,57245
8600000US57246,155,83,72,66458,88893,26676,57246
8600000US57247,280,154,126,86023,85456,20740,57247
8600000US57248,723,391,332,72212,76245,7042,57248
8600000US57249,702,396,306,55750,61424,6840,57249
8600000US57251,147,70,77,46667,72106,20668,57251
8600000US57252,3675,1901,1774,63856,72062,7857,57252
8600000US57255,281,152,129,36250,45490,8230,57255
8600000US57256,69,33,36,,86209,68475,57256
8600000US57257,496,264,232,52708,61499,8753,57257
8600000US57258,109,50,59,50417,65542,19831,57258
8600000US57259,334,174,160,65500,92156,31238,57259
8600000US57260,697,347,350,71500,80341,8345,57260
8600000US57261,344,177,167,60833,183994,80168,57261
8600000US57262,3894,1915,1979,42161,65112,6460,57262
8600000US57263,319,194,125,49375,62764,14123,57263
8600000US57264,209,96,113,48281,66268,14429,57264
8600000US57265,154,83,71,73125,72408,13776,57265
8600000US57266,404,211,193,51563,60348,6890,57266
8600000US57268,324,186,138,61250,67286,12272,57268
8600000US57269,243,134,109,70227,112623,49539,57269
8600000US57270,630,357,273,43750,52828,8055,57270
8600000US57271,117,55,62,75417,77806,21018,57271
8600000US57272,163,94,69,73571,67116,7699,57272
8600000US57273,801,395,406,43472,59742,11201,57273
8600000US57274,2076,1043,1033,40357,54326,4444,57274
8600000US57276,916,448,468,65446,84783,17186,57276
8600000US57278,526,269,257,53882,67101,10861,57278
8600000US57279,962,522,440,55556,72663,11535,57279
8600000US57301,14390,7254,7136,47063,66198,5628,57301
8600000US57311,1086,527,559,63478,79315,9215,57311
8600000US57312,477,248,229,68409,95548,20371,57312
8600000US57313,946,455,491,53068,62378,5116,57313
8600000US57314,634,333,301,59500,86601,17679,57314
8600000US57315,803,381,422,60000,73419,10626,57315
8600000US57317,484,260,224,49063,69150,14750,57317
8600000US57319,586,293,293,61667,71287,7409,57319
8600000US57321,307,163,144,60417,70219,12808,57321
8600000US57322,315,194,121,50938,78145,24490,57322
8600000US57323,178,87,91,53393,67805,19810,57323
8600000US57324,263,123,140,65250,71317,13201,57324
8600000US57325,2390,1159,1231,50795,80141,14736,57325
8600000US57328,917,439,478,69861,73452,8772,57328
8600000US57329,221,116,105,56458,63232,13378,57329
8600000US57330,370,192,178,46908,73466,18804,57330
8600000US57331,281,135,146,70500,77371,17609,57331
8600000US57332,640,317,323,63594,73397,11881,57332
8600000US57334,698,318,380,62000,79756,9656,57334
8600000US57335,252,127,125,40750,61740,15250,57335
8600000US57337,108,58,50,42708,65203,30643,57337
8600000US57339,1005,496,509,29306,38415,4779,57339
8600000US57340,215,122,93,44250,51161,7715,57340
8600000US57341,81,42,39,38646,43515,15582,57341
8600000US57342,453,216,237,56042,67838,12904,57342
8600000US57344,105,53,52,85625,162567,108555,57344
8600000US57345,931,446,485,55625,73222,9570,57345
8600000US57346,61,48,13,55313,59590,22757,57346
8600000US57348,486,247,239,73500,94603,14167,57348
8600000US57349,1079,548,531,52917,61084,6258,57349
8600000US57350,11379,5837,5542,49686,59961,3339,57350
8600000US57353,612,301,311,55476,68777,9021,57353
8600000US57355,867,420,447,51630,62155,9846,57355
8600000US57356,1276,618,658,40238,52122,5109,57356
8600000US57358,35,23,12,43750,40603,11031,57358
8600000US57359,633,293,340,53208,70686,9914,57359
8600000US57361,127,71,56,37083,38352,7634,57361
8600000US57362,1641,841,800,45313,62775,5982,57362
8600000US57363,665,342,323,55227,79503,14573,57363
8600000US57364,21,10,11,,,,57364
8600000US57365,448,229,219,66979,67033,8151,57365
8600000US57366,1764,854,910,57050,73824,7520,57366
8600000US57367,179,88,91,64000,75205,11089,57367
8600000US57368,833,408,425,65060,82827,12695,57368
8600000US57369,1867,909,958,51287,63894,7714,57369
8600000US57370,546,268,278,51719,61535,8930,57370
8600000US57371,131,71,60,55893,60691,15499,57371
8600000US57373,388,194,194,61250,70153,11045,57373
8600000US57374,227,120,107,59375,71149,13911,57374
8600000US57375,486,282,204,54792,67485,11198,57375
8600000US57376,781,373,408,45781,58769,8604,57376
8600000US57379,76,36,40,46719,49197,10458,57379
8600000US57380,2611,1259,1352,43317,59245,5354,57380
8600000US57381,372,176,196,55625,77725,26596,57381
8600000US57382,1125,512,613,45370,82359,20725,57382
8600000US57383,587,320,267,62450,71855,12470,57383
8600000US57384,695,339,356,77422,81796,7535,57384
8600000US57385,852,433,419,51211,64958,10218,57385
8600000US57386,150,78,72,77813,83124,27008,57386
8600000US57401,25138,12175,12963,54505,73437,6466,57401
8600000US57420,56,38,18,54000,52563,11224,57420
8600000US57421,95,49,46,76250,81858,26038,57421
8600000US57422,201,112,89,44423,53080,10610,57422
8600000US57424,194,107,87,61250,76791,16882,57424
8600000US57426,38,25,13,,36219,28395,57426
8600000US57427,547,269,278,108194,108620,21806,57427
8600000US57428,455,218,237,52500,61517,9521,57428
8600000US57429,58,29,29,,60320,23906,57429
8600000US57430,1732,845,887,68008,74423,7018,57430
8600000US57432,324,143,181,75243,73035,13768,57432
8600000US57433,200,106,94,52159,68698,15841,57433
8600000US57434,340,138,202,77750,187549,106155,57434
8600000US57435,174,87,87,39792,61056,12708,57435
8600000US57436,349,176,173,58000,78043,13655,57436
8600000US57437,1223,559,664,36313,58651,9256,57437
8600000US57438,1218,531,687,50982,67445,10222,57438
8600000US57439,60,28,32,,47637,18603,57439
8600000US57440,453,215,238,58125,122397,40293,57440
8600000US57441,430,223,207,63523,90344,21098,57441
8600000US57442,1411,721,690,52833,75184,9464,57442
8600000US57445,1387,639,748,65833,92284,13909,57445
8600000US57446,296,161,135,64773,79598,17755,57446
8600000US57448,358,196,162,55694,81848,19067,57448
8600000US57449,153,90,63,75000,99332,45362,57449
8600000US57450,473,240,233,57939,64188,11165,57450
8600000US57451,1680,882,798,73942,85249,11811,57451
8600000US57452,195,102,93,36250,48658,11169,57452
8600000US57454,477,263,214,61765,83469,13935,57454
8600000US57455,61,22,39,53750,67647,35653,57455
8600000US57456,543,273,270,52875,61737,8281,57456
8600000US57457,68,34,34,91250,124647,37191,57457
8600000US57460,263,129,134,64688,80228,18632,57460
8600000US57461,281,132,149,60750,75707,12968,57461
8600000US57465,239,124,115,62813,92663,15325,57465
8600000US57466,162,104,58,56250,73970,17369,57466
8600000US57467,217,109,108,49063,110637,67585,57467
8600000US57468,294,165,129,46250,51511,16139,57468
8600000US57469,2591,1241,1350,48381,71939,8390,57469
8600000US57470,67,33,34,67813,71808,18020,57470
8600000US57471,459,263,196,57500,73838,11420,57471
8600000US57472,761,383,378,64861,80338,11869,57472
8600000US57473,112,65,47,,112178,41392,57473
8600000US57474,184,76,108,68750,79368,23368,57474
8600000US57475,71,35,36,,71241,35418,57475
8600000US57476,315,172,143,72000,73907,8800,57476
8600000US57477,108,63,45,70179,95496,29291,57477
8600000US57479,404,235,169,86875,100146,15908,57479
8600000US57481,386,269,117,61544,72065,9887,57481
8600000US57501,12958,6235,6723,64170,78107,4807,57501
8600000US57520,78,37,41,42500,53298,19921,57520
8600000US57521,129,72,57,,30896,17186,57521
8600000US57522,334,190,144,60156,70739,12788,57522
8600000US57523,738,377,361,44167,69280,12258,57523
8600000US57528,612,289,323,51875,66969,13307,57528
8600000US57529,276,162,114,49531,69363,23067,57529
8600000US57531,102,62,40,41125,47998,14214,57531
8600000US57532,2175,1124,1051,71699,87055,8869,57532
8600000US57533,1470,699,771,43405,56403,5597,57533
8600000US57534,228,146,82,63529,73950,24286,57534
8600000US57536,263,159,104,57788,85506,30845,57536
8600000US57537,85,38,47,89500,101332,28124,57537
8600000US57538,174,91,83,50417,55696,11527,57538
8600000US57540,57,30,27,,45572,27637,57540
8600000US57541,136,72,64,,55768,19037,57541
8600000US57543,682,322,360,39667,47799,7450,57543
8600000US57544,389,213,176,60357,70544,9929,57544
8600000US57547,104,53,51,31094,34083,12937,57547
8600000US57548,933,456,477,32938,41610,3223,57548
8600000US57551,1584,784,800,49821,57285,5498,57551
8600000US57552,425,221,204,38641,54801,13417,57552
8600000US57553,58,31,27,33125,30139,8208,57553
8600000US57555,2557,1233,1324,28594,40080,4693,57555
8600000US57559,450,209,241,39038,54563,8322,57559
8600000US57560,342,182,160,19886,30882,8363,57560
8600000US57562,33,19,14,46250,46963,11334,57562
8600000US57563,142,61,81,21964,37962,20828,57563
8600000US57564,743,369,374,68462,100070,22120,57564
8600000US57566,709,368,341,21806,32551,9298,57566
8600000US57567,1211,612,599,37333,55579,8871,57567
8600000US57568,520,295,225,67375,79849,12474,57568
8600000US57569,205,93,112,39938,53434,13026,57569
8600000US57570,1288,669,619,20455,42095,9030,57570
8600000US57571,4,2,2,,,,57571
8600000US57572,1160,515,645,16094,24312,3688,57572
8600000US57574,147,76,71,70833,76725,23700,57574
8600000US57576,180,103,77,36250,51511,13695,57576
8600000US57577,997,517,480,22969,33958,7562,57577
8600000US57579,924,470,454,33000,42716,5794,57579
8600000US57580,3171,1538,1633,50850,57199,5303,57580
8600000US57584,50,24,26,56250,49484,22100,57584
8600000US57585,132,72,60,32411,61063,23510,57585
8600000US57601,3015,1444,1571,47500,70187,12567,57601
8600000US57620,336,172,164,60096,67407,12289,57620
8600000US57621,211,116,95,21250,88650,73322,57621
8600000US57622,280,173,107,19688,29198,8588,57622
8600000US57623,779,391,388,51389,61175,7932,57623
8600000US57625,2721,1284,1437,38449,46104,3650,57625
8600000US57626,746,384,362,55417,68218,8372,57626
8600000US57630,24,11,13,39500,70800,43136,57630
8600000US57631,315,166,149,73889,74621,10689,57631
8600000US57632,480,235,245,57500,75530,14456,57632
8600000US57633,295,163,132,56932,106373,29188,57633
8600000US57634,118,64,54,45750,56783,10322,57634
8600000US57636,103,39,64,42656,44475,14925,57636
8600000US57638,1531,757,774,49926,73147,13977,57638
8600000US57639,191,92,99,14922,19284,3457,57639
8600000US57640,124,73,51,72054,71174,22292,57640
8600000US57641,245,136,109,41458,54071,9698,57641
8600000US57642,1201,580,621,30417,43519,4780,57642
8600000US57644,198,95,103,49464,61370,15024,57644
8600000US57645,129,66,63,42500,63350,14040,57645
8600000US57646,184,113,71,55938,210183,178851,57646
8600000US57648,276,148,128,41324,62616,13371,57648
8600000US57649,163,92,71,65417,73287,17155,57649
8600000US57650,24,9,15,,,,57650
8600000US57651,106,63,43,38333,52836,16245,57651
8600000US57652,262,126,136,31111,35885,7438,57652
8600000US57656,619,312,307,50000,76959,10580,57656
8600000US57657,191,103,88,83125,103010,22967,57657
8600000US57658,257,125,132,21250,32767,6559,57658
8600000US57660,85,41,44,72500,87333,27802,57660
8600000US57661,66,36,30,71250,80671,32486,57661
8600000US57701,34810,17675,17135,44895,58836,2757,57701
8600000US57702,27521,13165,14356,71215,97850,5706,57702
8600000US57703,12223,6514,5709,57342,68167,2980,57703
8600000US57706,2376,1545,831,47375,50361,3995,57706
8600000US57714,405,160,245,34722,37109,11879,57714
8600000US57716,331,153,178,62125,66724,10801,57716
8600000US57717,5971,2829,3142,44543,65999,9899,57717
8600000US57718,5298,2707,2591,69406,74404,9706,57718
8600000US57719,5568,2757,2811,54543,60321,4430,57719
8600000US57720,550,290,260,63214,81595,12878,57720
8600000US57722,174,92,82,39318,46310,15227,57722
8600000US57724,195,115,80,52083,53232,8372,57724
8600000US57725,260,119,141,48828,68488,18758,57725
8600000US57730,4809,2298,2511,56659,64020,6079,57730
8600000US57732,1879,985,894,50000,55742,5489,57732
8600000US57735,946,453,493,35000,46489,6843,57735
8600000US57738,109,70,39,43988,53462,13089,57738
8600000US57741,84,63,21,,,,57741
8600000US57744,1630,805,825,55174,71573,10476,57744
8600000US57745,1932,1058,874,58750,65850,9134,57745
8600000US57747,5012,2452,2560,52154,62018,5384,57747
8600000US57748,251,137,114,64750,73883,22973,57748
8600000US57750,179,81,98,53958,74196,38274,57750
8600000US57751,829,397,432,60625,75914,9766,57751
8600000US57752,1047,468,579,38594,42605,8528,57752
8600000US57754,3143,1620,1523,52652,66316,12507,57754
8600000US57755,75,35,40,56818,67202,15550,57755
8600000US57756,471,186,285,25568,47103,26616,57756
8600000US57758,82,48,34,,94216,110920,57758
8600000US57759,433,258,175,35926,43394,14622,57759
8600000US57760,937,520,417,54201,64915,9562,57760
8600000US57761,1082,507,575,74861,95682,17024,57761
8600000US57762,531,284,247,26429,40382,8579,57762
8600000US57763,218,109,109,49196,80675,22952,57763
8600000US57764,1297,655,642,22917,34740,12190,57764
8600000US57766,160,78,82,,74612,25843,57766
8600000US57767,93,52,41,50278,114345,90670,57767
8600000US57769,2919,1428,1491,65217,72642,8107,57769
8600000US57770,4083,1984,2099,36750,49202,7255,57770
8600000US57772,1482,712,770,22696,33370,10106,57772
8600000US57773,162,89,73,68214,64025,18782,57773
8600000US57775,214,103,111,79318,104433,53803,57775
8600000US57776,0,0,0,,,,57776
8600000US57779,191,98,93,43169,50891,12486,57779
8600000US57780,46,26,20,53438,58861,15704,57780
8600000US57782,32,14,18,,124305,85748,57782
8600000US57783,12423,6058,6365,50658,74016,7573,57783
8600000US57785,7223,3599,3624,55503,70075,8192,57785
8600000US57787,306,155,151,44292,52681,10922,57787
8600000US57788,332,184,148,61667,79149,27474,57788
8600000US57790,775,353,422,65250,71914,8521,57790
8600000US57791,231,112,119,68015,63863,13768,57791
8600000US57792,138,76,62,105982,102502,41576,57792
8600000US57793,1780,947,833,68029,70323,10559,57793
8600000US57794,277,109,168,,13167,7331,57794
8600000US57799,681,224,457,,,,57799
8600000US58001,26,16,10,128750,112025,44004,58001
8600000US58002,32,21,11,,73629,50635,58002
8600000US58004,217,120,97,94464,91629,19795,58004
8600000US58005,621,320,301,106406,139313,26568,58005
8600000US58006,336,161,175,70000,91742,22130,58006
8600000US58007,85,44,41,,86160,33948,58007
8600000US58008,159,93,66,79886,105992,20488,58008
8600000US58009,12,6,6,,,,58009
8600000US58011,336,170,166,68750,85741,14652,58011
8600000US58012,1850,886,964,78500,97682,13429,58012
8600000US58013,113,64,49,63750,88221,35011,58013
8600000US58015,203,120,83,70625,81652,12782,58015
8600000US58016,100,48,52,82656,92609,34125,58016
8600000US58017,248,132,116,58958,81421,15754,58017
8600000US58018,253,138,115,115625,149826,37765,58018
8600000US58021,271,126,145,69000,85131,27304,58021
8600000US58027,1095,561,534,58900,73015,6986,58027
8600000US58029,78,48,30,82625,83700,23020,58029
8600000US58030,484,247,237,59375,76940,9409,58030
8600000US58031,332,172,160,67692,78287,19729,58031
8600000US58032,577,291,286,57639,84718,15871,58032
8600000US58033,372,184,188,81875,125411,41600,58033
8600000US58035,195,108,87,55972,79180,19960,58035
8600000US58036,239,144,95,71563,127009,70459,58036
8600000US58038,267,146,121,73125,88692,15445,58038
8600000US58040,865,481,384,73688,78980,5536,58040
8600000US58041,1135,560,575,67917,78991,11054,58041
8600000US58042,966,480,486,107440,115871,12057,58042
8600000US58043,110,64,46,97614,82557,20398,58043
8600000US58045,1659,801,858,64716,77049,7013,58045
8600000US58046,489,254,235,60750,97000,25824,58046
8600000US58047,3247,1653,1594,131086,179164,45599,58047
8600000US58048,333,168,165,64345,84780,16032,58048
8600000US58049,304,130,174,64960,83104,12847,58049
8600000US58051,1281,603,678,106818,119035,18264,58051
8600000US58052,432,232,200,73438,85966,14338,58052
8600000US58053,897,459,438,51250,59544,5768,58053
8600000US58054,2383,1192,1191,61273,78134,10753,58054
8600000US58056,129,82,47,71750,64738,11878,58056
8600000US58057,78,35,43,66071,61495,13215,58057
8600000US58058,69,31,38,58977,72330,17509,58058
8600000US58059,942,533,409,83667,91456,7986,58059
8600000US58060,942,478,464,62500,77199,7788,58060
8600000US58061,268,143,125,77500,77013,8529,58061
8600000US58062,124,67,57,70313,92006,27798,58062
8600000US58063,257,131,126,56786,79786,21434,58063
8600000US58064,356,183,173,74688,86219,18846,58064
8600000US58065,29,16,13,43594,42438,4815,58065
8600000US58067,202,107,95,64219,76756,16499,58067
8600000US58068,308,148,160,71141,88308,17462,58068
8600000US58069,90,46,44,65833,83339,15841,58069
8600000US58071,336,192,144,54464,73896,15945,58071
8600000US58072,6305,3134,3171,52131,70729,6356,58072
8600000US58075,7469,3981,3488,56047,67565,4551,58075
8600000US58076,355,231,124,,,,58076
8600000US58077,513,267,246,76172,90405,10659,58077
8600000US58078,25319,12521,12798,81616,105969,10712,58078
8600000US58079,353,168,185,110625,129338,22589,58079
8600000US58081,661,339,322,71146,83348,11497,58081
8600000US58102,25001,13893,11108,47964,70435,4144,58102
8600000US58103,39136,19345,19791,45646,61815,3073,58103
8600000US58104,31185,15094,16091,77055,102676,6103,58104
8600000US58105,2369,1263,1106,,,,58105
8600000US58201,31308,16011,15297,53067,77129,4158,58201
8600000US58202,1722,985,737,,,,58202
8600000US58203,14203,7392,6811,43664,53897,3596,58203
8600000US58204,1550,865,685,54231,62623,4446,58204
8600000US58205,338,264,74,,,,58205
8600000US58210,291,180,111,48813,61851,13230,58210
8600000US58212,453,281,172,48542,56458,8511,58212
8600000US58214,273,122,151,75417,78434,15850,58214
8600000US58216,139,74,65,69375,76171,23963,58216
8600000US58218,661,345,316,84402,92702,9467,58218
8600000US58219,33,18,15,,46543,19139,58219
8600000US58220,1642,818,824,64310,77688,8080,58220
8600000US58222,218,119,99,47292,55150,10561,58222
8600000US58223,198,103,95,77045,119850,64778,58223
8600000US58224,55,27,28,79432,94580,15766,58224
8600000US58225,754,385,369,73403,87511,11896,58225
8600000US58227,434,223,211,76250,85375,11672,58227
8600000US58228,684,400,284,67813,81125,10812,58228
8600000US58229,80,37,43,73125,74827,24990,58229
8600000US58230,558,298,260,64079,67466,5732,58230
8600000US58231,288,156,132,59167,63471,7734,58231
8600000US58233,187,97,90,70313,130065,47264,58233
8600000US58235,313,185,128,62083,72846,11111,58235
8600000US58237,4008,1951,2057,50714,67178,4407,58237
8600000US58238,123,60,63,68750,84477,28848,58238
8600000US58239,11,4,7,,,,58239
8600000US58240,894,447,447,59125,73139,7778,58240
8600000US58241,133,66,67,,116036,48655,58241
8600000US58243,458,240,218,53750,74798,13057,58243
8600000US58244,98,55,43,74583,88931,19160,58244
8600000US58249,1875,920,955,67308,102617,18041,58249
8600000US58250,193,101,92,57375,64726,7944,58250
8600000US58251,1486,717,769,56331,68261,6005,58251
8600000US58254,355,187,168,53542,67016,8806,58254
8600000US58256,629,310,319,90769,92373,7031,58256
8600000US58257,1720,896,824,52917,77362,23591,58257
8600000US58258,240,134,106,67917,85130,10861,58258
8600000US58259,293,157,136,41842,57886,12135,58259
8600000US58260,175,90,85,79545,120599,41829,58260
8600000US58261,921,495,426,65833,78143,11213,58261
8600000US58262,81,42,39,60313,73817,27610,58262
8600000US58265,347,190,157,83750,129408,41730,58265
8600000US58266,131,74,57,74063,76027,20860,58266
8600000US58267,994,509,485,61250,86127,19184,58267
8600000US58269,225,116,109,54583,73565,16764,58269
8600000US58270,1467,700,767,47604,66334,7332,58270
8600000US58271,480,249,231,71250,71962,7257,58271
8600000US58272,199,99,100,65000,74066,13549,58272
8600000US58273,186,106,80,47986,56855,9958,58273
8600000US58274,684,353,331,67917,79202,9864,58274
8600000US58275,567,284,283,77321,92581,11275,58275
8600000US58276,420,228,192,59167,69613,8780,58276
8600000US58277,144,75,69,51563,75365,28926,58277
8600000US58278,1390,691,699,100682,111738,12846,58278
8600000US58281,106,51,55,100288,80355,18200,58281
8600000US58282,1163,646,517,61579,82075,18290,58282
8600000US58301,7835,3932,3903,56650,77767,10385,58301
8600000US58311,68,45,23,107697,82920,22151,58311
8600000US58316,4446,2036,2410,35212,55029,9216,58316
8600000US58317,167,93,74,75833,121412,47331,58317
8600000US58318,3093,1541,1552,58083,80076,10112,58318
8600000US58321,79,38,41,47083,68112,23981,58321
8600000US58323,37,19,18,153068,135884,30770,58323
8600000US58324,1064,583,481,50486,69190,14634,58324
8600000US58325,28,14,14,70833,56650,20765,58325
8600000US58327,243,130,113,89219,113021,31086,58327
8600000US58329,2223,1131,1092,38661,49053,5354,58329
8600000US58330,264,124,140,53125,82787,23786,58330
8600000US58331,76,24,52,,29352,11877,58331
8600000US58332,266,158,108,81250,135168,48738,58332
8600000US58335,964,466,498,24338,29916,4249,58335
8600000US58338,51,24,27,52083,100679,64762,58338
8600000US58339,24,20,4,,179256,120973,58339
8600000US58341,2011,955,1056,55225,65990,9158,58341
8600000US58343,53,27,26,78571,80378,29831,58343
8600000US58344,728,347,381,47857,72499,12245,58344
8600000US58345,116,54,62,51786,71779,25603,58345
8600000US58346,505,271,234,53355,66740,11719,58346
8600000US58348,613,309,304,58906,77234,14500,58348
8600000US58351,378,206,172,64583,88044,26198,58351
8600000US58352,339,191,148,58011,86253,16761,58352
8600000US58353,87,56,31,,135433,81159,58353
8600000US58355,54,25,29,64500,83325,19073,58355
8600000US58356,1379,640,739,47788,70726,8907,58356
8600000US58357,211,108,103,60500,75811,18841,58357
8600000US58361,186,87,99,53021,75672,21430,58361
8600000US58362,18,9,9,,,,58362
8600000US58363,98,49,49,91304,101146,29647,58363
8600000US58365,189,99,90,60114,62217,12130,58365
8600000US58366,873,417,456,45625,59397,7857,58366
8600000US58367,1196,612,584,50208,63118,7783,58367
8600000US58368,2918,1413,1505,43919,54542,6170,58368
8600000US58369,855,459,396,50795,66344,13987,58369
8600000US58370,825,425,400,30583,46088,9748,58370
8600000US58372,90,48,42,71250,105049,32669,58372
8600000US58374,428,210,218,50909,97841,25777,58374
8600000US58377,245,130,115,57321,110416,64312,58377
8600000US58379,211,100,111,42969,47767,8119,58379
8600000US58380,350,163,187,41786,62548,14891,58380
8600000US58381,262,126,136,63750,99731,28760,58381
8600000US58382,148,97,51,64750,69968,15155,58382
8600000US58384,401,224,177,59219,59224,9901,58384
8600000US58385,153,85,68,54375,87642,32521,58385
8600000US58386,107,67,40,75417,77440,15240,58386
8600000US58401,13688,7057,6631,56888,71649,4238,58401
8600000US58402,242,173,69,,,,58402
8600000US58405,428,192,236,,,,58405
8600000US58413,847,379,468,49038,59420,6145,58413
8600000US58415,146,68,78,97708,91526,24686,58415
8600000US58416,330,151,179,42188,72175,14703,58416
8600000US58418,311,137,174,52500,91842,41699,58418
8600000US58420,244,140,104,90417,87462,10577,58420
8600000US58421,2171,1113,1058,60799,77783,6810,58421
8600000US58422,138,75,63,77188,95852,34066,58422
8600000US58423,36,17,19,39750,46387,12876,58423
8600000US58424,243,127,116,60000,64116,14610,58424
8600000US58425,1055,465,590,54960,70010,9078,58425
8600000US58426,123,63,60,63125,63243,14057,58426
8600000US58428,208,113,95,64000,74386,16697,58428
8600000US58429,277,164,113,38750,55555,14493,58429
8600000US58430,98,57,41,78750,119885,42526,58430
8600000US58431,107,47,60,97813,104933,25867,58431
8600000US58433,840,438,402,59167,90651,22197,58433
8600000US58436,1420,686,734,51023,72525,10868,58436
8600000US58438,526,306,220,57188,73002,8509,58438
8600000US58439,90,29,61,32500,74107,35539,58439
8600000US58440,84,43,41,58500,63913,13360,58440
8600000US58441,283,129,154,76806,99240,30450,58441
8600000US58442,406,191,215,49250,59878,8376,58442
8600000US58443,146,61,85,51875,64214,17532,58443
8600000US58444,167,96,71,48438,69329,16400,58444
8600000US58445,158,78,80,63750,80370,25371,58445
8600000US58448,233,147,86,52500,104180,45011,58448
8600000US58451,147,77,70,66667,83500,20990,58451
8600000US58452,21,13,8,,,,58452
8600000US58454,303,178,125,38906,60306,18401,58454
8600000US58455,296,152,144,52500,68525,12012,58455
8600000US58456,436,214,222,65795,85661,16384,58456
8600000US58458,923,477,446,65707,73855,6399,58458
8600000US58460,181,103,78,47589,71450,23675,58460
8600000US58461,333,170,163,45000,70024,16036,58461
8600000US58463,559,263,296,31550,48871,7277,58463
8600000US58464,168,95,73,63125,67597,13599,58464
8600000US58466,266,141,125,55313,81042,15056,58466
8600000US58467,490,251,239,60326,68782,8102,58467
8600000US58472,360,172,188,68750,88865,17841,58472
8600000US58474,1981,990,991,68125,77909,8649,58474
8600000US58475,155,88,67,83571,127479,56573,58475
8600000US58476,217,111,106,90313,107995,39370,58476
8600000US58477,126,80,46,58750,76524,24591,58477
8600000US58478,96,50,46,41250,50613,15972,58478
8600000US58479,174,95,79,101250,110029,32594,58479
8600000US58480,258,116,142,86250,93413,20157,58480
8600000US58481,191,94,97,79250,88616,19764,58481
8600000US58482,816,455,361,46458,67338,13540,58482
8600000US58483,231,118,113,42045,84120,28383,58483
8600000US58484,32,16,16,,47562,17087,58484
8600000US58486,178,85,93,93125,82112,14085,58486
8600000US58487,352,166,186,63125,72262,16615,58487
8600000US58488,166,100,66,64375,73980,17211,58488
8600000US58490,179,95,84,61250,92776,34185,58490
8600000US58492,356,190,166,59063,86849,23312,58492
8600000US58494,203,112,91,44750,61478,10339,58494
8600000US58495,1083,530,553,54500,69543,8996,58495
8600000US58496,150,93,57,,78556,40746,58496
8600000US58497,185,104,81,67422,96493,44054,58497
8600000US58501,24209,12341,11868,59444,73575,3283,58501
8600000US58503,24631,11828,12803,83513,102038,5068,58503
8600000US58504,20694,10322,10372,69605,91059,4608,58504
8600000US58505,0,0,0,,,,58505
8600000US58520,213,115,98,66429,79454,16009,58520
8600000US58521,481,248,233,93242,101392,12383,58521
8600000US58523,2839,1445,1394,83558,96236,13543,58523
8600000US58524,78,31,47,51875,86008,64210,58524
8600000US58528,472,218,254,31000,48045,8936,58528
8600000US58529,442,224,218,49375,101754,38328,58529
8600000US58530,817,402,415,55345,78161,11776,58530
8600000US58531,334,172,162,71176,95082,20843,58531
8600000US58532,187,96,91,60750,76328,21382,58532
8600000US58533,846,407,439,43150,62528,7955,58533
8600000US58535,518,298,220,65750,87734,19871,58535
8600000US58538,1657,822,835,38529,56392,10656,58538
8600000US58540,2079,1004,1075,61970,75883,11568,58540
8600000US58541,350,164,186,52917,59249,15066,58541
8600000US58542,210,116,94,43125,63112,13284,58542
8600000US58544,430,256,174,45139,75995,27423,58544
8600000US58545,2867,1480,1387,84432,88190,5947,58545
8600000US58549,198,100,98,78438,79647,21709,58549
8600000US58552,1377,634,743,50875,60639,6044,58552
8600000US58554,19891,10268,9623,68378,93570,8329,58554
8600000US58558,773,381,392,84167,102409,14594,58558
8600000US58559,156,78,78,83864,89307,20564,58559
8600000US58560,110,60,50,55625,59186,13344,58560
8600000US58561,841,459,382,58450,78994,10214,58561
8600000US58562,333,170,163,70833,67990,7920,58562
8600000US58563,1711,881,830,74375,83920,11137,58563
8600000US58564,66,43,23,,80943,30753,58564
8600000US58565,217,128,89,45536,59619,14217,58565
8600000US58566,83,55,28,69167,136688,49991,58566
8600000US58568,424,212,212,45114,68705,17857,58568
8600000US58569,61,41,20,83438,85658,17844,58569
8600000US58570,334,191,143,68000,89579,17060,58570
8600000US58571,416,216,200,66250,69921,8860,58571
8600000US58572,224,122,102,54583,97924,41746,58572
8600000US58573,478,251,227,51484,58160,6246,58573
8600000US58575,679,308,371,47065,67539,7841,58575
8600000US58576,774,396,378,68452,86440,9009,58576
8600000US58577,1503,853,650,78526,87631,5670,58577
8600000US58579,1130,603,527,79405,90905,8842,58579
8600000US58580,202,101,101,107083,89781,13238,58580
8600000US58581,208,114,94,,88286,27712,58581
8600000US58601,20104,10459,9645,78997,98073,5528,58601
8600000US58620,88,51,37,65625,77369,16752,58620
8600000US58621,1106,522,584,56467,72853,13828,58621
8600000US58622,1335,707,628,67778,86873,11901,58622
8600000US58623,1681,808,873,63795,76063,9316,58623
8600000US58625,248,121,127,58125,102876,34018,58625
8600000US58626,269,132,137,52656,78322,29645,58626
8600000US58627,127,74,53,60625,74629,23652,58627
8600000US58630,528,261,267,54545,69324,19801,58630
8600000US58631,936,462,474,52813,67005,9903,58631
8600000US58632,151,76,75,39250,50284,10734,58632
8600000US58634,236,101,135,151250,156690,47766,58634
8600000US58636,732,421,311,64432,112380,21152,58636
8600000US58638,895,482,413,64911,82296,15247,58638
8600000US58639,1440,669,771,55446,77687,8478,58639
8600000US58640,1236,669,567,75714,119408,23384,58640
8600000US58641,87,52,35,39674,46227,8636,58641
8600000US58642,252,138,114,85167,87552,12984,58642
8600000US58643,131,68,63,40972,56764,14476,58643
8600000US58645,270,155,115,93214,112882,30103,58645
8600000US58646,933,482,451,51298,78131,13428,58646
8600000US58647,938,395,543,63984,86537,14733,58647
8600000US58649,244,133,111,47391,59136,10790,58649
8600000US58650,306,168,138,48750,62839,14157,58650
8600000US58651,424,221,203,82344,96620,23272,58651
8600000US58652,929,486,443,69375,87436,9871,58652
8600000US58653,559,304,255,87610,95189,13424,58653
8600000US58654,205,116,89,69118,82083,15478,58654
8600000US58655,418,202,216,78750,97222,19596,58655
8600000US58656,363,181,182,91058,93076,13934,58656
8600000US58701,25117,12958,12159,68571,84258,4080,58701
8600000US58702,0,0,0,,,,58702
8600000US58703,17678,9495,8183,67661,85979,6472,58703
8600000US58704,3081,1571,1510,51699,63108,6686,58704
8600000US58705,525,372,153,,,,58705
8600000US58707,495,264,231,,,,58707
8600000US58710,431,235,196,61696,69171,7014,58710
8600000US58711,203,122,81,60714,83995,20099,58711
8600000US58712,98,49,49,46250,61676,21945,58712
8600000US58713,18,11,7,76500,72760,28080,58713
8600000US58716,134,70,64,40625,46952,14273,58716
8600000US58718,662,352,310,69318,93912,15579,58718
8600000US58721,425,242,183,79583,89417,13810,58721
8600000US58722,1292,748,544,76875,83691,7559,58722
8600000US58723,195,109,86,42000,57382,19429,58723
8600000US58725,302,137,165,63393,91172,26841,58725
8600000US58727,184,85,99,74167,106970,33578,58727
8600000US58730,1110,504,606,58250,99144,18958,58730
8600000US58731,205,104,101,66406,98369,29902,58731
8600000US58733,247,112,135,78594,95921,24117,58733
8600000US58734,306,171,135,87857,115907,33380,58734
8600000US58735,222,129,93,82969,77840,9414,58735
8600000US58736,455,240,215,49750,66656,11297,58736
8600000US58737,122,60,62,77656,72252,16050,58737
8600000US58740,511,273,238,75938,92077,15233,58740
8600000US58741,503,287,216,66250,86973,23676,58741
8600000US58744,89,50,39,66250,83763,25537,58744
8600000US58746,1082,552,530,62390,77670,9795,58746
8600000US58748,116,69,47,,64206,26818,58748
8600000US58750,368,207,161,80833,99834,12535,58750
8600000US58752,133,61,72,60625,74593,20258,58752
8600000US58755,68,38,30,76250,70866,22624,58755
8600000US58756,142,71,71,63750,62272,14309,58756
8600000US58757,514,262,252,50750,68877,20516,58757
8600000US58758,191,100,91,87917,100761,24949,58758
8600000US58759,606,311,295,70625,81140,9177,58759
8600000US58760,223,109,114,63750,75638,16233,58760
8600000US58761,760,383,377,67386,81714,10564,58761
8600000US58762,180,105,75,80750,103484,26367,58762
8600000US58763,2939,1558,1381,72644,110205,17676,58763
8600000US58765,415,226,189,57404,71200,18131,58765
8600000US58768,213,96,117,98750,99916,23279,58768
8600000US58769,165,128,37,49464,58912,12883,58769
8600000US58770,1168,574,594,77500,92928,9356,58770
8600000US58771,521,296,225,68250,79924,12907,58771
8600000US58772,121,69,52,81667,89512,20856,58772
8600000US58773,645,331,314,72250,91681,12122,58773
8600000US58775,107,46,61,47250,59594,22820,58775
8600000US58776,180,96,84,48158,47007,16436,58776
8600000US58778,163,70,93,88750,89337,26714,58778
8600000US58779,369,206,163,54816,79232,19886,58779
8600000US58781,576,310,266,86875,103533,18060,58781
8600000US58782,354,191,163,68173,81049,10164,58782
8600000US58783,286,164,122,46250,72474,23813,58783
8600000US58784,2468,1470,998,70078,98889,18822,58784
8600000US58785,880,440,440,83194,84746,15376,58785
8600000US58787,127,74,53,54904,61730,12971,58787
8600000US58788,923,484,439,53542,69900,9469,58788
8600000US58789,245,131,114,63393,84625,29044,58789
8600000US58790,1295,611,684,62396,76758,8910,58790
8600000US58792,261,132,129,100625,272114,219056,58792
8600000US58793,426,230,196,56923,83646,18955,58793
8600000US58794,131,81,50,,145914,79709,58794
8600000US58795,178,85,93,51858,80585,33981,58795
8600000US58801,22002,12188,9814,87934,113525,9522,58801
8600000US58830,187,113,74,,107886,33906,58830
8600000US58831,499,261,238,88512,97776,17315,58831
8600000US58833,57,34,23,153088,131372,54527,58833
8600000US58835,308,167,141,,132461,40796,58835
8600000US58838,125,63,62,79018,153014,78298,58838
8600000US58843,449,263,186,116528,191997,98174,58843
8600000US58844,64,25,39,,95077,75230,58844
8600000US58845,203,110,93,55000,71804,12381,58845
8600000US58847,233,131,102,96339,181582,124204,58847
8600000US58849,582,353,229,75489,95353,16124,58849
8600000US58852,1222,725,497,83625,94765,14105,58852
8600000US58853,157,65,92,48333,57245,15068,58853
8600000US58854,6192,3501,2691,81806,107703,10197,58854
8600000US58856,95,50,45,95804,126886,44047,58856
8600000US59001,1175,547,628,63083,89579,18963,59001
8600000US59002,170,64,106,43125,61574,28910,59002
8600000US59003,929,441,488,46087,54896,8074,59003
8600000US59006,710,316,394,58889,71713,14998,59006
8600000US59007,199,85,114,106354,116249,37153,59007
8600000US59008,429,220,209,58929,89338,36415,59008
8600000US59010,117,62,55,85714,74777,12491,59010
8600000US59011,2440,1158,1282,49256,65218,5938,59011
8600000US59012,160,74,86,47500,63351,12538,59012
8600000US59013,121,48,73,75750,84790,20390,59013
8600000US59014,1436,708,728,54850,72345,7695,59014
8600000US59015,340,167,173,68750,103677,37110,59015
8600000US59016,776,364,412,53542,59423,7450,59016
8600000US59018,394,192,202,52604,66299,15018,59018
8600000US59019,3315,1634,1681,64387,78964,6919,59019
8600000US59020,46,25,21,36250,45677,17635,59020
8600000US59022,1444,622,822,38088,55690,9679,59022
8600000US59024,286,148,138,51667,57848,13486,59024
8600000US59025,45,24,21,79375,88100,28559,59025
8600000US59026,145,92,53,,51302,16083,59026
8600000US59027,585,267,318,48125,61596,16391,59027
8600000US59028,494,271,223,54423,69408,12659,59028
8600000US59029,598,288,310,51250,71513,15529,59029
8600000US59030,1071,593,478,59375,62127,8459,59030
8600000US59031,241,116,125,54063,53403,8127,59031
8600000US59032,419,244,175,58162,67569,14786,59032
8600000US59033,241,108,133,53542,82548,22566,59033
8600000US59034,3755,1839,1916,44985,64235,7767,59034
8600000US59035,140,69,71,41000,47601,13652,59035
8600000US59036,1140,544,596,44750,56734,7381,59036
8600000US59037,1311,720,591,70982,96986,35869,59037
8600000US59038,551,269,282,42981,57252,8033,59038
8600000US59039,32,16,16,,47135,21817,59039
8600000US59041,1385,731,654,63710,73500,8330,59041
8600000US59043,1868,919,949,43333,53790,6571,59043
8600000US59044,8939,4383,4556,60373,78700,6023,59044
8600000US59046,322,145,177,38512,57457,19934,59046
8600000US59047,10154,4989,5165,46808,69030,5978,59047
8600000US59050,1027,469,558,48125,56606,5342,59050
8600000US59052,131,77,54,67955,71624,13122,59052
8600000US59053,229,108,121,50833,52510,12778,59053
8600000US59054,204,106,98,31932,42621,12722,59054
8600000US59055,70,42,28,44583,64447,24737,59055
8600000US59057,662,340,322,48992,67023,24332,59057
8600000US59058,29,14,15,77708,58806,22946,59058
8600000US59059,154,84,70,49583,44547,15116,59059
8600000US59061,233,136,97,68472,84900,22863,59061
8600000US59062,7,5,2,,,,59062
8600000US59063,1600,844,756,73611,81897,6766,59063
8600000US59064,181,92,89,,69465,32948,59064
8600000US59065,156,79,77,80000,87167,26788,59065
8600000US59066,391,215,176,38750,60311,12711,59066
8600000US59067,147,74,73,49821,56316,11943,59067
8600000US59068,3054,1491,1563,50110,61421,4870,59068
8600000US59069,418,220,198,47679,58068,12335,59069
8600000US59070,662,352,310,68846,73721,7084,59070
8600000US59071,162,61,101,84750,102219,18662,59071
8600000US59072,3440,1709,1731,41504,51985,4471,59072
8600000US59074,252,130,122,46250,57456,8072,59074
8600000US59075,151,76,75,,71047,27482,59075
8600000US59076,58,26,32,40417,50570,12335,59076
8600000US59077,97,36,61,,96848,34116,59077
8600000US59078,168,93,75,34750,48585,26661,59078
8600000US59079,2367,1262,1105,73487,90216,15281,59079
8600000US59081,16,9,7,,128986,72955,59081
8600000US59082,35,19,16,27321,39216,15904,59082
8600000US59085,82,30,52,25417,37370,9175,59085
8600000US59086,721,331,390,54792,67775,11449,59086
8600000US59087,296,141,155,40417,66236,13095,59087
8600000US59088,1143,590,553,53922,58358,10368,59088
8600000US59089,329,167,162,43125,51520,10825,59089
8600000US59101,31524,16077,15447,48569,65188,3806,59101
8600000US59102,37591,17091,20500,56949,74570,3811,59102
8600000US59105,23075,11510,11565,66710,84540,4517,59105
8600000US59106,12898,6330,6568,75974,116245,9417,59106
8600000US59201,3779,1834,1945,43776,58961,5189,59201
8600000US59211,90,57,33,59375,72765,21027,59211
8600000US59212,421,223,198,69500,104987,24573,59212
8600000US59213,503,250,253,31250,47670,7922,59213
8600000US59214,93,69,24,38333,76474,46109,59214
8600000US59215,767,388,379,46250,57511,7970,59215
8600000US59217,98,59,39,103661,123370,36424,59217
8600000US59218,682,387,295,67000,80851,9006,59218
8600000US59219,202,107,95,42083,74169,21788,59219
8600000US59221,1330,653,677,69338,77111,7240,59221
8600000US59222,93,48,45,54489,69320,15027,59222
8600000US59223,288,155,133,86875,87817,18343,59223
8600000US59225,295,151,144,27500,35811,6749,59225
8600000US59226,316,153,163,51250,77490,23149,59226
8600000US59230,3556,1706,1850,62905,69984,6466,59230
8600000US59231,399,191,208,36875,61373,22961,59231
8600000US59240,22,10,12,40000,40042,9651,59240
8600000US59241,417,175,242,59375,54444,7478,59241
8600000US59242,61,32,29,147813,171889,60087,59242
8600000US59243,192,103,89,51563,90693,23502,59243
8600000US59244,22,8,14,56875,55164,41228,59244
8600000US59247,253,130,123,50208,57651,10606,59247
8600000US59248,530,276,254,48182,57373,7802,59248
8600000US59250,155,75,80,53750,65710,15407,59250
8600000US59252,76,41,35,85250,83433,22750,59252
8600000US59253,68,37,31,53839,60231,12162,59253
8600000US59254,1725,806,919,54028,77704,12403,59254
8600000US59255,2235,1086,1149,26583,43268,4430,59255
8600000US59256,57,37,20,,34327,20454,59256
8600000US59257,34,25,9,39643,40073,18185,59257
8600000US59258,89,45,44,44688,56149,12646,59258
8600000US59259,257,125,132,61250,60092,9101,59259
8600000US59260,118,44,74,,61769,29392,59260
8600000US59261,446,213,233,45208,57140,10292,59261
8600000US59262,530,239,291,67092,79427,12929,59262
8600000US59263,1192,579,613,54688,72801,12863,59263
8600000US59270,6691,3429,3262,66438,79988,6513,59270
8600000US59274,193,102,91,39766,53368,10734,59274
8600000US59275,285,152,133,55556,74622,21367,59275
8600000US59276,21,10,11,,,,59276
8600000US59301,9004,4402,4602,55745,70544,3726,59301
8600000US59311,136,70,66,47813,75945,28655,59311
8600000US59312,19,10,9,,60900,25995,59312
8600000US59313,1771,933,838,64583,76497,8382,59313
8600000US59314,66,35,31,58750,64605,15068,59314
8600000US59315,76,36,40,78750,116749,36414,59315
8600000US59317,916,453,463,56108,64731,8466,59317
8600000US59318,85,44,41,40625,56198,20624,59318
8600000US59322,33,19,14,26250,24800,8942,59322
8600000US59323,1628,788,840,85556,82342,6638,59323
8600000US59324,748,363,385,39191,66527,12734,59324
8600000US59326,185,95,90,33750,58218,28496,59326
8600000US59327,2211,1099,1112,45094,63428,10005,59327
8600000US59330,6778,3617,3161,60357,76190,6963,59330
8600000US59332,162,82,80,58750,79269,21596,59332
8600000US59333,14,7,7,55417,44486,15207,59333
8600000US59336,152,86,66,54063,80236,43326,59336
8600000US59337,628,310,318,47841,67998,12860,59337
8600000US59338,89,38,51,89375,91618,17124,59338
8600000US59339,110,64,46,47031,57788,13146,59339
8600000US59343,87,44,43,,67949,24864,59343
8600000US59344,326,148,178,47039,69578,22181,59344
8600000US59347,215,111,104,72321,79721,22450,59347
8600000US59349,856,439,417,48424,67744,9894,59349
8600000US59351,169,96,73,40952,49337,12795,59351
8600000US59353,839,404,435,50202,56109,6232,59353
8600000US59354,28,13,15,,109238,138827,59354
8600000US59401,11058,5624,5434,39530,59532,6746,59401
8600000US59404,21056,10363,10693,62554,86042,7718,59404
8600000US59405,24285,12166,12119,44161,56544,2506,59405
8600000US59410,499,239,260,44583,59124,12053,59410
8600000US59411,655,483,172,19015,57315,39541,59411
8600000US59412,1183,581,602,51467,73199,10823,59412
8600000US59414,761,393,368,36406,48319,13389,59414
8600000US59416,211,129,82,71607,79783,16397,59416
8600000US59417,5051,2424,2627,23273,37208,4503,59417
8600000US59418,136,79,57,,51302,18142,59418
8600000US59419,93,51,42,42500,103010,53841,59419
8600000US59420,162,82,80,70000,80904,25833,59420
8600000US59421,1434,679,755,51161,70259,10230,59421
8600000US59422,2040,1010,1030,40625,57837,6732,59422
8600000US59424,64,28,36,71250,95656,25874,59424
8600000US59425,2707,1333,1374,45956,65262,7281,59425
8600000US59427,3162,1460,1702,40811,61985,7626,59427
8600000US59430,280,134,146,54375,69523,12148,59430
8600000US59432,106,49,57,39107,38551,9044,59432
8600000US59433,420,205,215,44583,58975,11801,59433
8600000US59434,502,225,277,52917,60169,9039,59434
8600000US59436,1462,708,754,62727,75139,7084,59436
8600000US59440,108,76,32,17155,34350,15872,59440
8600000US59441,56,29,27,88438,70862,24286,59441
8600000US59442,1464,700,764,42379,55982,6916,59442
8600000US59443,310,152,158,62321,81661,25838,59443
8600000US59444,197,107,90,42054,54744,13832,59444
8600000US59446,476,235,241,43929,61303,10328,59446
8600000US59447,186,100,86,46875,87014,29844,59447
8600000US59448,486,245,241,30000,51926,15134,59448
8600000US59450,408,201,207,46719,59078,9825,59450
8600000US59451,149,56,93,68438,68304,11393,59451
8600000US59452,414,221,193,50417,65655,10994,59452
8600000US59453,220,116,104,39500,56456,11668,59453
8600000US59454,126,75,51,38958,46392,9683,59454
8600000US59456,366,227,139,,48138,32299,59456
8600000US59457,7154,3497,3657,49161,64110,7481,59457
8600000US59460,151,92,59,32656,35479,7471,59460
8600000US59461,14,7,7,,,,59461
8600000US59462,161,88,73,32031,50214,21713,59462
8600000US59463,88,50,38,,62832,43787,59463
8600000US59464,329,161,168,50750,65205,13759,59464
8600000US59465,36,19,17,35625,37948,12478,59465
8600000US59466,102,62,40,50750,67295,17716,59466
8600000US59467,95,43,52,53750,112937,69900,59467
8600000US59468,474,243,231,53750,70472,8213,59468
8600000US59469,113,63,50,47813,64086,18959,59469
8600000US59471,248,143,105,48681,67758,16230,59471
8600000US59472,541,259,282,55417,63833,8527,59472
8600000US59474,2870,1716,1154,43616,62606,13770,59474
8600000US59477,357,219,138,47411,61716,16186,59477
8600000US59479,596,314,282,47941,52493,5566,59479
8600000US59480,401,193,208,69464,66161,7223,59480
8600000US59482,474,211,263,65313,80799,14940,59482
8600000US59483,460,214,246,49722,88961,42273,59483
8600000US59484,87,44,43,65938,64586,11149,59484
8600000US59485,500,274,226,56607,68869,11264,59485
8600000US59486,960,431,529,48472,70410,9925,59486
8600000US59487,994,528,466,49833,64540,7605,59487
8600000US59489,238,146,92,63125,75634,23136,59489
8600000US59501,9508,4819,4689,49627,60987,3392,59501
8600000US59520,828,429,399,46855,64991,13915,59520
8600000US59521,2363,1143,1220,29493,41478,3814,59521
8600000US59522,1395,660,735,45795,81556,26048,59522
8600000US59523,1677,832,845,39338,51837,5977,59523
8600000US59524,488,268,220,47727,52271,10946,59524
8600000US59525,200,95,105,29688,43998,11893,59525
8600000US59526,1782,812,970,39167,48032,5238,59526
8600000US59527,678,319,359,29167,36887,5856,59527
8600000US59528,209,109,100,47500,64069,16124,59528
8600000US59529,143,77,66,40972,46276,8177,59529
8600000US59530,46,31,15,95208,87063,36658,59530
8600000US59531,235,130,105,50729,118202,66668,59531
8600000US59532,157,80,77,41563,50131,11772,59532
8600000US59535,60,29,31,36667,47168,29201,59535
8600000US59537,30,15,15,66250,76378,29264,59537
8600000US59538,2200,1092,1108,47520,54416,6538,59538
8600000US59540,239,126,113,56771,62961,9041,59540
8600000US59542,114,64,50,48438,78943,30833,59542
8600000US59544,145,72,73,41125,58590,21615,59544
8600000US59545,44,22,22,56964,58558,18666,59545
8600000US59546,84,27,57,,34430,26772,59546
8600000US59547,51,29,22,61250,70013,19206,59547
8600000US59601,25485,12044,13441,57398,73946,5221,59601
8600000US59602,20058,10084,9974,72216,84322,3204,59602
8600000US59631,195,89,106,42500,53849,11018,59631
8600000US59632,1338,646,692,43125,55056,7798,59632
8600000US59633,193,102,91,71429,79371,16621,59633
8600000US59634,4139,2119,2020,89884,107784,6718,59634
8600000US59635,5149,2719,2430,60491,68430,7105,59635
8600000US59636,26,24,2,,,,59636
8600000US59638,443,245,198,59545,70892,10988,59638
8600000US59639,915,482,433,33333,46798,6395,59639
8600000US59640,67,31,36,57639,61968,16279,59640
8600000US59642,51,30,21,,29689,14977,59642
8600000US59643,358,243,115,,129118,94886,59643
8600000US59644,3423,1676,1747,55558,68190,5128,59644
8600000US59645,1383,681,702,41724,57610,6937,59645
8600000US59647,298,161,137,43603,53973,20253,59647
8600000US59648,460,228,232,58750,68109,10768,59648
8600000US59701,26879,13483,13396,41340,57527,2758,59701
8600000US59703,44,25,19,80000,84195,22499,59703
8600000US59710,218,114,104,36250,49216,10234,59710
8600000US59711,7479,3851,3628,42086,58391,4474,59711
8600000US59713,166,108,58,40938,44816,11291,59713
8600000US59714,14938,7360,7578,67795,76693,4032,59714
8600000US59715,29724,15732,13992,56208,89330,4176,59715
8600000US59716,2127,1148,979,68188,97534,14513,59716
8600000US59718,28575,14970,13605,63579,85474,4389,59718
8600000US59720,123,66,57,90855,147402,80232,59720
8600000US59721,386,195,191,56250,82623,22922,59721
8600000US59722,4958,3309,1649,49005,64524,7005,59722
8600000US59724,63,34,29,46250,51154,15089,59724
8600000US59725,6460,3203,3257,44679,66167,7677,59725
8600000US59727,165,92,73,44792,51032,8685,59727
8600000US59728,289,154,135,59464,86440,23859,59728
8600000US59729,1988,1002,986,52960,62342,7349,59729
8600000US59730,1609,887,722,72685,82946,10598,59730
8600000US59731,84,55,29,48603,50964,11626,59731
8600000US59732,240,111,129,57083,78464,40086,59732
8600000US59733,192,110,82,77083,80257,11214,59733
8600000US59735,195,84,111,31875,51642,16351,59735
8600000US59736,78,38,40,48929,69288,19650,59736
8600000US59739,197,113,84,34688,56150,17465,59739
8600000US59740,255,101,154,29115,70165,56220,59740
8600000US59741,3386,1726,1660,63549,80106,7355,59741
8600000US59743,96,53,43,45000,51230,11956,59743
8600000US59745,84,47,37,71667,86895,37815,59745
8600000US59746,116,64,52,41250,65720,19120,59746
8600000US59747,139,73,66,52750,65976,19458,59747
8600000US59748,185,108,77,50000,83796,34582,59748
8600000US59749,1504,755,749,53000,67123,8094,59749
8600000US59750,285,159,126,52125,68832,18206,59750
8600000US59751,186,89,97,30521,41089,16722,59751
8600000US59752,2584,1234,1350,58299,76276,8940,59752
8600000US59754,916,604,312,55156,85630,24425,59754
8600000US59755,198,87,111,38750,53003,21386,59755
8600000US59756,471,391,80,,,,59756
8600000US59758,1289,791,498,37656,56439,9729,59758
8600000US59759,3148,1633,1515,52326,60213,4896,59759
8600000US59760,210,92,118,53095,57915,10360,59760
8600000US59761,271,165,106,64688,83948,16934,59761
8600000US59762,237,135,102,50667,68948,19516,59762
8600000US59801,27589,13872,13717,37410,55851,3673,59801
8600000US59802,16708,8877,7831,42928,63678,4698,59802
8600000US59803,13639,6705,6934,74169,95781,9306,59803
8600000US59804,6571,3083,3488,60625,88273,9991,59804
8600000US59808,14597,7035,7562,55516,77884,7237,59808
8600000US59820,1566,761,805,48938,61549,8922,59820
8600000US59821,2032,1059,973,52056,66307,7147,59821
8600000US59823,1677,864,813,57813,66165,6000,59823
8600000US59824,1162,568,594,58365,62264,7742,59824
8600000US59825,1956,926,1030,54550,72123,15142,59825
8600000US59826,394,171,223,45938,65053,13783,59826
8600000US59827,203,124,79,41691,46196,10052,59827
8600000US59828,4452,2035,2417,51146,67791,9041,59828
8600000US59829,2017,1032,985,38512,56688,9004,59829
8600000US59830,140,65,75,31154,29852,14329,59830
8600000US59831,325,179,146,26354,46232,8863,59831
8600000US59832,531,288,243,44167,60272,11653,59832
8600000US59833,4568,2175,2393,60852,80589,13686,59833
8600000US59834,1841,875,966,65163,90736,25431,59834
8600000US59837,426,168,258,61250,77142,21457,59837
8600000US59840,11443,5515,5928,40994,56043,5153,59840
8600000US59841,517,237,280,41000,50758,7742,59841
8600000US59842,17,4,13,,,,59842
8600000US59843,187,82,105,39722,49556,7476,59843
8600000US59844,519,223,296,41125,55868,21353,59844
8600000US59845,1072,528,544,24013,37824,6126,59845
8600000US59846,1010,480,530,57864,86012,27659,59846
8600000US59847,4284,2153,2131,58414,73585,7127,59847
8600000US59848,115,73,42,57917,123792,57753,59848
8600000US59851,91,53,38,57583,68889,36831,59851
8600000US59853,604,349,255,39940,60943,18651,59853
8600000US59854,181,95,86,53750,70494,18949,59854
8600000US59855,598,298,300,16429,20138,6805,59855
8600000US59856,363,218,145,35938,47087,15046,59856
8600000US59858,1082,581,501,53412,62318,14594,59858
8600000US59859,2535,1249,1286,41495,52680,7264,59859
8600000US59860,7894,3802,4092,45064,66571,7238,59860
8600000US59863,38,18,20,8824,18340,14767,59863
8600000US59864,4945,2401,2544,40204,51045,3608,59864
8600000US59865,2722,1315,1407,43113,55331,4603,59865
8600000US59866,613,345,268,37143,59996,19150,59866
8600000US59867,71,41,30,93036,91668,19274,59867
8600000US59868,1619,863,756,49347,75664,20984,59868
8600000US59870,7864,4015,3849,54334,72908,11847,59870
8600000US59871,279,148,131,61250,68597,14938,59871
8600000US59872,1743,939,804,42589,51008,10124,59872
8600000US59873,2758,1380,1378,34583,56252,12278,59873
8600000US59874,1232,637,595,46442,54458,8420,59874
8600000US59875,3217,1711,1506,42833,58776,8054,59875
8600000US59901,41161,20096,21065,52244,71117,3743,59901
8600000US59910,500,248,252,50769,70498,21236,59910
8600000US59911,6944,3350,3594,60272,81980,8057,59911
8600000US59912,11702,5640,6062,49531,64151,5140,59912
8600000US59913,456,247,209,62361,67319,21418,59913
8600000US59914,197,107,90,60417,60261,10712,59914
8600000US59915,273,138,135,60110,43146,11862,59915
8600000US59916,166,81,85,45625,72256,28746,59916
8600000US59917,3655,1697,1958,33322,52131,9110,59917
8600000US59918,513,266,247,46324,47063,6469,59918
8600000US59919,448,177,271,,37956,16840,59919
8600000US59920,1373,750,623,47500,67236,8475,59920
8600000US59922,1648,800,848,63413,66952,10444,59922
8600000US59923,7700,4045,3655,39105,55235,7193,59923
8600000US59925,1111,613,498,52000,62871,10120,59925
8600000US59926,359,194,165,,30337,11248,59926
8600000US59927,320,142,178,46250,59325,23553,59927
8600000US59928,187,101,86,56719,50589,7826,59928
8600000US59929,180,104,76,56250,70425,22170,59929
8600000US59930,410,176,234,30170,33448,13342,59930
8600000US59931,236,112,124,58583,85574,26512,59931
8600000US59932,1110,586,524,61755,83439,18901,59932
8600000US59933,65,42,23,45694,49257,22689,59933
8600000US59934,440,218,222,31750,55164,19391,59934
8600000US59935,3044,1439,1605,42763,60838,11781,59935
8600000US59936,372,193,179,49141,56813,8411,59936
8600000US59937,11249,5828,5421,58598,87953,9353,59937
8600000US60002,18608,9214,9394,82692,96227,5087,60002
8600000US60004,39313,18525,20788,94096,120600,4520,60004
8600000US60005,23696,11747,11949,78109,106101,8434,60005
8600000US60007,27272,13301,13971,79590,95566,4043,60007
8600000US60008,16862,8340,8522,66462,86993,4431,60008
8600000US60010,35077,16615,18462,137994,183843,9082,60010
8600000US60012,8595,4368,4227,127651,150298,11546,60012
8600000US60013,19797,9914,9883,98377,120401,6225,60013
8600000US60014,36736,18176,18560,87256,107481,4345,60014
8600000US60015,20578,9882,10696,142409,195948,10187,60015
8600000US60016,48286,22892,25394,64444,81986,3054,60016
8600000US60018,23244,11595,11649,60751,74397,3288,60018
8600000US60020,7949,3702,4247,57518,72393,5987,60020
8600000US60021,4264,1916,2348,106960,130328,13097,60021
8600000US60022,6004,2967,3037,209821,355756,41690,60022
8600000US60025,30690,14377,16313,97881,144313,6187,60025
8600000US60026,10501,4963,5538,111875,174303,13578,60026
8600000US60029,359,196,163,200500,266657,50627,60029
8600000US60030,28777,14134,14643,87449,108692,4167,60030
8600000US60031,28245,13495,14750,93028,115652,5637,60031
8600000US60033,9666,4901,4765,58264,69154,4615,60033
8600000US60034,1647,845,802,63333,80781,13734,60034
8600000US60035,22446,10564,11882,147973,220192,12679,60035
8600000US60040,4016,1985,2031,57563,98240,19721,60040
8600000US60041,7270,3554,3716,65117,82792,8296,60041
8600000US60042,6442,3284,3158,76223,85879,6171,60042
8600000US60043,1669,810,859,212750,298089,32738,60043
8600000US60044,7942,3716,4226,107039,159936,14060,60044
8600000US60045,16103,7933,8170,171913,266742,18818,60045
8600000US60046,26456,13041,13415,96024,114494,3725,60046
8600000US60047,32057,15822,16235,135146,180158,7393,60047
8600000US60048,22051,10674,11377,134621,179173,7987,60048
8600000US60050,25403,12483,12920,70289,87761,4389,60050
8600000US60051,18206,8977,9229,82283,98904,4650,60051
8600000US60053,18936,9174,9762,85476,100584,5879,60053
8600000US60056,41979,20618,21361,73686,98283,5467,60056
8600000US60060,28664,14428,14236,93108,115753,5347,60060
8600000US60061,19909,9434,10475,98939,130232,6449,60061
8600000US60062,31702,14873,16829,110012,157954,8506,60062
8600000US60064,11525,5719,5806,34911,49551,3827,60064
8600000US60067,29871,14363,15508,97270,133393,7005,60067
8600000US60068,28229,13361,14868,102494,140207,5532,60068
8600000US60069,6720,3074,3646,102632,149372,12440,60069
8600000US60070,12143,5998,6145,66379,95840,8349,60070
8600000US60071,2745,1306,1439,62750,84003,9605,60071
8600000US60072,791,406,385,116667,130883,33743,60072
8600000US60073,43514,22209,21305,72175,83895,3464,60073
8600000US60074,29448,14898,14550,67954,86904,3684,60074
8600000US60076,25202,11893,13309,79795,108594,7572,60076
8600000US60077,22161,10259,11902,63051,82305,6099,60077
8600000US60081,7535,3918,3617,88958,111467,10116,60081
8600000US60083,7413,3804,3609,95644,109722,9783,60083
8600000US60084,12764,6226,6538,80529,103111,7579,60084
8600000US60085,49883,25088,24795,43204,55687,2046,60085
8600000US60087,20068,9792,10276,58981,72814,5371,60087
8600000US60088,11647,8771,2876,63912,69746,7166,60088
8600000US60089,32032,15347,16685,111548,139484,5454,60089
8600000US60090,30332,15494,14838,66243,84222,3014,60090
8600000US60091,19571,9201,10370,154614,232797,11606,60091
8600000US60093,13657,6519,7138,174966,296977,18307,60093
8600000US60096,5561,2797,2764,87446,102511,6303,60096
8600000US60097,8257,4320,3937,72719,84817,7033,60097
8600000US60098,24733,12049,12684,66520,91316,7787,60098
8600000US60099,21972,10375,11597,54685,67198,3860,60099
8600000US60101,29874,14657,15217,64915,79676,3526,60101
8600000US60102,25132,12062,13070,102698,120069,5263,60102
8600000US60103,32000,15558,16442,105862,118849,4777,60103
8600000US60104,14997,6780,8217,55640,70959,6305,60104
8600000US60106,15651,7780,7871,63486,77724,4808,60106
8600000US60107,31478,15950,15528,80039,89614,3673,60107
8600000US60108,18539,8981,9558,85887,104640,5836,60108
8600000US60109,479,221,258,69583,113701,45851,60109
8600000US60110,26755,13447,13308,63133,80104,4080,60110
8600000US60111,150,73,77,166442,164633,45836,60111
8600000US60112,3017,1623,1394,69694,82364,5918,60112
8600000US60113,271,134,137,60156,71786,12793,60113
8600000US60115,37122,18215,18907,44747,61488,2756,60115
8600000US60118,12912,6417,6495,88264,108058,5667,60118
8600000US60119,7566,3612,3954,104516,121051,10690,60119
8600000US60120,37023,18600,18423,57843,73451,3720,60120
8600000US60123,36695,18020,18675,61680,80081,3908,60123
8600000US60124,16807,8653,8154,109865,134257,11128,60124
8600000US60126,35669,17298,18371,111420,155210,4809,60126
8600000US60129,195,115,80,,82417,54365,60129
8600000US60130,12134,5408,6726,59361,79353,6740,60130
8600000US60131,14213,6648,7565,63157,72908,3814,60131
8600000US60133,28321,14156,14165,74883,82395,2797,60133
8600000US60134,21659,10215,11444,117951,144681,8260,60134
8600000US60135,5289,2734,2555,65435,82338,10318,60135
8600000US60136,5172,2603,2569,104114,119440,16107,60136
8600000US60137,28763,14011,14752,107332,146419,7272,60137
8600000US60139,25828,12889,12939,65865,77455,3582,60139
8600000US60140,12878,6359,6519,94191,108634,20165,60140
8600000US60141,216,188,28,,,,60141
8600000US60142,21720,9827,11893,76730,94337,5974,60142
8600000US60143,8796,4189,4607,92561,115091,9132,60143
8600000US60144,69,35,34,66875,73884,11522,60144
8600000US60145,1984,1139,845,79107,93623,11681,60145
8600000US60146,2017,1019,998,61673,75976,7850,60146
8600000US60148,41740,20480,21260,81504,98286,3242,60148
8600000US60150,1331,693,638,68250,90065,10078,60150
8600000US60151,3185,1567,1618,89205,92447,7274,60151
8600000US60152,9647,4801,4846,85133,95561,7751,60152
8600000US60153,18362,8754,9608,48600,59809,3939,60153
8600000US60154,13445,6081,7364,80412,94468,6610,60154
8600000US60155,6397,3159,3238,49236,60133,7022,60155
8600000US60156,20820,10333,10487,91066,104844,4642,60156
8600000US60157,1971,1013,958,105644,131686,22454,60157
8600000US60160,18022,8983,9039,50571,63886,3585,60160
8600000US60162,6781,3111,3670,53728,68705,10320,60162
8600000US60163,4046,1999,2047,64934,80071,7042,60163
8600000US60164,16028,7959,8069,60191,69206,3906,60164
8600000US60165,3416,1775,1641,59022,63961,7302,60165
8600000US60169,26081,12824,13257,75275,87859,3495,60169
8600000US60171,7919,3814,4105,55508,65444,5535,60171
8600000US60172,19345,9355,9990,85787,101528,4558,60172
8600000US60173,9884,4964,4920,81250,99896,7718,60173
8600000US60174,24633,11511,13122,84957,112283,5933,60174
8600000US60175,18934,9644,9290,147625,178501,9311,60175
8600000US60176,9324,4774,4550,54617,65823,6475,60176
8600000US60177,16392,7981,8411,93388,112651,6092,60177
8600000US60178,16907,7916,8991,73524,89123,4920,60178
8600000US60180,1411,668,743,53500,76973,20576,60180
8600000US60181,22215,10959,11256,69488,87171,5490,60181
8600000US60184,1999,997,1002,132629,200754,46204,60184
8600000US60185,26387,13588,12799,80058,98791,3886,60185
8600000US60187,22726,10928,11798,103510,131175,4877,60187
8600000US60188,32882,15636,17246,82232,96941,3023,60188
8600000US60189,23354,11141,12213,98750,138455,7284,60189
8600000US60190,9056,4561,4495,106581,129042,6969,60190
8600000US60191,11351,5677,5674,66687,89470,7868,60191
8600000US60192,11633,5590,6043,119013,153807,16427,60192
8600000US60193,31201,14995,16206,82559,97397,3650,60193
8600000US60194,14812,6839,7973,76704,91414,5522,60194
8600000US60195,4315,2009,2306,83862,88330,8687,60195
8600000US60201,34559,16314,18245,77699,135077,7024,60201
8600000US60202,25564,11497,14067,77931,114591,6751,60202
8600000US60203,3078,1389,1689,119750,162153,16445,60203
8600000US60301,2319,1029,1290,80282,99919,15921,60301
8600000US60302,24581,11302,13279,87904,131771,5541,60302
8600000US60304,12644,5815,6829,106898,126201,5953,60304
8600000US60305,8291,3934,4357,121908,222859,28934,60305
8600000US60401,6163,3048,3115,68044,76639,4909,60401
8600000US60402,47259,23662,23597,60814,72063,2914,60402
8600000US60403,14795,7771,7024,54530,63918,3226,60403
8600000US60404,14298,6783,7515,101911,122828,11341,60404
8600000US60406,18630,9121,9509,43504,53302,3110,60406
8600000US60407,1301,688,613,60972,69882,6406,60407
8600000US60408,4321,2296,2025,65559,78854,9213,60408
8600000US60409,27694,11567,16127,42718,54576,3091,60409
8600000US60410,9061,4534,4527,89398,101326,5255,60410
8600000US60411,42255,19892,22363,46771,60444,3525,60411
8600000US60415,10449,4905,5544,42306,56646,6686,60415
8600000US60416,6813,3411,3402,73245,86472,5397,60416
8600000US60417,12276,6004,6272,69491,87136,6139,60417
8600000US60419,17261,7654,9607,45463,56547,3486,60419
8600000US60420,3877,2006,1871,62669,72351,6446,60420
8600000US60421,2974,1475,1499,80960,90822,6805,60421
8600000US60422,7412,3402,4010,108375,141893,15346,60422
8600000US60423,22996,11227,11769,108295,131046,6837,60423
8600000US60424,1995,1022,973,62237,81023,8649,60424
8600000US60425,6794,3051,3743,63444,71445,5428,60425
8600000US60426,21263,9795,11468,30015,42809,3601,60426
8600000US60428,8719,3875,4844,38978,54006,6229,60428
8600000US60429,11683,5055,6628,51742,72080,12435,60429
8600000US60430,15253,7145,8108,73251,82459,3509,60430
8600000US60431,17374,8556,8818,91333,103285,6037,60431
8600000US60432,13866,6948,6918,43357,55265,4099,60432
8600000US60433,12768,6508,6260,48039,60213,4014,60433
8600000US60435,37212,17293,19919,54372,66436,2004,60435
8600000US60436,14026,7299,6727,55550,62099,3591,60436
8600000US60437,156,78,78,47031,117201,65920,60437
8600000US60438,22464,9399,13065,52028,68342,3893,60438
8600000US60439,18313,8774,9539,93489,120411,7373,60439
8600000US60440,39092,19016,20076,73813,87735,3951,60440
8600000US60441,26816,13799,13017,74544,90155,3517,60441
8600000US60442,7489,3740,3749,91700,98182,5080,60442
8600000US60443,17223,7512,9711,73544,87114,5866,60443
8600000US60444,1317,687,630,73438,88554,9078,60444
8600000US60445,21145,10259,10886,60784,65608,2430,60445
8600000US60446,29565,14024,15541,77110,86552,4109,60446
8600000US60447,9735,4547,5188,75485,91256,6988,60447
8600000US60448,20121,9828,10293,104327,122872,5891,60448
8600000US60449,7568,3662,3906,74568,96595,8158,60449
8600000US60450,16024,7848,8176,72122,87708,4385,60450
8600000US60451,26196,12908,13288,108154,125376,8475,60451
8600000US60452,22283,10956,11327,75844,87528,4271,60452
8600000US60453,44555,21500,23055,62455,78356,2181,60453
8600000US60455,12569,5923,6646,53893,69665,6048,60455
8600000US60456,3391,1566,1825,49359,57751,5060,60456
8600000US60457,10816,5680,5136,66413,81420,5974,60457
8600000US60458,11242,5199,6043,50371,63962,5693,60458
8600000US60459,21871,10829,11042,60095,74629,4054,60459
8600000US60460,995,482,513,61429,93677,20388,60460
8600000US60461,4002,1829,2173,99595,120133,13805,60461
8600000US60462,31940,15261,16679,83324,103285,4874,60462
8600000US60463,12391,5778,6613,85457,110542,8037,60463
8600000US60464,7880,3642,4238,87621,117557,10350,60464
8600000US60465,13736,5913,7823,59104,75756,4914,60465
8600000US60466,16264,7394,8870,51324,60392,3329,60466
8600000US60467,21222,10009,11213,98358,130778,8374,60467
8600000US60468,4689,2430,2259,83414,91428,7038,60468
8600000US60469,3677,1710,1967,47010,53464,9379,60469
8600000US60470,410,210,200,82500,93590,14716,60470
8600000US60471,10712,4878,5834,55625,64363,4751,60471
8600000US60472,3767,2053,1714,26661,37846,5721,60472
8600000US60473,16678,7563,9115,62951,73716,3794,60473
8600000US60474,746,382,364,69688,83256,8808,60474
8600000US60475,7663,3812,3851,47516,60538,6053,60475
8600000US60476,2070,965,1105,57461,66764,6511,60476
8600000US60477,30042,14370,15672,65590,81790,3145,60477
8600000US60478,13171,5955,7216,59104,69613,5697,60478
8600000US60479,705,369,336,85214,77905,12898,60479
8600000US60480,4391,2021,2370,83505,107116,12629,60480
8600000US60481,9331,4653,4678,61090,75011,4785,60481
8600000US60482,8655,4491,4164,57218,67142,6499,60482
8600000US60484,4792,2050,2742,55000,63482,5561,60484
8600000US60487,19893,9912,9981,98072,112638,4353,60487
8600000US60490,15857,8001,7856,121472,138975,7487,60490
8600000US60491,17961,8937,9024,103058,119542,5006,60491
8600000US60501,8140,4208,3932,48793,63428,5673,60501
8600000US60502,16750,7997,8753,111802,142428,9541,60502
8600000US60503,11364,5586,5778,112716,125801,8761,60503
8600000US60504,27869,13480,14389,81068,99045,4170,60504
8600000US60505,52924,27122,25802,49423,62404,3172,60505
8600000US60506,39630,19408,20222,61231,76837,3932,60506
8600000US60510,22246,10782,11464,95026,124187,5975,60510
8600000US60511,1430,792,638,88750,98843,11109,60511
8600000US60512,1078,510,568,64482,105103,34086,60512
8600000US60513,14121,6592,7529,81033,97765,8240,60513
8600000US60514,6925,3207,3718,106866,180527,19951,60514
8600000US60515,21796,10279,11517,88949,119642,5205,60515
8600000US60516,23280,11130,12150,88474,109632,5221,60516
8600000US60517,25413,12346,13067,83883,100273,3244,60517
8600000US60518,2778,1381,1397,56111,68043,5781,60518
8600000US60519,49,24,25,83750,96633,35141,60519
8600000US60520,2159,1040,1119,71908,85616,7093,60520
8600000US60521,12716,6120,6596,183500,276556,15780,60521
8600000US60523,8793,3885,4908,103464,181716,19163,60523
8600000US60525,22996,11206,11790,83859,126267,6841,60525
8600000US60526,10044,4699,5345,95085,118184,7585,60526
8600000US60527,22304,10334,11970,94060,145955,9483,60527
8600000US60530,377,204,173,75417,101195,29797,60530
8600000US60531,1417,711,706,66971,80592,8777,60531
8600000US60532,23190,11511,11679,82952,107179,5854,60532
8600000US60534,8051,3785,4266,60700,65546,5624,60534
8600000US60536,103,46,57,71250,75405,19580,60536
8600000US60537,487,285,202,66932,80369,15196,60537
8600000US60538,19576,9487,10089,78193,90700,6295,60538
8600000US60539,261,224,37,,,,60539
8600000US60540,34557,16490,18067,118451,148016,6473,60540
8600000US60541,2573,1254,1319,85179,98476,8502,60541
8600000US60542,13860,6829,7031,81947,108781,14204,60542
8600000US60543,28967,14164,14803,101999,117976,7037,60543
8600000US60544,19697,8840,10857,76225,96700,4469,60544
8600000US60545,9413,4932,4481,72542,78168,8278,60545
8600000US60546,11887,5666,6221,79266,119599,11926,60546
8600000US60548,9483,4572,4911,70318,80426,5794,60548
8600000US60549,203,92,111,,101298,47625,60549
8600000US60550,1172,591,581,58125,68668,7921,60550
8600000US60551,4806,3388,1418,68750,86639,14001,60551
8600000US60552,3549,1819,1730,77333,86440,5887,60552
8600000US60553,548,294,254,61667,76426,16378,60553
8600000US60554,9927,4872,5055,111558,129045,9895,60554
8600000US60555,10309,5155,5154,82106,97376,5594,60555
8600000US60556,1528,709,819,78092,88715,9207,60556
8600000US60557,157,81,76,66250,69951,9735,60557
8600000US60558,9020,4243,4777,161563,211626,13139,60558
8600000US60559,19574,9256,10318,67598,88930,5352,60559
8600000US60560,17765,8672,9093,95878,106867,8315,60560
8600000US60561,18753,8840,9913,93118,120872,6799,60561
8600000US60563,29372,14108,15264,89305,114862,4162,60563
8600000US60564,30110,14755,15355,148855,174700,5604,60564
8600000US60565,30065,14716,15349,129456,158195,6353,60565
8600000US60585,16250,7953,8297,128818,148064,7787,60585
8600000US60586,33086,16337,16749,104785,112603,4391,60586
8600000US60601,13855,6909,6946,103243,151419,19714,60601
8600000US60602,1095,601,494,157125,220969,103715,60602
8600000US60603,1118,538,580,151765,244614,50854,60603
8600000US60604,744,337,407,116250,187582,41034,60604
8600000US60605,25259,12076,13183,111164,162660,22084,60605
8600000US60606,3000,1422,1578,131477,195357,36197,60606
8600000US60607,26241,13255,12986,93508,127681,9403,60607
8600000US60608,64295,36005,28290,44043,62105,1952,60608
8600000US60609,44895,22111,22784,35179,48805,1476,60609
8600000US60610,35454,16069,19385,86803,136254,10578,60610
8600000US60611,30788,14307,16481,103522,167990,10632,60611
8600000US60612,26151,12371,13780,41300,66282,4430,60612
8600000US60613,44320,22364,21956,82321,115630,3725,60613
8600000US60614,61384,30758,30626,107461,170947,6747,60614
8600000US60615,34890,15662,19228,44111,73010,3638,60615
8600000US60616,46249,21462,24787,45997,69607,4299,60616
8600000US60617,61197,27698,33499,40265,53819,1898,60617
8600000US60618,73917,37969,35948,73810,107994,3034,60618
8600000US60619,48254,21030,27224,33454,47960,1932,60619
8600000US60620,53412,22571,30841,35890,49449,2285,60620
8600000US60621,21232,9377,11855,20991,34411,2832,60621
8600000US60622,44738,23090,21648,93988,129360,4295,60622
8600000US60623,59592,28437,31155,31634,43088,1416,60623
8600000US60624,25134,11297,13837,22992,36466,2371,60624
8600000US60625,63423,31419,32004,64117,88211,3178,60625
8600000US60626,41428,20591,20837,40591,60784,3827,60626
8600000US60628,51211,23223,27988,40261,55559,3811,60628
8600000US60629,79470,39108,40362,42019,56396,1959,60629
8600000US60630,45431,21870,23561,72092,88927,2942,60630
8600000US60631,23544,11066,12478,91034,113720,6687,60631
8600000US60632,64158,32509,31649,42758,56684,2062,60632
8600000US60633,10044,5093,4951,47083,61696,6585,60633
8600000US60634,59414,28885,30529,66741,81533,2579,60634
8600000US60636,24761,11618,13143,27310,41515,2544,60636
8600000US60637,35902,14912,20990,28785,60302,5263,60637
8600000US60638,44497,22112,22385,67984,81993,2482,60638
8600000US60639,65944,32668,33276,44150,58812,1905,60639
8600000US60640,60170,30696,29474,53831,80424,2779,60640
8600000US60641,55174,26535,28639,60073,79606,2972,60641
8600000US60642,17870,8851,9019,101939,122742,5287,60642
8600000US60643,38788,17617,21171,64477,88321,3955,60643
8600000US60644,35376,15228,20148,27262,42543,2821,60644
8600000US60645,34826,17161,17665,53340,76812,4520,60645
8600000US60646,21987,10348,11639,89480,119777,10555,60646
8600000US60647,71211,35749,35462,73443,102153,2825,60647
8600000US60649,35531,14173,21358,30222,49147,4291,60649
8600000US60651,45889,20467,25422,38083,50872,2304,60651
8600000US60652,32228,15008,17220,68425,77770,3377,60652
8600000US60653,23060,9263,13797,29569,55675,3296,60653
8600000US60654,17524,8875,8649,112699,165178,13761,60654
8600000US60655,21789,10538,11251,97572,109287,3758,60655
8600000US60656,22632,11327,11305,61599,77491,3794,60656
8600000US60657,61614,30888,30726,92295,136939,3693,60657
8600000US60659,30914,15628,15286,51383,71390,3425,60659
8600000US60660,38197,18691,19506,49241,72394,3347,60660
8600000US60661,9243,4725,4518,107245,138255,13572,60661
8600000US60706,19009,8950,10059,62657,80144,4366,60706
8600000US60707,33734,15868,17866,57554,77041,4618,60707
8600000US60712,9876,4618,5258,93250,116740,8510,60712
8600000US60714,24878,11624,13254,60708,76407,3205,60714
8600000US60803,16914,8311,8603,56239,69284,4050,60803
8600000US60804,58356,29331,29025,47487,58789,2299,60804
8600000US60805,14913,6611,8302,72054,91604,6248,60805
8600000US60827,20232,8503,11729,31954,46742,3406,60827
8600000US60901,26973,12972,14001,47629,61421,2585,60901
8600000US60910,520,268,252,44444,51440,9045,60910
8600000US60911,1016,494,522,66719,76993,8148,60911
8600000US60912,424,209,215,45313,53204,7219,60912
8600000US60913,1263,656,607,72266,81763,6759,60913
8600000US60914,23091,10503,12588,68512,84966,4132,60914
8600000US60915,7548,3501,4047,55152,60926,3542,60915
8600000US60917,379,174,205,77600,74938,9477,60917
8600000US60918,661,364,297,47955,61337,9251,60918
8600000US60919,393,191,202,70833,88174,21173,60919
8600000US60920,154,71,83,44063,55288,13191,60920
8600000US60921,1158,534,624,38438,55355,6044,60921
8600000US60922,1720,896,824,68594,77447,8951,60922
8600000US60924,1158,594,564,55298,66949,6560,60924
8600000US60926,35,16,19,,62765,26758,60926
8600000US60927,1657,809,848,59716,74639,6488,60927
8600000US60928,589,251,338,55250,75935,13757,60928
8600000US60929,585,255,330,39875,52943,6068,60929
8600000US60930,685,325,360,58594,62346,7324,60930
8600000US60931,400,194,206,55000,56957,7953,60931
8600000US60932,65,24,41,79219,95395,31505,60932
8600000US60933,237,120,117,52031,58377,7834,60933
8600000US60934,213,110,103,,96313,59508,60934
8600000US60935,870,459,411,72171,90830,10859,60935
8600000US60936,3177,1469,1708,44645,64607,5120,60936
8600000US60938,1536,717,819,54375,63133,4877,60938
8600000US60940,2731,1393,1338,69489,82482,6723,60940
8600000US60941,1590,781,809,74444,99611,20658,60941
8600000US60942,4618,2331,2287,44105,65697,11058,60942
8600000US60945,151,76,75,57500,63244,9379,60945
8600000US60946,336,168,168,55714,79626,22417,60946
8600000US60948,1184,574,610,69250,90918,16694,60948
8600000US60949,440,213,227,53750,62692,8491,60949
8600000US60950,9206,4847,4359,59240,77622,7276,60950
8600000US60951,651,331,320,70179,86441,12763,60951
8600000US60952,470,231,239,51875,71762,14397,60952
8600000US60953,1846,931,915,47422,55425,4299,60953
8600000US60954,4525,2494,2031,60331,66211,5326,60954
8600000US60955,1226,653,573,55486,72654,11912,60955
8600000US60957,4000,1927,2073,53434,64898,4700,60957
8600000US60958,1340,647,693,28922,37334,5940,60958
8600000US60959,911,451,460,52411,59639,6366,60959
8600000US60960,842,429,413,56683,69079,9138,60960
8600000US60961,555,280,275,75000,111124,33918,60961
8600000US60962,485,269,216,42083,52709,8656,60962
8600000US60963,1392,670,722,51932,63219,6285,60963
8600000US60964,3913,1961,1952,53723,66843,3722,60964
8600000US60966,1290,620,670,48355,60776,8098,60966
8600000US60968,236,105,131,53750,80593,27921,60968
8600000US60969,32,16,16,62188,65100,11502,60969
8600000US60970,5680,2652,3028,41330,54779,5646,60970
8600000US60973,299,137,162,58380,61083,11650,60973
8600000US60974,220,104,116,47857,53353,8269,60974
8600000US61001,895,485,410,65240,71291,10207,61001
8600000US61006,1379,690,689,59559,69792,5300,61006
8600000US61007,399,219,180,52829,90145,40910,61007
8600000US61008,25728,12451,13277,58709,76643,3988,61008
8600000US61010,5831,2769,3062,76620,96464,6765,61010
8600000US61011,2007,1015,992,116411,133188,23214,61011
8600000US61012,1779,930,849,59565,79895,11491,61012
8600000US61013,416,194,222,64167,67762,8384,61013
8600000US61014,974,503,471,55481,64185,7136,61014
8600000US61015,877,387,490,81250,83870,20849,61015
8600000US61016,4062,1998,2064,74821,89740,10077,61016
8600000US61018,798,388,410,51923,59010,8007,61018
8600000US61019,2511,1306,1205,67443,80396,7970,61019
8600000US61020,2159,1094,1065,68654,81327,7951,61020
8600000US61021,18753,10406,8347,59874,74628,4309,61021
8600000US61024,2040,1059,981,61452,69242,5694,61024
8600000US61025,3637,1958,1679,62208,77540,11850,61025
8600000US61027,61,32,29,,,,61027
8600000US61028,1724,835,889,49189,66150,12097,61028
8600000US61030,1623,816,807,53906,65908,7153,61030
8600000US61031,1215,602,613,52188,74547,19821,61031
8600000US61032,23442,10807,12635,42829,59102,3004,61032
8600000US61036,5570,2602,2968,59934,87452,14000,61036
8600000US61037,55,26,29,78571,69158,26755,61037
8600000US61038,1003,529,474,79598,78880,10627,61038
8600000US61039,715,325,390,59750,64896,8380,61039
8600000US61041,815,389,426,43370,47331,4881,61041
8600000US61042,503,266,237,49318,63115,10897,61042
8600000US61043,70,41,29,54375,87454,42210,61043
8600000US61044,178,100,78,68250,62447,14938,61044
8600000US61046,1932,963,969,60469,78611,9037,61046
8600000US61047,1532,718,814,57847,65681,9925,61047
8600000US61048,3072,1562,1510,53455,62910,5429,61048
8600000US61049,410,185,225,59231,72823,14557,61049
8600000US61050,378,198,180,53269,67280,10355,61050
8600000US61051,1297,677,620,58315,69831,9270,61051
8600000US61052,711,383,328,60000,72319,9715,61052
8600000US61053,2203,1071,1132,49375,63417,5376,61053
8600000US61054,2911,1328,1583,52313,57001,6496,61054
8600000US61057,95,45,50,71364,91492,30239,61057
8600000US61059,155,69,86,62500,63045,14677,61059
8600000US61060,1144,625,519,50893,65440,7093,61060
8600000US61061,5303,2613,2690,59519,74531,6572,61061
8600000US61062,1386,723,663,72500,81107,7272,61062
8600000US61063,3197,1646,1551,69306,85427,18035,61063
8600000US61064,2853,1485,1368,57525,66431,6591,61064
8600000US61065,7348,3843,3505,70056,91887,16490,61065
8600000US61067,669,340,329,55000,69993,12811,61067
8600000US61068,10812,5492,5320,54797,66894,3802,61068
8600000US61070,1116,585,531,61364,82804,25289,61070
8600000US61071,10817,5346,5471,52355,65703,5544,61071
8600000US61072,8889,4417,4472,84159,89879,4428,61072
8600000US61073,14086,6741,7345,84563,102165,4985,61073
8600000US61074,3331,1595,1736,42969,51159,5316,61074
8600000US61075,800,405,395,61875,71352,6019,61075
8600000US61077,36,18,18,,,,61077
8600000US61078,1056,513,543,43646,60997,10198,61078
8600000US61079,124,66,58,51786,66119,19616,61079
8600000US61080,7577,3749,3828,61419,80951,10029,61080
8600000US61081,16266,7749,8517,53286,71263,4903,61081
8600000US61084,2370,1120,1250,70304,86052,10246,61084
8600000US61085,2694,1324,1370,46859,58139,5100,61085
8600000US61087,1195,583,612,56466,61460,5754,61087
8600000US61088,4579,2231,2348,83500,96358,6791,61088
8600000US61089,560,289,271,53350,73690,13639,61089
8600000US61091,45,20,25,,,,61091
8600000US61101,14036,6718,7318,35054,44395,2742,61101
8600000US61102,13055,6698,6357,39793,57830,8666,61102
8600000US61103,18668,8669,9999,37749,55077,3948,61103
8600000US61104,13948,6952,6996,28453,37985,2594,61104
8600000US61107,24513,11792,12721,60404,80996,3537,61107
8600000US61108,21644,10226,11418,52852,65400,3522,61108
8600000US61109,20583,9917,10666,49224,57641,2717,61109
8600000US61111,18232,8495,9737,52931,71085,5252,61111
8600000US61112,66,7,59,21192,28295,15512,61112
8600000US61114,12667,5575,7092,74025,95545,7052,61114
8600000US61115,17454,8613,8841,60213,69955,3408,61115
8600000US61201,30118,14576,15542,47563,60957,2370,61201
8600000US61230,893,416,477,55000,67134,8576,61230
8600000US61231,4117,1972,2145,53859,67248,7944,61231
8600000US61232,1014,509,505,64500,80690,15737,61232
8600000US61234,1014,494,520,54625,61091,4293,61234
8600000US61235,1110,525,585,58636,68428,6136,61235
8600000US61236,91,41,50,48977,59029,16528,61236
8600000US61238,2733,1407,1326,62132,72480,6023,61238
8600000US61239,817,338,479,34033,43583,6903,61239
8600000US61240,4848,2394,2454,72292,91208,10918,61240
8600000US61241,5329,2684,2645,64552,69762,5965,61241
8600000US61242,1027,537,490,69867,79351,9818,61242
8600000US61243,219,97,122,100972,95000,13654,61243
8600000US61244,18429,9188,9241,49343,58019,3183,61244
8600000US61250,1914,926,988,58889,78699,11522,61250
8600000US61251,298,143,155,85703,109303,43261,61251
8600000US61252,4245,2136,2109,59572,70988,5284,61252
8600000US61254,8471,4026,4445,67312,86960,6355,61254
8600000US61256,1457,710,747,68485,85513,5872,61256
8600000US61257,811,365,446,52417,61186,9785,61257
8600000US61258,152,77,75,47917,52457,13830,61258
8600000US61259,920,441,479,73636,90816,20224,61259
8600000US61260,820,397,423,45750,50919,7562,61260
8600000US61261,709,348,361,44792,59412,8856,61261
8600000US61262,906,442,464,69375,76274,8172,61262
8600000US61263,489,242,247,59750,63482,10864,61263
8600000US61264,8511,3995,4516,56832,76945,5908,61264
8600000US61265,33870,16592,17278,52635,70180,3874,61265
8600000US61270,5584,2811,2773,57250,70392,4781,61270
8600000US61272,950,507,443,49063,59343,6697,61272
8600000US61273,2536,1246,1290,70766,84112,7796,61273
8600000US61274,187,109,78,67031,71319,15560,61274
8600000US61275,3498,1806,1692,68774,90636,7343,61275
8600000US61276,73,24,49,59868,65261,6058,61276
8600000US61277,2591,1311,1280,59000,79976,16781,61277
8600000US61278,334,151,183,74375,87370,18376,61278
8600000US61279,703,380,323,56375,66262,7742,61279
8600000US61281,1953,1030,923,68958,83508,7121,61281
8600000US61282,5771,2681,3090,50620,56828,4613,61282
8600000US61283,1143,540,603,49938,63559,9359,61283
8600000US61284,1698,868,830,83538,102016,13971,61284
8600000US61285,1346,692,654,62961,70622,7816,61285
8600000US61301,7656,3932,3724,47692,62982,5809,61301
8600000US61310,2961,1463,1498,51818,67352,7152,61310
8600000US61311,161,101,60,51250,56867,24944,61311
8600000US61312,398,203,195,75750,83769,15401,61312
8600000US61313,178,82,96,56944,62077,17844,61313
8600000US61314,699,344,355,46023,61793,7647,61314
8600000US61315,163,80,83,56250,69345,17372,61315
8600000US61316,224,113,111,57500,63145,9184,61316
8600000US61317,372,200,172,47750,57409,9096,61317
8600000US61318,585,272,313,51477,62491,9422,61318
8600000US61319,1177,613,564,68194,72080,8360,61319
8600000US61320,614,336,278,54000,70705,10060,61320
8600000US61321,205,80,125,51250,97399,40072,61321
8600000US61322,1040,593,447,51364,58447,6358,61322
8600000US61323,65,27,38,,90027,55437,61323
8600000US61324,92,63,29,76136,77670,21554,61324
8600000US61325,764,355,409,68281,94399,20317,61325
8600000US61326,1906,946,960,66196,89426,13714,61326
8600000US61327,959,498,461,64219,74867,5926,61327
8600000US61328,9,0,9,,,,61328
8600000US61329,962,489,473,65972,80684,11999,61329
8600000US61330,1153,562,591,81250,96626,9564,61330
8600000US61331,18,9,9,,,,61331
8600000US61332,60,28,32,66250,63969,14763,61332
8600000US61333,242,121,121,77917,74849,10530,61333
8600000US61334,521,257,264,62750,74743,12036,61334
8600000US61335,343,165,178,83750,76448,13864,61335
8600000US61336,405,221,184,66250,71700,12792,61336
8600000US61337,309,174,135,41333,58763,11459,61337
8600000US61338,194,109,85,52000,61886,10432,61338
8600000US61340,212,105,107,77708,88396,23323,61340
8600000US61341,6101,2831,3270,59147,74655,6494,61341
8600000US61342,6720,3376,3344,58845,77916,10227,61342
8600000US61344,314,164,150,46250,57957,9419,61344
8600000US61345,682,356,326,71667,84880,22562,61345
8600000US61346,60,27,33,52750,47694,9176,61346
8600000US61348,3532,1753,1779,59219,70332,6343,61348
8600000US61349,696,337,359,63026,79680,10007,61349
8600000US61350,18442,8756,9686,53793,69499,3140,61350
8600000US61353,961,488,473,54423,65707,5915,61353
8600000US61354,8541,3906,4635,50809,67655,5677,61354
8600000US61356,8496,3976,4520,59638,70516,3551,61356
8600000US61358,245,123,122,41528,50122,8443,61358
8600000US61359,235,112,123,53750,65954,14252,61359
8600000US61360,2753,1457,1296,71198,81954,7696,61360
8600000US61361,877,437,440,52813,70009,6588,61361
8600000US61362,4325,1987,2338,49112,63878,6701,61362
8600000US61363,200,111,89,43571,63975,20642,61363
8600000US61364,15026,7539,7487,48564,60493,2864,61364
8600000US61367,583,284,299,51711,71788,13234,61367
8600000US61368,1135,565,570,47619,59010,5002,61368
8600000US61369,1405,666,739,54205,62476,4881,61369
8600000US61370,1051,540,511,59583,72472,5716,61370
8600000US61372,114,63,51,65000,71728,15536,61372
8600000US61373,1672,865,807,74821,83756,7446,61373
8600000US61374,106,59,47,84167,89312,28074,61374
8600000US61375,997,502,495,64706,71920,6956,61375
8600000US61376,1713,874,839,50833,65321,7517,61376
8600000US61377,1079,499,580,58289,68315,9461,61377
8600000US61378,278,159,119,47000,76257,27871,61378
8600000US61379,1102,549,553,56250,67988,8693,61379
8600000US61401,27381,14043,13338,38710,54848,2729,61401
8600000US61410,3067,1366,1701,44570,52683,5593,61410
8600000US61411,390,231,159,68594,88791,32310,61411
8600000US61412,1122,556,566,57250,66925,7068,61412
8600000US61413,720,356,364,55682,71516,11020,61413
8600000US61414,661,300,361,54965,61253,5841,61414
8600000US61415,1402,695,707,56667,70287,8548,61415
8600000US61416,228,104,124,21250,29936,7282,61416
8600000US61417,266,119,147,61667,63402,7976,61417
8600000US61418,464,215,249,47500,69018,14564,61418
8600000US61419,105,40,65,47500,60734,22593,61419
8600000US61420,947,483,464,50078,61675,7155,61420
8600000US61421,954,497,457,55417,72363,9803,61421
8600000US61422,2498,1327,1171,44981,56788,7010,61422
8600000US61423,428,206,222,80179,82620,20401,61423
8600000US61424,106,53,53,120250,102526,21956,61424
8600000US61425,363,181,182,55781,57069,12397,61425
8600000US61426,82,30,52,43684,46945,14266,61426
8600000US61427,1726,835,891,58641,68410,8221,61427
8600000US61428,824,427,397,70625,96240,12477,61428
8600000US61430,562,296,266,59063,81151,11706,61430
8600000US61431,253,122,131,39125,74578,29920,61431
8600000US61432,501,246,255,72188,80082,22211,61432
8600000US61433,107,60,47,,,,61433
8600000US61434,2427,1293,1134,39280,53459,6498,61434
8600000US61435,29,6,23,,,,61435
8600000US61436,572,264,308,65417,78258,15081,61436
8600000US61437,717,351,366,57375,67688,9131,61437
8600000US61438,677,350,327,63750,98232,23512,61438
8600000US61439,215,117,98,52250,57428,8997,61439
8600000US61440,529,235,294,64063,62946,5811,61440
8600000US61441,811,422,389,45714,56438,7493,61441
8600000US61442,575,256,319,37500,51759,10176,61442
8600000US61443,10504,4963,5541,40559,53712,3219,61443
8600000US61447,762,369,393,66250,104039,35138,61447
8600000US61448,2882,1278,1604,55801,70735,7881,61448
8600000US61449,274,158,116,36667,65167,17986,61449
8600000US61450,1398,667,731,44500,52676,4617,61450
8600000US61451,262,116,146,69821,89393,11541,61451
8600000US61452,178,87,91,46750,52594,11546,61452
8600000US61453,450,236,214,51875,61539,13573,61453
8600000US61454,424,188,236,38750,54255,10640,61454
8600000US61455,17679,8195,9484,42013,58477,3830,61455
8600000US61458,570,297,273,56354,66693,11928,61458
8600000US61459,344,177,167,72992,69867,11188,61459
8600000US61460,240,101,139,43864,56549,13898,61460
8600000US61462,8831,4230,4601,43568,63045,5823,61462
8600000US61465,914,470,444,70368,77780,18284,61465
8600000US61466,282,161,121,61667,77008,20711,61466
8600000US61467,824,396,428,74306,75641,5277,61467
8600000US61468,70,41,29,,55419,24937,61468
8600000US61469,1871,960,911,44967,59457,10569,61469
8600000US61470,398,199,199,47222,57168,10408,61470
8600000US61471,55,27,28,46667,72457,36047,61471
8600000US61472,442,234,208,72727,81439,15502,61472
8600000US61473,1245,599,646,44883,58526,7414,61473
8600000US61474,220,96,124,51875,51715,7893,61474
8600000US61475,173,103,70,76563,77452,12095,61475
8600000US61476,319,146,173,49511,65625,14242,61476
8600000US61477,444,190,254,40000,48966,10484,61477
8600000US61478,230,106,124,85341,81522,19488,61478
8600000US61479,51,34,17,17969,75276,92923,61479
8600000US61480,960,446,514,51389,57932,6355,61480
8600000US61482,480,234,246,53750,58479,9414,61482
8600000US61483,1685,822,863,51591,60835,5416,61483
8600000US61484,647,327,320,50556,57141,8884,61484
8600000US61485,383,201,182,48684,63828,15804,61485
8600000US61486,1066,539,527,63382,74686,6937,61486
8600000US61488,836,401,435,53750,62503,8023,61488
8600000US61489,669,305,364,52500,63156,8263,61489
8600000US61490,895,493,402,58750,67999,7324,61490
8600000US61491,1541,773,768,56286,85092,15464,61491
8600000US61501,1165,612,553,43897,54280,7688,61501
8600000US61516,523,276,247,71500,73414,7046,61516
8600000US61517,2524,1391,1133,83929,114535,16059,61517
8600000US61519,188,92,96,53750,74955,24709,61519
8600000US61520,13806,7683,6123,47362,61865,4311,61520
8600000US61523,8641,4241,4400,59758,71654,4920,61523
8600000US61524,269,129,140,48333,58083,10263,61524
8600000US61525,6162,3112,3050,122000,159856,16007,61525
8600000US61526,615,260,355,81875,100724,23653,61526
8600000US61528,2282,1188,1094,105918,122738,13419,61528
8600000US61529,2040,977,1063,70750,78931,6391,61529
8600000US61530,5566,2710,2856,58936,77547,10198,61530
8600000US61531,2527,1230,1297,56528,63494,5153,61531
8600000US61532,468,226,242,51833,79149,25165,61532
8600000US61533,1950,952,998,60250,71369,8097,61533
8600000US61534,1358,703,655,57917,71175,7792,61534
8600000US61535,1240,631,609,81964,110004,28851,61535
8600000US61536,2300,1095,1205,70690,78389,8541,61536
8600000US61537,2096,1029,1067,47259,61326,8105,61537
8600000US61539,163,89,74,52000,52855,7490,61539
8600000US61540,2251,1085,1166,57137,75352,9598,61540
8600000US61541,77,30,47,30250,40562,11120,61541
8600000US61542,2906,1414,1492,56811,66107,6195,61542
8600000US61543,132,55,77,35208,44713,9707,61543
8600000US61544,441,217,224,51875,56328,7355,61544
8600000US61545,515,283,232,53542,67379,12866,61545
8600000US61546,2987,1504,1483,63387,74046,4273,61546
8600000US61547,3142,1562,1580,94688,117085,12455,61547
8600000US61548,8758,4148,4610,88233,117016,12422,61548
8600000US61550,13444,6382,7062,76797,98254,5047,61550
8600000US61552,101,50,51,32857,42015,17522,61552
8600000US61553,113,51,62,40625,42733,12415,61553
8600000US61554,32901,16007,16894,53504,66964,3095,61554
8600000US61559,2381,1109,1272,62241,76239,6603,61559
8600000US61560,548,268,280,62857,69362,19472,61560
8600000US61561,1964,974,990,56071,72750,6106,61561
8600000US61562,44,35,9,,72981,45200,61562
8600000US61563,392,200,192,43250,49631,7225,61563
8600000US61564,663,322,341,49934,55394,5159,61564
8600000US61565,1161,618,543,58516,70516,6532,61565
8600000US61567,422,222,200,38750,45507,7589,61567
8600000US61568,2867,1463,1404,80220,94654,8526,61568
8600000US61569,883,427,456,77763,78199,10932,61569
8600000US61570,1352,669,683,52688,66207,7237,61570
8600000US61571,18304,8568,9736,70785,89688,4727,61571
8600000US61572,1004,512,492,56607,66567,11387,61572
8600000US61602,872,678,194,18958,39942,7730,61602
8600000US61603,11814,5294,6520,34167,44886,3161,61603
8600000US61604,23898,11076,12822,46813,57507,2945,61604
8600000US61605,11071,5131,5940,21923,35458,4700,61605
8600000US61606,6695,3394,3301,46855,60074,6791,61606
8600000US61607,8257,3892,4365,62516,70732,3465,61607
8600000US61610,4604,2269,2335,47127,67806,20862,61610
8600000US61611,20359,10265,10094,59891,77341,5550,61611
8600000US61614,22419,10635,11784,62436,82054,4538,61614
8600000US61615,17325,8120,9205,67908,96452,7179,61615
8600000US61616,4710,2107,2603,44037,57839,5664,61616
8600000US61625,370,202,168,,,,61625
8600000US61701,28851,14239,14612,45664,61972,2944,61701
8600000US61704,28292,13990,14302,87174,113962,6413,61704
8600000US61705,8923,4324,4599,106915,126036,9665,61705
8600000US61720,132,63,69,60625,74381,17755,61720
8600000US61721,451,237,214,71111,68375,7366,61721
8600000US61722,359,166,193,62813,74073,11957,61722
8600000US61723,1994,1027,967,64453,76695,8185,61723
8600000US61724,391,194,197,52969,64835,15487,61724
8600000US61725,1155,636,519,85795,107106,21999,61725
8600000US61726,1913,974,939,61442,73403,7963,61726
8600000US61727,7655,3850,3805,53923,70207,4992,61727
8600000US61728,983,471,512,60333,90247,21475,61728
8600000US61729,853,412,441,77813,85428,8198,61729
8600000US61730,250,132,118,65417,76653,7886,61730
8600000US61731,144,60,84,112578,88247,25528,61731
8600000US61732,1506,752,754,83750,86411,7455,61732
8600000US61733,592,294,298,61458,71899,7611,61733
8600000US61734,2144,1043,1101,59798,79430,8199,61734
8600000US61735,346,167,179,59583,77808,20875,61735
8600000US61736,1321,659,662,94063,109145,14347,61736
8600000US61737,406,208,198,71442,79935,11586,61737
8600000US61738,3172,1554,1618,71857,89836,8526,61738
8600000US61739,3417,1606,1811,53993,66290,7345,61739
8600000US61740,1237,584,653,52917,84767,17772,61740
8600000US61741,1174,568,606,70385,76408,7560,61741
8600000US61742,990,509,481,94231,112024,15872,61742
8600000US61743,163,82,81,61250,67057,12817,61743
8600000US61744,1374,653,721,66667,77837,7097,61744
8600000US61745,3369,1642,1727,78565,85103,5898,61745
8600000US61747,1157,549,608,77578,92831,16171,61747
8600000US61748,2100,963,1137,83750,97287,7337,61748
8600000US61749,416,203,213,53261,58368,8252,61749
8600000US61750,98,60,38,58650,58674,10997,61750
8600000US61751,61,31,30,66250,59570,15539,61751
8600000US61752,3292,1562,1730,72798,81958,6591,61752
8600000US61753,2308,1116,1192,65547,101019,25398,61753
8600000US61754,908,428,480,65417,75888,13561,61754
8600000US61755,3494,1779,1715,82404,90461,7023,61755
8600000US61756,1811,972,839,68953,79763,6730,61756
8600000US61759,1209,597,612,65268,86213,13397,61759
8600000US61760,1849,913,936,65208,71467,5727,61760
8600000US61761,45197,20792,24405,55434,74534,3240,61761
8600000US61764,11091,5990,5101,52017,67952,4756,61764
8600000US61769,454,221,233,60000,67547,7948,61769
8600000US61770,844,398,446,61563,69879,6173,61770
8600000US61771,575,307,268,92574,99542,14545,61771
8600000US61772,217,99,118,78438,81973,20799,61772
8600000US61773,335,192,143,46250,52165,7273,61773
8600000US61774,844,453,391,72206,80355,8899,61774
8600000US61775,277,132,145,81250,93769,18437,61775
8600000US61776,1075,558,517,90294,103630,13187,61776
8600000US61777,586,270,316,55625,66144,7745,61777
8600000US61778,523,253,270,61750,70600,9152,61778
8600000US61801,28505,14885,13620,31530,50758,3620,61801
8600000US61802,15312,7219,8093,45321,63516,3975,61802
8600000US61810,274,133,141,59583,65259,12395,61810
8600000US61811,489,223,266,52656,51573,7295,61811
8600000US61812,348,160,188,68500,105275,25500,61812
8600000US61813,1339,656,683,48214,69575,8691,61813
8600000US61814,795,380,415,57083,64132,7043,61814
8600000US61815,223,121,102,61250,72584,14587,61815
8600000US61816,371,178,193,56667,82496,24229,61816
8600000US61817,1965,985,980,53950,62385,5646,61817
8600000US61818,1305,709,596,62132,75461,11837,61818
8600000US61820,35043,18523,16520,24305,42290,4015,61820
8600000US61821,23951,11982,11969,55743,75684,4915,61821
8600000US61822,19607,9023,10584,85231,119378,7972,61822
8600000US61830,285,140,145,59091,74848,17305,61830
8600000US61831,116,67,49,52083,74284,28204,61831
8600000US61832,25830,11925,13905,37822,51837,2036,61832
8600000US61833,1632,795,837,41503,59103,15321,61833
8600000US61834,7357,4468,2889,62538,81223,10433,61834
8600000US61839,481,241,240,64813,88412,20167,61839
8600000US61840,703,354,349,62941,76669,17969,61840
8600000US61841,1020,526,494,63417,66936,6315,61841
8600000US61842,2150,993,1157,60404,69496,6879,61842
8600000US61843,1740,846,894,62400,78127,7228,61843
8600000US61844,598,251,347,63393,88046,21400,61844
8600000US61845,293,157,136,82813,146386,64903,61845
8600000US61846,3808,1868,1940,43750,56890,5719,61846
8600000US61847,932,427,505,74792,80719,6143,61847
8600000US61848,166,84,82,54750,57930,11716,61848
8600000US61849,1470,785,685,63295,78670,10672,61849
8600000US61850,323,162,161,53929,61261,9639,61850
8600000US61851,255,125,130,64167,90329,26545,61851
8600000US61852,149,73,76,43875,56773,12621,61852
8600000US61853,9975,4770,5205,90465,105558,7381,61853
8600000US61854,1001,470,531,62143,74375,7277,61854
8600000US61855,85,46,39,,49309,24238,61855
8600000US61856,5881,2764,3117,75665,85839,7927,61856
8600000US61857,145,87,58,32500,42226,12271,61857
8600000US61858,2359,1064,1295,60068,67727,4907,61858
8600000US61859,958,479,479,72344,87736,15094,61859
8600000US61862,396,204,192,71827,98404,24408,61862
8600000US61863,617,333,284,69750,71407,9935,61863
8600000US61864,1330,671,659,78357,96391,13858,61864
8600000US61865,1048,493,555,54423,66974,9510,61865
8600000US61866,9916,4655,5261,43030,56384,4826,61866
8600000US61870,1025,607,418,52679,68213,14744,61870
8600000US61871,238,113,125,70833,71472,16784,61871
8600000US61872,646,306,340,77292,105896,44276,61872
8600000US61873,4737,2244,2493,88597,88125,9308,61873
8600000US61874,6582,3038,3544,65048,81182,6767,61874
8600000US61875,565,239,326,93906,101984,24448,61875
8600000US61876,458,226,232,49028,60463,8960,61876
8600000US61877,1292,641,651,73906,89095,11153,61877
8600000US61878,1115,540,575,50368,65307,7368,61878
8600000US61880,2824,1429,1395,76591,81867,11464,61880
8600000US61882,545,278,267,56167,66859,7310,61882
8600000US61883,3172,1536,1636,47679,56846,5794,61883
8600000US61884,959,466,493,88676,108575,22606,61884
8600000US61910,3049,1413,1636,53665,65889,6379,61910
8600000US61911,3392,1632,1760,56076,76557,11653,61911
8600000US61912,994,438,556,53125,61721,7912,61912
8600000US61913,1164,560,604,45446,56292,5845,61913
8600000US61914,1337,643,694,59408,71569,9874,61914
8600000US61917,568,265,303,58333,62675,10253,61917
8600000US61919,727,331,396,59886,68693,7844,61919
8600000US61920,20489,9781,10708,41045,63894,6695,61920
8600000US61924,1895,919,976,60977,69165,8245,61924
8600000US61925,552,295,257,64107,86038,21763,61925
8600000US61928,591,366,225,42946,54966,11385,61928
8600000US61929,504,281,223,49500,82859,36108,61929
8600000US61930,561,285,276,62865,66324,9769,61930
8600000US61931,889,412,477,53693,58147,9733,61931
8600000US61932,345,182,163,58750,63992,9107,61932
8600000US61933,739,365,374,36932,50312,5249,61933
8600000US61936,196,113,83,73750,90959,31078,61936
8600000US61937,1472,742,730,57708,62178,7564,61937
8600000US61938,17158,8170,8988,44797,63105,6355,61938
8600000US61940,181,89,92,38333,46914,9119,61940
8600000US61941,79,45,34,,,,61941
8600000US61942,890,393,497,58177,64896,8313,61942
8600000US61943,1318,609,709,53529,61503,8424,61943
8600000US61944,9630,4643,4987,50782,62419,6480,61944
8600000US61949,138,62,76,52500,63150,9876,61949
8600000US61951,6189,2958,3231,61096,69972,4396,61951
8600000US61953,4648,2342,2306,53684,79035,11970,61953
8600000US61955,134,68,66,48889,52207,10025,61955
8600000US61956,2171,1078,1093,56818,68680,6815,61956
8600000US61957,1464,701,763,50721,56356,6685,61957
8600000US62001,1437,689,748,73519,86858,10636,62001
8600000US62002,24083,11168,12915,43406,60260,3394,62002
8600000US62006,378,195,183,61452,66626,8701,62006
8600000US62009,1334,685,649,43309,50842,5119,62009
8600000US62010,8694,4094,4600,67535,78814,5702,62010
8600000US62011,141,78,63,49327,60537,16248,62011
8600000US62012,5137,2625,2512,75650,87296,8115,62012
8600000US62013,583,300,283,55833,77282,21484,62013
8600000US62014,3298,1548,1750,62697,70588,5702,62014
8600000US62015,481,246,235,51806,58407,10411,62015
8600000US62016,2859,1417,1442,51667,66742,10106,62016
8600000US62017,734,386,348,34250,46728,6275,62017
8600000US62018,2342,1103,1239,46722,48417,6028,62018
8600000US62019,353,175,178,48403,56790,16826,62019
8600000US62021,752,370,382,89554,85827,13259,62021
8600000US62022,890,495,395,59119,71089,10807,62022
8600000US62023,71,33,38,58542,111994,73184,62023
8600000US62024,7857,4025,3832,54975,65934,8753,62024
8600000US62025,27332,13399,13933,76809,100585,6136,62025
8600000US62027,413,200,213,61875,75399,17555,62027
8600000US62028,1114,567,547,52200,66860,16963,62028
8600000US62030,112,40,72,29375,35782,11331,62030
8600000US62031,609,303,306,50625,65863,11461,62031
8600000US62032,546,243,303,51806,56600,9250,62032
8600000US62033,3697,1663,2034,42240,59715,6292,62033
8600000US62034,10410,5066,5344,80625,97693,7794,62034
8600000US62035,13148,6167,6981,66474,80191,5254,62035
8600000US62036,674,373,301,61094,76757,11380,62036
8600000US62037,1799,882,917,55000,68748,9232,62037
8600000US62040,33454,16031,17423,49182,60344,2552,62040
8600000US62044,1653,777,876,48398,62210,6825,62044
8600000US62045,341,177,164,81750,76607,13607,62045
8600000US62046,522,262,260,66250,72589,10084,62046
8600000US62047,1120,533,587,53100,61613,8845,62047
8600000US62048,1295,671,624,50179,62956,9019,62048
8600000US62049,7831,4997,2834,53188,67207,8267,62049
8600000US62050,280,145,135,36016,40676,7459,62050
8600000US62051,529,287,242,43875,61520,16848,62051
8600000US62052,9383,4360,5023,50704,68794,5144,62052
8600000US62053,429,214,215,42361,47223,8132,62053
8600000US62054,586,373,213,48125,60490,15189,62054
8600000US62056,6713,3017,3696,48580,60542,5188,62056
8600000US62058,661,321,340,47250,54472,5502,62058
8600000US62059,349,127,222,17500,23087,5004,62059
8600000US62060,3627,1634,1993,24864,34794,5907,62060
8600000US62061,1289,658,631,72533,81082,8839,62061
8600000US62062,6552,3278,3274,70141,93996,9940,62062
8600000US62063,936,434,502,58239,71881,16064,62063
8600000US62065,152,57,95,,78798,51734,62065
8600000US62067,2148,1024,1124,73417,84441,11910,62067
8600000US62069,2510,1299,1211,53361,61150,4096,62069
8600000US62070,48,9,39,,,,62070
8600000US62074,926,444,482,82321,88080,15167,62074
8600000US62075,2564,1164,1400,56914,67402,5862,62075
8600000US62076,90,44,46,48438,58361,20003,62076
8600000US62077,182,82,100,46667,51300,11045,62077
8600000US62078,63,31,32,38333,41769,12459,62078
8600000US62079,147,34,113,16677,31327,20491,62079
8600000US62080,1855,896,959,38750,53976,8185,62080
8600000US62081,237,130,107,44375,61832,17958,62081
8600000US62082,2156,1225,931,43550,51834,4205,62082
8600000US62083,167,72,95,61065,68676,12188,62083
8600000US62084,1130,569,561,45847,62006,10892,62084
8600000US62085,137,64,73,31667,38011,6637,62085
8600000US62086,968,460,508,47609,52776,6557,62086
8600000US62087,1530,722,808,41250,47838,6032,62087
8600000US62088,5256,2624,2632,47143,63122,5722,62088
8600000US62089,404,216,188,41667,65439,21429,62089
8600000US62090,827,320,507,25370,35823,6014,62090
8600000US62091,267,136,131,49919,97736,49069,62091
8600000US62092,2414,1095,1319,40139,53324,8462,62092
8600000US62093,387,179,208,34821,42647,9643,62093
8600000US62094,848,410,438,46154,56240,8060,62094
8600000US62095,7977,3718,4259,45824,55778,4063,62095
8600000US62097,2360,1158,1202,81811,88882,6270,62097
8600000US62098,24,8,16,26429,25581,3383,62098
8600000US62201,4621,1796,2825,17384,27961,4170,62201
8600000US62203,6712,3065,3647,33765,47147,5324,62203
8600000US62204,5810,2734,3076,20942,32073,7268,62204
8600000US62205,6126,2724,3402,25856,39737,7138,62205
8600000US62206,11139,5142,5997,29266,45333,5088,62206
8600000US62207,6565,2848,3717,17973,30079,3594,62207
8600000US62208,13284,6523,6761,63074,78995,7515,62208
8600000US62214,964,500,464,74688,76606,8800,62214
8600000US62215,1362,672,690,65208,78813,11419,62215
8600000US62216,2121,1049,1072,85273,98477,8684,62216
8600000US62217,624,386,238,40303,52546,14253,62217
8600000US62218,1322,711,611,104531,115381,15263,62218
8600000US62219,750,352,398,41406,54691,12455,62219
8600000US62220,14276,7049,7227,52608,67815,5029,62220
8600000US62221,22989,10695,12294,63458,82530,4929,62221
8600000US62223,13022,6199,6823,62572,77441,5560,62223
8600000US62225,3205,1751,1454,63958,78295,7176,62225
8600000US62226,22810,10595,12215,54745,74691,4228,62226
8600000US62230,4910,2232,2678,70536,90977,16540,62230
8600000US62231,5903,3059,2844,53778,65491,6289,62231
8600000US62232,4899,2393,2506,50864,76426,10051,62232
8600000US62233,8197,5889,2308,50496,65981,7589,62233
8600000US62234,25651,12120,13531,55663,70028,3446,62234
8600000US62236,10461,5018,5443,98109,122333,10095,62236
8600000US62237,1949,1063,886,51563,62507,6488,62237
8600000US62238,455,236,219,53523,53608,9068,62238
8600000US62239,3569,1588,1981,46192,59459,8685,62239
8600000US62240,1254,650,604,44125,55061,7711,62240
8600000US62241,760,399,361,59426,65901,9579,62241
8600000US62242,1126,487,639,54559,70986,11683,62242
8600000US62243,4710,2368,2342,77542,97307,8239,62243
8600000US62244,735,359,376,70893,90291,17394,62244
8600000US62245,1359,722,637,68929,78067,5812,62245
8600000US62246,8213,4360,3853,62188,74939,7573,62246
8600000US62248,269,129,140,46250,58041,12317,62248
8600000US62249,11944,5961,5983,66615,86617,6554,62249
8600000US62250,356,194,162,42614,58229,10340,62250
8600000US62253,463,224,239,47500,58049,11036,62253
8600000US62254,5131,2368,2763,63192,71309,8121,62254
8600000US62255,808,421,387,65000,79027,12852,62255
8600000US62257,2218,1109,1109,59338,67221,7546,62257
8600000US62258,6683,3226,3457,79432,89121,5730,62258
8600000US62260,5930,2955,2975,79423,88521,7454,62260
8600000US62261,64,26,38,48750,64844,25240,62261
8600000US62262,1229,637,592,41645,58205,8797,62262
8600000US62263,4127,2134,1993,57732,81333,11569,62263
8600000US62264,2916,1536,1380,63850,68667,6272,62264
8600000US62265,3389,1619,1770,71875,88963,8060,62265
8600000US62266,60,29,31,,,,62266
8600000US62268,504,241,263,68929,85875,18639,62268
8600000US62269,23825,11478,12347,87269,107451,8256,62269
8600000US62271,1649,805,844,63702,80307,7871,62271
8600000US62272,1243,657,586,42063,58305,6351,62272
8600000US62273,278,135,143,69545,85135,29770,62273
8600000US62274,6694,4345,2349,45926,66387,16027,62274
8600000US62275,2865,1402,1463,69705,73858,5469,62275
8600000US62277,1088,557,531,55139,64447,8532,62277
8600000US62278,5064,2522,2542,66170,83690,11572,62278
8600000US62279,7,0,7,,,,62279
8600000US62280,337,185,152,85313,81355,17717,62280
8600000US62281,1869,914,955,95188,112714,27511,62281
8600000US62282,325,140,185,64250,77041,12202,62282
8600000US62284,408,192,216,41250,50904,7770,62284
8600000US62285,3348,1498,1850,76228,103551,22341,62285
8600000US62286,5133,2412,2721,49092,63980,6409,62286
8600000US62288,2321,1150,1171,59401,72093,9926,62288
8600000US62289,247,102,145,43636,54107,11225,62289
8600000US62292,711,329,382,36953,53304,9400,62292
8600000US62293,3495,1594,1901,71728,94507,7987,62293
8600000US62294,10530,4999,5531,82977,92722,5817,62294
8600000US62295,1166,541,625,78654,90518,8756,62295
8600000US62297,215,105,110,75357,84818,17114,62297
8600000US62298,13006,6354,6652,74794,89602,5148,62298
8600000US62301,25159,11758,13401,40634,56847,2990,62301
8600000US62305,14999,7247,7752,69700,94162,7880,62305
8600000US62311,553,312,241,50000,55430,6264,62311
8600000US62312,1450,656,794,40982,60014,6691,62312
8600000US62313,319,159,160,45139,60145,13573,62313
8600000US62314,356,162,194,39375,52719,15210,62314
8600000US62316,402,213,189,53672,55409,11298,62316
8600000US62319,232,117,115,62788,62037,14283,62319
8600000US62320,1802,892,910,60769,68272,8645,62320
8600000US62321,2994,1412,1582,53325,66148,5818,62321
8600000US62323,184,97,87,54531,57279,6665,62323
8600000US62324,850,468,382,44063,50999,8544,62324
8600000US62325,331,154,177,57540,54610,6241,62325
8600000US62326,1800,879,921,40893,53962,4061,62326
8600000US62330,1438,709,729,50347,58265,6055,62330
8600000US62334,108,58,50,37083,45083,11530,62334
8600000US62336,17,8,9,47500,73717,56147,62336
8600000US62338,965,540,425,68309,81737,14297,62338
8600000US62339,699,319,380,57292,66794,9185,62339
8600000US62340,1421,708,713,51932,68073,9152,62340
8600000US62341,2788,1256,1532,51913,66211,7403,62341
8600000US62343,684,347,337,43750,55416,11164,62343
8600000US62344,14,3,11,,,,62344
8600000US62345,314,160,154,60150,52240,7755,62345
8600000US62346,170,86,84,51563,49023,8560,62346
8600000US62347,1394,630,764,63873,77303,12080,62347
8600000US62348,133,57,76,58516,62466,9022,62348
8600000US62349,461,237,224,49063,54825,5995,62349
8600000US62351,1463,747,716,59659,68516,7832,62351
8600000US62352,188,87,101,35750,50161,11955,62352
8600000US62353,4535,3217,1318,57721,65230,5712,62353
8600000US62354,1284,681,603,48750,69028,13163,62354
8600000US62355,608,318,290,41563,50849,9208,62355
8600000US62356,376,176,200,42813,47641,8382,62356
8600000US62357,384,171,213,24931,52552,23086,62357
8600000US62358,645,318,327,57784,69368,11915,62358
8600000US62359,152,87,65,39185,47786,9866,62359
8600000US62360,1400,730,670,60000,69192,10166,62360
8600000US62361,343,190,153,56875,53632,6213,62361
8600000US62362,244,111,133,30833,43263,7057,62362
8600000US62363,4654,2382,2272,39311,59091,5377,62363
8600000US62365,466,276,190,51964,67776,15713,62365
8600000US62366,1174,557,617,45991,52362,5237,62366
8600000US62367,887,467,420,37266,49556,7783,62367
8600000US62370,171,100,71,53854,60331,11380,62370
8600000US62373,243,113,130,,75309,27487,62373
8600000US62374,323,178,145,,48131,14027,62374
8600000US62375,250,133,117,92308,98543,18408,62375
8600000US62376,913,470,443,52083,75826,13056,62376
8600000US62378,815,354,461,55694,67385,10442,62378
8600000US62379,1307,681,626,53977,68121,8556,62379
8600000US62380,326,127,199,56731,62465,13005,62380
8600000US62401,14449,6940,7509,53170,75155,7347,62401
8600000US62410,867,412,455,63125,77910,12199,62410
8600000US62411,3096,1472,1624,48789,69301,13362,62411
8600000US62413,265,136,129,46932,58458,8909,62413
8600000US62414,1513,745,768,39792,59597,8284,62414
8600000US62417,2464,1190,1274,49704,66131,7222,62417
8600000US62418,1553,775,778,48036,67691,13125,62418
8600000US62419,212,121,91,35000,63328,36565,62419
8600000US62420,3701,1712,1989,49362,64169,6196,62420
8600000US62421,445,220,225,66250,71119,7907,62421
8600000US62422,824,437,387,40833,54397,8177,62422
8600000US62423,369,172,197,100139,82717,14355,62423
8600000US62424,1702,879,823,65260,80533,10163,62424
8600000US62425,425,229,196,56146,71264,16447,62425
8600000US62426,741,363,378,43229,51979,8591,62426
8600000US62427,1256,559,697,58490,71202,10394,62427
8600000US62428,2188,1093,1095,51190,57036,5004,62428
8600000US62431,797,427,370,46458,54178,10406,62431
8600000US62432,337,198,139,53750,72548,27137,62432
8600000US62433,722,375,347,49028,61857,9089,62433
8600000US62434,299,145,154,52250,66066,16430,62434
8600000US62436,558,344,214,39306,51810,14231,62436
8600000US62438,189,94,95,40972,46945,13112,62438
8600000US62439,5659,2714,2945,41834,55450,4233,62439
8600000US62440,970,506,464,57292,58313,10941,62440
8600000US62441,5246,2570,2676,55951,78372,8997,62441
8600000US62442,2113,1082,1031,52962,59673,4684,62442
8600000US62443,1257,643,614,55719,63271,6635,62443
8600000US62444,248,129,119,39250,60513,18638,62444
8600000US62445,969,515,454,64167,63492,7835,62445
8600000US62446,298,155,143,68500,82446,19490,62446
8600000US62447,2822,1370,1452,51386,65286,6413,62447
8600000US62448,4259,2038,2221,50754,61224,4734,62448
8600000US62449,2398,1097,1301,45125,64217,8568,62449
8600000US62450,9535,4601,4934,44840,59060,3640,62450
8600000US62451,1593,702,891,46458,62405,8257,62451
8600000US62452,303,160,143,44375,53831,8967,62452
8600000US62454,9136,5202,3934,50383,72197,5829,62454
8600000US62458,1592,808,784,43682,53574,5326,62458
8600000US62459,258,120,138,44583,78746,44601,62459
8600000US62460,844,389,455,50417,60785,10489,62460
8600000US62461,552,277,275,56023,69893,11086,62461
8600000US62462,671,327,344,48333,59084,8883,62462
8600000US62463,877,412,465,62727,65234,7696,62463
8600000US62465,757,413,344,75139,80939,9312,62465
8600000US62466,4073,3070,1003,48438,58484,6000,62466
8600000US62467,3255,1691,1564,80000,95242,11053,62467
8600000US62468,1935,937,998,62258,66813,5758,62468
8600000US62469,476,222,254,72500,67579,17663,62469
8600000US62471,8400,4847,3553,45754,60846,4759,62471
8600000US62473,1135,596,539,56012,62930,9507,62473
8600000US62474,760,396,364,54821,64191,9164,62474
8600000US62475,340,192,148,58571,55338,15261,62475
8600000US62476,1280,656,624,48185,55891,5841,62476
8600000US62477,616,315,301,55643,65857,14808,62477
8600000US62478,295,143,152,79375,81646,20951,62478
8600000US62479,643,309,334,64861,70485,9813,62479
8600000US62480,440,226,214,35875,47391,10604,62480
8600000US62481,327,154,173,55972,55837,16093,62481
8600000US62501,2216,1143,1073,74260,87126,8486,62501
8600000US62510,1135,572,563,46293,59971,9009,62510
8600000US62512,322,164,158,56875,82505,19987,62512
8600000US62513,1177,522,655,49167,65171,11036,62513
8600000US62514,157,65,92,,60478,26643,62514
8600000US62515,800,415,385,67750,75305,7643,62515
8600000US62517,145,60,85,50938,51245,7984,62517
8600000US62518,152,66,86,,52588,10073,62518
8600000US62519,61,29,32,67102,81286,21659,62519
8600000US62520,1355,674,681,83906,96471,17578,62520
8600000US62521,27423,12847,14576,54888,74236,4169,62521
8600000US62522,11981,5624,6357,44993,58815,3468,62522
8600000US62523,1124,731,393,11250,16024,3651,62523
8600000US62526,25668,11470,14198,39683,55152,2781,62526
8600000US62530,1229,554,675,63750,74452,8454,62530
8600000US62531,1437,764,673,56625,73788,8932,62531
8600000US62532,110,32,78,60208,56728,23964,62532
8600000US62533,612,283,329,53828,63499,11103,62533
8600000US62534,1127,585,542,59250,63767,8328,62534
8600000US62535,2307,1095,1212,86250,122552,15739,62535
8600000US62536,607,361,246,83542,107143,26150,62536
8600000US62537,56,25,31,,48689,23553,62537
8600000US62538,290,118,172,63571,74507,17516,62538
8600000US62539,991,464,527,68563,70815,6956,62539
8600000US62540,1264,635,629,52344,56817,5190,62540
8600000US62541,37,14,23,,41583,26214,62541
8600000US62543,421,239,182,54282,65183,9049,62543
8600000US62544,1299,643,656,65000,82899,8807,62544
8600000US62545,951,460,491,65962,78987,11508,62545
8600000US62546,1221,612,609,62350,71471,6279,62546
8600000US62547,672,320,352,65667,71993,14604,62547
8600000US62548,1898,881,1017,70341,81780,8768,62548
8600000US62549,4579,2365,2214,71978,89571,9021,62549
8600000US62550,2124,1035,1089,64079,73452,5471,62550
8600000US62551,497,250,247,57500,64685,6892,62551
8600000US62553,389,207,182,51304,57220,10092,62553
8600000US62554,1013,561,452,69732,98281,20848,62554
8600000US62555,353,173,180,80083,77454,13753,62555
8600000US62556,271,131,140,65000,69300,18050,62556
8600000US62557,5492,2756,2736,51329,58043,5712,62557
8600000US62558,2545,1313,1232,69286,78185,5530,62558
8600000US62560,896,414,482,53816,66134,5489,62560
8600000US62561,3939,1804,2135,64077,76173,6986,62561
8600000US62563,4065,1932,2133,96851,115474,12326,62563
8600000US62565,5697,2709,2988,46795,55001,4124,62565
8600000US62567,815,415,400,62143,69476,7431,62567
8600000US62568,12962,6626,6336,48085,61897,4048,62568
8600000US62570,361,194,167,47813,62744,12562,62570
8600000US62571,1286,620,666,42431,55172,9672,62571
8600000US62572,412,190,222,51379,65911,14825,62572
8600000US62573,1393,630,763,65313,73209,7818,62573
8600000US62601,306,169,137,98750,105190,25058,62601
8600000US62610,101,51,50,38438,43587,12697,62610
8600000US62611,904,471,433,62257,81094,11685,62611
8600000US62612,1488,725,763,65244,76503,7114,62612
8600000US62613,2830,1370,1460,76573,92845,10559,62613
8600000US62615,4361,2088,2273,65227,82457,13129,62615
8600000US62617,534,251,283,40469,54181,10593,62617
8600000US62618,5562,2770,2792,44838,55083,4047,62618
8600000US62621,935,469,466,57083,66184,8086,62621
8600000US62622,42,20,22,,,,62622
8600000US62624,374,175,199,43393,59282,11265,62624
8600000US62625,680,329,351,98681,119707,29237,62625
8600000US62626,5915,2910,3005,57629,71263,6058,62626
8600000US62627,734,349,385,59474,78536,13413,62627
8600000US62628,590,301,289,47604,63590,9452,62628
8600000US62629,10011,4751,5260,87754,100128,6252,62629
8600000US62630,277,151,126,60938,73114,18141,62630
8600000US62631,228,132,96,39474,44093,7361,62631
8600000US62633,464,237,227,49191,58059,8712,62633
8600000US62634,599,293,306,65000,78875,9132,62634
8600000US62635,519,252,267,56827,70979,9510,62635
8600000US62638,1037,541,496,70341,97355,24382,62638
8600000US62639,241,121,120,58750,80841,24667,62639
8600000US62640,2832,1301,1531,55387,77374,7443,62640
8600000US62642,1105,591,514,63063,79612,13043,62642
8600000US62643,447,248,199,65625,73314,7232,62643
8600000US62644,3871,1877,1994,38139,52321,5493,62644
8600000US62649,405,200,205,77898,83635,16779,62649
8600000US62650,21727,10923,10804,46662,60905,3173,62650
8600000US62655,389,225,164,31014,43920,12853,62655
8600000US62656,16099,7567,8532,54834,69462,3700,62656
8600000US62661,1215,607,608,59737,72276,10126,62661
8600000US62663,211,106,105,43000,51953,12014,62663
8600000US62664,2485,1249,1236,42472,67425,8608,62664
8600000US62665,1067,526,541,43466,50378,4530,62665
8600000US62666,467,236,231,70114,71749,8211,62666
8600000US62667,357,182,175,55278,55751,9731,62667
8600000US62668,1055,485,570,52955,62243,9281,62668
8600000US62670,2045,955,1090,72000,81476,7700,62670
8600000US62671,398,175,223,67083,72265,7913,62671
8600000US62672,174,85,89,47321,49885,9789,62672
8600000US62673,346,159,187,67500,66751,9755,62673
8600000US62674,1147,573,574,48750,62285,7528,62674
8600000US62675,4847,2287,2560,67188,79535,5936,62675
8600000US62677,1795,843,952,66382,84172,9963,62677
8600000US62681,4441,2429,2012,45849,57475,5276,62681
8600000US62682,777,395,382,68534,77167,7766,62682
8600000US62684,4421,2058,2363,101989,109980,9003,62684
8600000US62685,1825,946,879,63811,77509,9327,62685
8600000US62688,477,232,245,62778,66912,10344,62688
8600000US62689,377,179,198,53333,60112,9737,62689
8600000US62690,2991,1468,1523,55132,66379,5905,62690
8600000US62691,1511,742,769,53889,71853,7471,62691
8600000US62692,1552,702,850,46979,63388,6883,62692
8600000US62693,1137,561,576,86875,100602,11999,62693
8600000US62694,2402,1150,1252,56275,73757,10203,62694
8600000US62695,175,83,92,43523,52082,9943,62695
8600000US62701,1173,776,397,22037,65870,17502,62701
8600000US62702,26510,12310,14200,39233,53179,3037,62702
8600000US62703,23401,10345,13056,38382,52518,2812,62703
8600000US62704,32348,15375,16973,54764,78579,3244,62704
8600000US62707,5721,2751,2970,69313,82356,5399,62707
8600000US62711,13237,6154,7083,105539,141211,8893,62711
8600000US62712,8017,3926,4091,92310,111645,7925,62712
8600000US62801,17089,8963,8126,41736,54046,2751,62801
8600000US62803,774,351,423,52227,65912,6831,62803
8600000US62806,2547,1227,1320,49831,62837,5469,62806
8600000US62807,566,278,288,50114,61539,11454,62807
8600000US62808,1063,567,496,52109,61945,7365,62808
8600000US62809,105,45,60,47679,70370,22008,62809
8600000US62810,586,269,317,50417,57947,5252,62810
8600000US62811,161,91,70,34375,40158,10692,62811
8600000US62812,8641,4100,4541,42652,61806,6633,62812
8600000US62814,1451,683,768,53125,61405,5584,62814
8600000US62815,228,114,114,62708,62748,10525,62815
8600000US62816,958,484,474,47614,59608,9216,62816
8600000US62817,412,172,240,55089,46239,9765,62817
8600000US62818,206,99,107,45833,55768,11092,62818
8600000US62819,340,166,174,30556,38505,7005,62819
8600000US62820,118,60,58,74250,84970,22359,62820
8600000US62821,5685,2781,2904,45434,57975,5093,62821
8600000US62822,2228,1052,1176,33561,46630,4929,62822
8600000US62823,1408,649,759,51554,62521,7497,62823
8600000US62824,1295,635,660,45846,53095,4603,62824
8600000US62825,162,84,78,45000,57586,15082,62825
8600000US62827,915,425,490,47321,54839,6357,62827
8600000US62828,922,424,498,56000,81940,23220,62828
8600000US62829,0,0,0,,,,62829
8600000US62830,1011,524,487,43864,66841,9572,62830
8600000US62831,338,172,166,51250,59039,12562,62831
8600000US62832,6976,3413,3563,43385,58502,6023,62832
8600000US62833,282,144,138,82344,90409,20971,62833
8600000US62835,753,358,395,38750,57494,12260,62835
8600000US62836,564,284,280,67344,79711,11216,62836
8600000US62837,7008,3516,3492,49788,60956,3574,62837
8600000US62838,1392,696,696,47738,54958,5432,62838
8600000US62839,4911,2223,2688,47827,62394,6848,62839
8600000US62841,88,42,46,47000,56882,17490,62841
8600000US62842,570,261,309,44306,52966,5767,62842
8600000US62843,102,55,47,45000,47520,15624,62843
8600000US62844,1635,792,843,52404,62229,7833,62844
8600000US62846,2533,2310,223,36719,56532,18743,62846
8600000US62848,545,257,288,61625,62609,8368,62848
8600000US62849,1633,863,770,59875,67632,4973,62849
8600000US62850,262,120,142,66607,64037,11288,62850
8600000US62851,114,57,57,60625,60096,22175,62851
8600000US62852,59,28,31,66875,66166,23417,62852
8600000US62853,775,429,346,57788,67355,7788,62853
8600000US62854,1251,637,614,51983,60465,7128,62854
8600000US62856,302,140,162,43672,54385,12394,62856
8600000US62858,2253,1165,1088,55175,61247,6110,62858
8600000US62859,4627,2274,2353,55556,65091,5769,62859
8600000US62860,459,224,235,58450,57685,7696,62860
8600000US62861,138,76,62,35536,43973,15156,62861
8600000US62862,278,123,155,52250,59121,10624,62862
8600000US62863,7747,3717,4030,50372,62797,5196,62863
8600000US62864,18296,8618,9678,44120,64236,3275,62864
8600000US62865,1491,772,719,52773,64050,8995,62865
8600000US62867,437,209,228,43281,53218,7610,62867
8600000US62868,1280,630,650,58831,81678,15482,62868
8600000US62869,1999,962,1037,58393,67076,10779,62869
8600000US62870,1631,782,849,49083,66150,11973,62870
8600000US62871,467,238,229,46442,55336,9591,62871
8600000US62872,826,431,395,58333,66462,8379,62872
8600000US62874,353,202,151,30625,38447,6588,62874
8600000US62875,1000,527,473,63681,72414,7629,62875
8600000US62876,138,59,79,43214,54294,8865,62876
8600000US62877,463,225,238,61667,71474,10603,62877
8600000US62878,297,145,152,50700,56904,12099,62878
8600000US62879,87,54,33,31750,37377,11725,62879
8600000US62880,520,290,230,43393,54078,11683,62880
8600000US62881,8342,4023,4319,46801,61123,3694,62881
8600000US62882,1765,902,863,41944,53917,5392,62882
8600000US62883,610,315,295,66136,73143,17009,62883
8600000US62884,2206,1101,1105,52708,56843,5649,62884
8600000US62885,606,265,341,,70841,25454,62885
8600000US62886,220,105,115,68750,69746,13818,62886
8600000US62887,313,187,126,52465,67101,11369,62887
8600000US62888,1596,817,779,55125,61883,5940,62888
8600000US62889,697,337,360,60500,65773,8859,62889
8600000US62890,2220,1135,1085,57934,60251,5989,62890
8600000US62891,423,208,215,55625,70777,17500,62891
8600000US62892,314,153,161,65703,70567,17826,62892
8600000US62893,818,395,423,64000,67931,8820,62893
8600000US62894,778,365,413,61250,73797,7641,62894
8600000US62895,1531,755,776,48047,53925,5429,62895
8600000US62896,9537,4488,5049,37052,47345,2936,62896
8600000US62897,295,150,145,61250,63549,9974,62897
8600000US62898,1664,835,829,68258,78096,8155,62898
8600000US62899,1344,732,612,44375,64755,16637,62899
8600000US62901,22492,11665,10827,24646,49266,5149,62901
8600000US62902,3753,1851,1902,54216,69528,6956,62902
8600000US62903,2516,1195,1321,43293,71000,10400,62903
8600000US62905,454,215,239,73203,68560,12843,62905
8600000US62906,5338,2592,2746,46667,60322,7713,62906
8600000US62907,1472,639,833,44617,64422,15672,62907
8600000US62908,378,197,181,65682,68710,12613,62908
8600000US62910,1984,943,1041,35893,56521,13755,62910
8600000US62912,994,477,517,41458,75163,31492,62912
8600000US62914,2028,957,1071,25975,41104,8092,62914
8600000US62915,270,119,151,48333,55967,14225,62915
8600000US62916,773,403,370,71579,82856,24090,62916
8600000US62917,1792,830,962,34583,44353,8770,62917
8600000US62918,7600,3489,4111,51884,68276,5687,62918
8600000US62919,874,498,376,61579,105988,53524,62919
8600000US62920,2725,1407,1318,47557,59349,5061,62920
8600000US62921,294,128,166,,36050,15803,62921
8600000US62922,2030,1030,1000,64777,77261,9820,62922
8600000US62923,312,130,182,53393,58015,7811,62923
8600000US62924,2217,1110,1107,50290,62122,7269,62924
8600000US62926,1642,832,810,50602,63536,6883,62926
8600000US62927,287,149,138,33846,41021,7036,62927
8600000US62928,164,90,74,16023,28332,11560,62928
8600000US62930,4837,2354,2483,40188,55947,5101,62930
8600000US62931,1184,578,606,39432,48549,5983,62931
8600000US62932,1154,546,608,37946,47751,5397,62932
8600000US62933,1228,482,746,51087,64978,11822,62933
8600000US62934,764,357,407,42938,49046,7845,62934
8600000US62935,1479,784,695,50774,74321,13003,62935
8600000US62938,2649,1432,1217,37250,53047,6478,62938
8600000US62939,2481,1076,1405,63355,79604,18702,62939
8600000US62940,246,117,129,50972,50545,11845,62940
8600000US62941,719,305,414,54844,60911,9133,62941
8600000US62942,489,248,241,36806,39578,5224,62942
8600000US62943,326,160,166,61786,85232,30769,62943
8600000US62946,9911,4750,5161,41756,55632,4191,62946
8600000US62947,411,228,183,41750,61911,15172,62947
8600000US62948,10237,4814,5423,42575,58333,4454,62948
8600000US62949,675,349,326,35515,44925,6178,62949
8600000US62950,147,61,86,,64438,31789,62950
8600000US62951,3487,1668,1819,38363,51143,6691,62951
8600000US62952,2552,1219,1333,52712,61325,5382,62952
8600000US62953,218,111,107,25455,36527,10158,62953
8600000US62954,382,178,204,52167,64891,21538,62954
8600000US62956,614,266,348,46417,62331,17605,62956
8600000US62957,637,309,328,35000,41389,6953,62957
8600000US62958,1738,947,791,65387,81017,8659,62958
8600000US62959,22303,11586,10717,51532,68215,4383,62959
8600000US62960,8501,3978,4523,42731,55545,3233,62960
8600000US62961,45,14,31,,63500,32308,62961
8600000US62962,9,5,4,,,,62962
8600000US62963,511,274,237,33929,38659,6772,62963
8600000US62964,999,512,487,30000,40961,6034,62964
8600000US62965,77,30,47,28958,31916,13801,62965
8600000US62966,12017,5674,6343,43865,65608,7717,62966
8600000US62967,198,88,110,42250,48133,10574,62967
8600000US62969,324,129,195,48162,53531,12886,62969
8600000US62970,620,341,279,40714,57359,10861,62970
8600000US62972,846,403,443,51925,68581,13977,62972
8600000US62974,1223,649,574,45996,58886,8692,62974
8600000US62975,268,171,97,30750,35505,15064,62975
8600000US62976,308,105,203,35750,39838,8754,62976
8600000US62977,490,231,259,49688,65208,12763,62977
8600000US62979,918,489,429,51719,58930,7271,62979
8600000US62982,743,309,434,30000,48214,10897,62982
8600000US62983,1144,565,579,46563,59292,8193,62983
8600000US62984,1177,502,675,34712,59463,12513,62984
8600000US62985,539,271,268,49167,59852,7963,62985
8600000US62987,1103,540,563,37250,50207,6861,62987
8600000US62988,1358,641,717,46731,54049,7427,62988
8600000US62990,519,274,245,36875,50883,10193,62990
8600000US62992,556,291,265,25000,48224,20167,62992
8600000US62994,476,215,261,55208,68293,10811,62994
8600000US62995,5006,3458,1548,45679,57097,5822,62995
8600000US62996,382,165,217,34063,43633,10325,62996
8600000US62997,418,226,192,56607,53789,7214,62997
8600000US62998,245,123,122,,66937,21910,62998
8600000US62999,1311,611,700,43672,48239,4005,62999
8600000US63005,13075,6542,6533,158832,219234,15577,63005
8600000US63010,28327,13831,14496,64919,74920,2649,63010
8600000US63011,29218,13849,15369,99025,126852,6452,63011
8600000US63012,7852,4014,3838,77489,87478,7418,63012
8600000US63013,1374,774,600,47589,67478,13244,63013
8600000US63014,698,363,335,45994,57158,11584,63014
8600000US63015,1790,900,890,43788,79389,26618,63015
8600000US63016,6064,3021,3043,62457,76345,10482,63016
8600000US63017,33082,15540,17542,106261,143424,6897,63017
8600000US63019,3348,1612,1736,51076,62201,5773,63019
8600000US63020,15421,7505,7916,50338,60798,3507,63020
8600000US63021,43288,20013,23275,87551,113112,4793,63021
8600000US63023,4402,2146,2256,53523,71761,16642,63023
8600000US63025,10624,5280,5344,105812,119067,7382,63025
8600000US63026,32590,15923,16667,76935,93167,3675,63026
8600000US63028,20838,10267,10571,60131,74715,4457,63028
8600000US63030,224,99,125,63068,65523,12574,63030
8600000US63031,35276,15964,19312,60301,70920,2134,63031
8600000US63033,32262,13450,18812,54133,66615,3925,63033
8600000US63034,14585,6728,7857,91109,97571,5414,63034
8600000US63036,733,378,355,37422,56880,14235,63036
8600000US63037,2312,1137,1175,59250,75656,12576,63037
8600000US63038,5405,2647,2758,130530,173957,18507,63038
8600000US63039,489,174,315,57583,60459,13601,63039
8600000US63040,5945,2763,3182,111204,134431,10443,63040
8600000US63041,463,250,213,88750,98184,27979,63041
8600000US63042,15386,7355,8031,47222,64815,6186,63042
8600000US63043,18402,9104,9298,68556,81925,5612,63043
8600000US63044,8246,3825,4421,61061,75660,4717,63044
8600000US63045,0,0,0,,,,63045
8600000US63047,69,69,0,,,,63047
8600000US63048,2885,1324,1561,64289,72507,7737,63048
8600000US63049,13120,6294,6826,70062,80434,4237,63049
8600000US63050,12441,6404,6037,64622,78356,5352,63050
8600000US63051,10753,5353,5400,61328,73721,4181,63051
8600000US63052,19899,9711,10188,70389,81874,5456,63052
8600000US63053,35,19,16,41875,49235,20364,63053
8600000US63055,2188,1144,1044,73342,86409,15775,63055
8600000US63056,1506,809,697,37586,56282,8165,63056
8600000US63057,52,52,0,,,,63057
8600000US63060,1512,766,746,52883,57519,7749,63060
8600000US63061,141,91,50,132823,101619,38850,63061
8600000US63068,3609,1760,1849,54679,67658,7064,63068
8600000US63069,11863,6146,5717,64512,82037,5470,63069
8600000US63070,6072,2816,3256,58485,65695,8310,63070
8600000US63071,887,451,436,28365,42188,10418,63071
8600000US63072,2583,1211,1372,55363,67010,9143,63072
8600000US63073,735,350,385,217607,209486,83035,63073
8600000US63074,11354,5290,6064,45663,56895,9642,63074
8600000US63077,8623,4175,4448,46494,55791,4114,63077
8600000US63079,24,24,0,,,,63079
8600000US63080,10470,5341,5129,43511,58195,3520,63080
8600000US63084,14250,6875,7375,55911,71521,6631,63084
8600000US63087,644,322,322,53788,48746,11980,63087
8600000US63088,6873,3356,3517,58284,82298,10077,63088
8600000US63089,4105,2086,2019,54319,70249,8109,63089
8600000US63090,17097,8426,8671,68319,89558,6838,63090
8600000US63091,1119,552,567,64167,71695,9910,63091
8600000US63101,2863,1591,1272,56403,74613,10689,63101
8600000US63102,2130,1489,641,55053,55309,7975,63102
8600000US63103,7785,4250,3535,40247,56491,4671,63103
8600000US63104,15874,7679,8195,53645,73194,4667,63104
8600000US63105,15625,7795,7830,102180,180789,18438,63105
8600000US63106,7146,2479,4667,17792,33163,5138,63106
8600000US63107,7292,3266,4026,23911,34554,3155,63107
8600000US63108,19017,9565,9452,46009,87783,7403,63108
8600000US63109,22258,9969,12289,57946,76242,3673,63109
8600000US63110,15264,6993,8271,55414,76427,4762,63110
8600000US63111,15998,7670,8328,27019,42019,3462,63111
8600000US63112,15132,6932,8200,37970,56691,3476,63112
8600000US63113,9136,4324,4812,28180,43153,5669,63113
8600000US63114,27670,13398,14272,43890,54904,3039,63114
8600000US63115,13972,5788,8184,23951,33194,2356,63115
8600000US63116,35135,17492,17643,45871,59698,2708,63116
8600000US63117,7487,3685,3802,76935,112023,7530,63117
8600000US63118,20447,10006,10441,35580,52236,2779,63118
8600000US63119,26301,11880,14421,82462,109332,4532,63119
8600000US63120,6420,3256,3164,24826,34168,3444,63120
8600000US63121,19502,8474,11028,37866,47757,2172,63121
8600000US63122,29115,13265,15850,99341,128628,4833,63122
8600000US63123,42118,19832,22286,57215,70060,2101,63123
8600000US63124,8564,3980,4584,152589,259885,35543,63124
8600000US63125,26615,12849,13766,52145,61554,2859,63125
8600000US63126,11563,5606,5957,75331,89928,4936,63126
8600000US63127,3841,1722,2119,92670,136782,13868,63127
8600000US63128,24551,11586,12965,74682,94630,5063,63128
8600000US63129,43620,20945,22675,72822,90808,2671,63129
8600000US63130,23767,10916,12851,64097,104376,7116,63130
8600000US63131,13383,6557,6826,154046,220376,15383,63131
8600000US63132,9892,4457,5435,59029,98491,7939,63132
8600000US63133,5394,2142,3252,22346,32034,3902,63133
8600000US63134,9798,4706,5092,39639,45003,2499,63134
8600000US63135,16037,7106,8931,44959,57125,4558,63135
8600000US63136,33126,13488,19638,32224,42929,2204,63136
8600000US63137,15010,6288,8722,40462,52032,5742,63137
8600000US63138,13115,5738,7377,38682,55327,5707,63138
8600000US63139,18932,9349,9583,54362,75392,4501,63139
8600000US63140,216,100,116,23000,26305,6285,63140
8600000US63141,16502,7674,8828,111774,183864,14724,63141
8600000US63143,7806,3675,4131,45980,59870,4513,63143
8600000US63144,7140,3463,3677,80000,110432,13061,63144
8600000US63146,25200,11743,13457,67591,91342,5544,63146
8600000US63147,7625,3611,4014,30177,39172,5941,63147
8600000US63155,0,0,0,,,,63155
8600000US63301,41772,19701,22071,59406,74350,2734,63301
8600000US63303,38294,18567,19727,77549,94913,3024,63303
8600000US63304,31582,15432,16150,95261,115825,4270,63304
8600000US63330,112,63,49,42054,52965,13992,63330
8600000US63332,1033,537,496,69541,93908,16395,63332
8600000US63333,599,316,283,44231,84507,33638,63333
8600000US63334,7153,4532,2621,49926,65652,9893,63334
8600000US63336,1059,524,535,49479,73919,14241,63336
8600000US63339,643,283,360,39125,57238,10610,63339
8600000US63341,3000,1450,1550,102872,129185,20513,63341
8600000US63343,3301,1648,1653,45679,55177,6084,63343
8600000US63344,1069,544,525,51929,68522,7203,63344
8600000US63345,406,197,209,55340,50779,6509,63345
8600000US63347,2037,1044,993,63381,69504,13420,63347
8600000US63348,5554,2818,2736,94338,110999,10245,63348
8600000US63349,1639,863,776,58355,79120,17466,63349
8600000US63350,413,208,205,45938,52161,6951,63350
8600000US63351,1557,843,714,48500,64766,14624,63351
8600000US63352,931,488,443,40530,47515,5361,63352
8600000US63353,3483,1733,1750,42952,53050,4884,63353
8600000US63357,4161,2028,2133,62972,70433,7704,63357
8600000US63359,1103,546,557,54063,67368,7953,63359
8600000US63361,3258,1589,1669,42530,52851,4094,63361
8600000US63362,5387,2605,2782,64390,71869,7191,63362
8600000US63363,1395,715,680,41054,48215,3774,63363
8600000US63366,37427,18605,18822,75255,93610,4433,63366
8600000US63367,17674,8963,8711,95576,114264,5552,63367
8600000US63368,33386,16205,17181,98202,114911,4455,63368
8600000US63369,1420,662,758,73397,78829,11949,63369
8600000US63370,13,5,8,,,,63370
8600000US63373,440,233,207,71250,76350,8126,63373
8600000US63376,57222,27296,29926,79930,94533,3581,63376
8600000US63377,1794,865,929,54634,69206,10498,63377
8600000US63379,18719,9082,9637,65541,73699,3833,63379
8600000US63381,475,261,214,47386,58227,17872,63381
8600000US63382,4237,1181,3056,42266,63378,21762,63382
8600000US63383,12537,5908,6629,49287,64225,4953,63383
8600000US63384,1278,606,672,43050,50083,5071,63384
8600000US63385,30453,14926,15527,86149,101007,5246,63385
8600000US63386,347,203,144,42917,64774,11800,63386
8600000US63387,49,26,23,22361,42248,23228,63387
8600000US63388,577,289,288,37500,46947,13761,63388
8600000US63389,5143,2485,2658,54240,65763,7001,63389
8600000US63390,8037,4053,3984,62164,81785,10522,63390
8600000US63401,16906,8109,8797,44769,58313,3150,63401
8600000US63430,459,245,214,36875,65412,13538,63430
8600000US63431,226,131,95,40455,46519,14768,63431
8600000US63432,362,159,203,42750,68402,28549,63432
8600000US63433,21,10,11,,,,63433
8600000US63434,544,250,294,57500,69506,10410,63434
8600000US63435,3380,1658,1722,41620,58820,6394,63435
8600000US63436,1183,624,559,50588,71112,31915,63436
8600000US63437,1115,558,557,38056,45530,4165,63437
8600000US63438,381,211,170,57679,75503,20002,63438
8600000US63439,62,35,27,41250,45933,11396,63439
8600000US63440,787,363,424,48854,61881,14279,63440
8600000US63441,813,379,434,44531,55505,7336,63441
8600000US63443,254,137,117,51250,44655,8043,63443
8600000US63445,2663,1334,1329,46351,61100,8384,63445
8600000US63446,402,215,187,39792,47461,10357,63446
8600000US63447,964,515,449,39390,53513,7032,63447
8600000US63448,1101,498,603,50750,59052,7682,63448
8600000US63450,69,31,38,,61535,19158,63450
8600000US63451,167,82,85,58125,109009,30268,63451
8600000US63452,984,505,479,46250,56944,7643,63452
8600000US63453,411,206,205,69563,68299,10204,63453
8600000US63454,640,338,302,49444,59709,8739,63454
8600000US63456,3251,1555,1696,43542,52842,4166,63456
8600000US63457,258,128,130,75313,90308,25393,63457
8600000US63458,91,45,46,29545,36296,10131,63458
8600000US63459,3198,1581,1617,63174,69320,5240,63459
8600000US63460,351,185,166,56250,57134,7583,63460
8600000US63461,4274,2032,2242,54289,62071,4159,63461
8600000US63462,1170,567,603,40938,45592,5180,63462
8600000US63463,531,271,260,56118,63884,9382,63463
8600000US63464,13,7,6,,,,63464
8600000US63465,282,137,145,52500,113272,78559,63465
8600000US63467,15,7,8,,,,63467
8600000US63468,1858,928,930,43512,52480,5653,63468
8600000US63469,882,459,423,61797,68196,7695,63469
8600000US63471,450,196,254,59511,61306,20356,63471
8600000US63472,519,275,244,50000,50613,8412,63472
8600000US63473,199,106,93,67841,67741,10753,63473
8600000US63474,316,167,149,35625,64296,29258,63474
8600000US63501,17680,8295,9385,38152,55363,5270,63501
8600000US63530,863,421,442,38611,46765,5255,63530
8600000US63531,259,131,128,60000,63120,18639,63531
8600000US63532,1107,513,594,40815,49632,5670,63532
8600000US63533,542,264,278,48654,58278,8122,63533
8600000US63534,589,282,307,39286,46172,5150,63534
8600000US63535,92,36,56,52917,74671,50862,63535
8600000US63536,778,354,424,44258,74557,25499,63536
8600000US63537,1466,668,798,37400,49688,5534,63537
8600000US63538,292,155,137,37500,55932,14805,63538
8600000US63539,156,86,70,46875,51531,11172,63539
8600000US63540,93,40,53,51250,81086,31065,63540
8600000US63541,259,140,119,40417,45384,9883,63541
8600000US63543,217,106,111,31071,35058,5352,63543
8600000US63544,541,253,288,37833,44953,6201,63544
8600000US63545,704,351,353,45625,52921,6058,63545
8600000US63546,1462,743,719,45893,58241,8717,63546
8600000US63547,347,210,137,40147,43755,7839,63547
8600000US63548,909,465,444,38450,51871,10577,63548
8600000US63549,1857,871,986,42206,53884,5848,63549
8600000US63551,209,96,113,30521,47123,19840,63551
8600000US63552,5721,2854,2867,40161,51931,3481,63552
8600000US63555,2349,1105,1244,43800,57700,8541,63555
8600000US63556,3116,1501,1615,45417,55963,7113,63556
8600000US63557,179,86,93,39659,52271,10230,63557
8600000US63558,574,285,289,47667,54983,7082,63558
8600000US63559,1201,619,582,43542,52436,6219,63559
8600000US63560,164,122,42,,37876,12373,63560
8600000US63561,850,380,470,36250,51316,11537,63561
8600000US63563,553,321,232,51776,91414,46221,63563
8600000US63565,2806,1359,1447,36894,48788,4807,63565
8600000US63566,71,35,36,49375,43292,9373,63566
8600000US63567,149,87,62,27059,32682,9873,63567
8600000US63601,11341,5568,5773,36415,47586,3915,63601
8600000US63620,1054,503,551,35293,49256,10065,63620
8600000US63621,812,360,452,37174,52105,10769,63621
8600000US63622,744,433,311,38188,58199,34530,63622
8600000US63623,731,388,343,34952,48775,8491,63623
8600000US63624,2858,1432,1426,39745,54830,10723,63624
8600000US63625,351,185,166,51635,73287,30672,63625
8600000US63626,1131,682,449,59474,66014,17576,63626
8600000US63627,2626,1345,1281,60822,66910,9693,63627
8600000US63628,12966,7556,5410,49568,61729,6879,63628
8600000US63629,1104,561,543,45150,58912,11535,63629
8600000US63630,2964,1388,1576,35378,42210,6146,63630
8600000US63631,997,482,515,59911,60355,7774,63631
8600000US63633,437,235,202,41875,49258,8276,63633
8600000US63636,486,213,273,38421,41232,6823,63636
8600000US63637,1181,739,442,26220,48885,20058,63637
8600000US63638,2059,1003,1056,39620,48374,6027,63638
8600000US63640,23448,13117,10331,53088,66442,3993,63640
8600000US63645,8809,4318,4491,42370,53914,4059,63645
8600000US63648,910,422,488,61250,66561,15866,63648
8600000US63650,3296,1672,1624,39083,51713,5481,63650
8600000US63653,973,500,473,32375,38858,5120,63653
8600000US63654,579,288,291,62188,73020,11357,63654
8600000US63655,1262,618,644,40379,50613,8147,63655
8600000US63656,322,173,149,53419,55685,11917,63656
8600000US63660,3096,1936,1160,36818,47599,7140,63660
8600000US63662,1362,647,715,42422,57983,15999,63662
8600000US63663,535,253,282,31538,45572,10582,63663
8600000US63664,6771,3273,3498,40087,49706,4988,63664
8600000US63665,240,109,131,31971,53169,22147,63665
8600000US63666,59,34,25,,43009,24422,63666
8600000US63670,8774,4416,4358,55405,70249,5279,63670
8600000US63673,1380,684,696,47803,63503,9198,63673
8600000US63674,76,0,76,,,,63674
8600000US63675,194,96,98,31654,37251,9286,63675
8600000US63701,30834,14979,15855,53745,73019,5613,63701
8600000US63703,6780,2897,3883,28721,39014,4589,63703
8600000US63730,2492,1222,1270,45893,61073,12604,63730
8600000US63732,871,450,421,59457,64866,7303,63732
8600000US63735,573,305,268,38750,50109,8343,63735
8600000US63736,2883,1432,1451,47228,56028,5291,63736
8600000US63738,31,31,0,,,,63738
8600000US63739,335,146,189,54219,52620,10021,63739
8600000US63740,3811,1861,1950,46574,63828,9797,63740
8600000US63742,56,30,26,,57496,26359,63742
8600000US63743,58,28,30,,103314,42262,63743
8600000US63744,68,26,42,44286,44268,16802,63744
8600000US63745,21,10,11,37500,41470,13279,63745
8600000US63746,34,12,22,63958,60312,39169,63746
8600000US63747,365,206,159,61724,65400,11339,63747
8600000US63748,771,384,387,53819,62083,6724,63748
8600000US63750,5,0,5,,,,63750
8600000US63751,1091,561,530,39352,46110,7678,63751
8600000US63755,19032,9055,9977,59861,74440,5451,63755
8600000US63758,111,61,50,44219,47790,13298,63758
8600000US63760,431,195,236,62868,70487,19045,63760
8600000US63763,124,67,57,,66338,40218,63763
8600000US63764,4210,2091,2119,39286,48447,4767,63764
8600000US63766,769,379,390,48088,54919,10153,63766
8600000US63767,603,319,284,35938,50277,9028,63767
8600000US63769,1058,523,535,57500,67227,10067,63769
8600000US63770,94,50,44,36667,40969,7113,63770
8600000US63771,2282,1178,1104,44714,54625,4377,63771
8600000US63774,56,20,36,37250,41403,11314,63774
8600000US63775,12846,6323,6523,54740,61618,2688,63775
8600000US63780,4877,2314,2563,47708,60439,8378,63780
8600000US63781,931,499,432,66570,71730,12848,63781
8600000US63782,286,163,123,33224,46468,14289,63782
8600000US63783,101,47,54,93409,117693,46312,63783
8600000US63784,179,88,91,36250,73424,43456,63784
8600000US63785,735,370,365,45833,53674,7946,63785
8600000US63787,634,309,325,47167,50719,6768,63787
8600000US63801,17437,7947,9490,40946,56164,3877,63801
8600000US63820,97,36,61,23125,34291,17095,63820
8600000US63821,598,312,286,19554,37564,13594,63821
8600000US63822,2053,972,1081,38836,50685,5984,63822
8600000US63823,986,465,521,36221,53162,10347,63823
8600000US63824,105,54,51,25000,35248,12240,63824
8600000US63825,3385,1748,1637,40779,54505,7193,63825
8600000US63826,38,5,33,,62823,80202,63826
8600000US63827,639,325,314,44000,54977,7284,63827
8600000US63828,146,93,53,39167,50798,13763,63828
8600000US63829,946,441,505,35655,52201,20356,63829
8600000US63830,5320,2484,2836,30979,43278,3523,63830
8600000US63833,168,75,93,,50113,21162,63833
8600000US63834,5539,3458,2081,33457,52825,8707,63834
8600000US63837,1042,520,522,29970,42114,7691,63837
8600000US63839,315,168,147,41618,49740,9826,63839
8600000US63841,10408,4825,5583,40734,52770,4164,63841
8600000US63845,4100,1883,2217,32614,45881,4247,63845
8600000US63846,1336,582,754,36420,44320,6237,63846
8600000US63847,138,56,82,23913,27623,9553,63847
8600000US63848,1276,603,673,33505,43280,5844,63848
8600000US63849,100,46,54,37083,50283,14361,63849
8600000US63851,2596,1056,1540,27090,47398,13019,63851
8600000US63852,749,320,429,33393,44336,5704,63852
8600000US63853,166,83,83,28958,39185,9652,63853
8600000US63855,792,384,408,42750,68906,21671,63855
8600000US63857,9471,4438,5033,36831,51215,5981,63857
8600000US63860,147,69,78,16354,23317,7995,63860
8600000US63862,1232,549,683,27564,35795,5638,63862
8600000US63863,4527,1963,2564,32484,45555,5165,63863
8600000US63866,213,70,143,22422,29600,7712,63866
8600000US63867,766,382,384,32396,50727,11652,63867
8600000US63868,537,224,313,26957,32679,5708,63868
8600000US63869,2732,1284,1448,38990,53031,7951,63869
8600000US63870,707,393,314,26016,45193,12685,63870
8600000US63873,3483,1674,1809,36806,49605,5133,63873
8600000US63874,293,139,154,41250,52652,10648,63874
8600000US63876,1691,810,881,39094,46634,5717,63876
8600000US63877,2657,1202,1455,39375,59141,7737,63877
8600000US63878,65,35,30,41250,38482,8978,63878
8600000US63879,463,223,240,35625,51989,12734,63879
8600000US63880,96,47,49,,27303,11722,63880
8600000US63882,285,128,157,40625,39492,7827,63882
8600000US63901,26476,12410,14066,37622,53568,3697,63901
8600000US63902,0,0,0,,,,63902
8600000US63932,1050,594,456,35380,44938,11307,63932
8600000US63933,2585,1290,1295,33450,43141,7531,63933
8600000US63934,195,83,112,60809,40909,21099,63934
8600000US63935,7568,3635,3933,36010,44845,3729,63935
8600000US63936,708,376,332,40739,59171,15960,63936
8600000US63937,1937,925,1012,35022,52224,8492,63937
8600000US63939,1217,671,546,26278,38615,7038,63939
8600000US63940,1057,536,521,51042,60379,13809,63940
8600000US63941,167,71,96,37604,52324,34873,63941
8600000US63942,543,292,251,32500,41891,8079,63942
8600000US63943,406,213,193,36250,53769,18909,63943
8600000US63944,1334,722,612,29964,41349,7623,63944
8600000US63945,1083,594,489,45699,70639,30122,63945
8600000US63951,144,93,51,11500,18168,11138,63951
8600000US63952,283,150,133,,58641,25856,63952
8600000US63953,1258,621,637,30660,40818,5915,63953
8600000US63954,480,228,252,29231,38570,8054,63954
8600000US63955,150,73,77,28125,29774,7280,63955
8600000US63956,1015,541,474,52632,55300,13558,63956
8600000US63957,4636,2111,2525,31738,43495,6370,63957
8600000US63960,2154,1046,1108,46086,57212,7052,63960
8600000US63961,1266,627,639,49000,57886,9120,63961
8600000US63962,208,112,96,,,,63962
8600000US63964,373,125,248,23611,28724,9032,63964
8600000US63965,2474,1242,1232,44873,57188,6932,63965
8600000US63966,1965,1032,933,40595,43992,6060,63966
8600000US63967,1513,824,689,39931,46565,6336,63967
8600000US64001,476,229,247,49583,69530,12809,64001
8600000US64011,2517,1237,1280,61652,73849,9503,64011
8600000US64012,20499,9775,10724,64489,78357,4680,64012
8600000US64014,17995,8761,9234,73517,86557,5908,64014
8600000US64015,22843,10803,12040,69549,84901,3777,64015
8600000US64016,3586,1760,1826,66771,77262,7151,64016
8600000US64017,388,191,197,82656,66806,11836,64017
8600000US64018,720,345,375,93750,105887,26573,64018
8600000US64019,2182,1180,1002,68819,75231,10086,64019
8600000US64020,2934,1336,1598,60069,75067,10531,64020
8600000US64021,429,189,240,45769,60441,26365,64021
8600000US64022,108,56,52,45938,57127,17361,64022
8600000US64024,12843,6204,6639,55805,65050,4218,64024
8600000US64029,12725,6141,6584,75288,84303,5367,64029
8600000US64030,18540,8850,9690,44971,57191,3083,64030
8600000US64034,6357,3105,3252,100076,114796,8580,64034
8600000US64035,791,393,398,55417,65985,12055,64035
8600000US64036,266,147,119,41250,51723,13887,64036
8600000US64037,4502,2301,2201,55191,65111,8643,64037
8600000US64040,5020,2429,2591,53555,59809,4443,64040
8600000US64048,3351,1771,1580,73640,98673,23229,64048
8600000US64050,17380,8317,9063,37407,45922,2501,64050
8600000US64052,15901,7673,8228,43965,51490,3052,64052
8600000US64053,4002,1803,2199,30724,50498,16059,64053
8600000US64054,2636,1276,1360,40867,51312,7548,64054
8600000US64055,27467,12401,15066,50852,74932,6407,64055
8600000US64056,11619,5271,6348,57813,67286,5201,64056
8600000US64057,11524,5399,6125,61509,74945,4382,64057
8600000US64058,5131,2508,2623,63735,70824,5432,64058
8600000US64060,10407,5034,5373,83152,94809,8051,64060
8600000US64061,2414,1219,1195,68132,81340,8565,64061
8600000US64062,4492,2244,2248,69323,83493,7212,64062
8600000US64063,15219,6838,8381,63896,78891,4918,64063
8600000US64064,13196,6285,6911,99525,129372,9046,64064
8600000US64065,39,10,29,47500,45000,10647,64065
8600000US64066,27,12,15,83125,92408,49979,64066
8600000US64067,4388,2077,2311,49506,64601,10776,64067
8600000US64068,29329,13964,15365,71598,89752,6812,64068
8600000US64070,2671,1330,1341,77656,87651,8236,64070
8600000US64071,497,239,258,64375,70813,16467,64071
8600000US64072,431,235,196,48000,47459,6348,64072
8600000US64074,575,331,244,64643,84048,18676,64074
8600000US64075,8880,4327,4553,68431,77702,4888,64075
8600000US64076,6887,3355,3532,53942,67834,7103,64076
8600000US64077,1286,640,646,67837,71690,7758,64077
8600000US64078,7661,3837,3824,66824,81642,5060,64078
8600000US64079,10438,5104,5334,86053,97116,5253,64079
8600000US64080,9468,4696,4772,75645,89810,4508,64080
8600000US64081,17864,8251,9613,85077,104345,6213,64081
8600000US64082,11417,5557,5860,113174,123062,6890,64082
8600000US64083,17061,8002,9059,79126,90622,3899,64083
8600000US64084,1247,632,615,57300,70543,14725,64084
8600000US64085,6363,3018,3345,48790,61594,6293,64085
8600000US64086,16745,8190,8555,85259,100279,4953,64086
8600000US64088,1102,598,504,61420,75663,11362,64088
8600000US64089,9603,4582,5021,81909,103888,7929,64089
8600000US64090,77,44,33,41875,49188,12603,64090
8600000US64092,30,17,13,,,,64092
8600000US64093,22298,11190,11108,50327,61002,3754,64093
8600000US64096,850,395,455,49875,66667,6442,64096
8600000US64097,987,495,492,51667,62418,9029,64097
8600000US64098,2417,1193,1224,66591,78891,8024,64098
8600000US64101,278,271,7,,,,64101
8600000US64102,0,0,0,,,,64102
8600000US64105,4548,2564,1984,59474,68991,6367,64105
8600000US64106,7022,3945,3077,31140,52620,4559,64106
8600000US64108,6942,3590,3352,49500,71516,6157,64108
8600000US64109,8118,4096,4022,32131,49180,3385,64109
8600000US64110,14214,6979,7235,42550,67419,5216,64110
8600000US64111,16040,8640,7400,48105,60825,3523,64111
8600000US64112,7684,3715,3969,74864,136006,14715,64112
8600000US64113,9214,4596,4618,136913,178930,11129,64113
8600000US64114,20974,10152,10822,63694,77691,3366,64114
8600000US64116,13050,6422,6628,49352,75325,9727,64116
8600000US64117,10988,5404,5584,46514,54929,3481,64117
8600000US64118,33201,16273,16928,55690,66675,2913,64118
8600000US64119,22137,10475,11662,68841,81365,3494,64119
8600000US64120,258,133,125,34417,52365,21212,64120
8600000US64123,6525,3334,3191,35290,43149,3812,64123
8600000US64124,7748,4035,3713,26512,37184,3618,64124
8600000US64125,1023,545,478,22328,32228,5473,64125
8600000US64126,3889,1728,2161,20699,29077,3797,64126
8600000US64127,11025,4909,6116,25472,38833,4522,64127
8600000US64128,8313,3796,4517,24421,34155,2753,64128
8600000US64129,6721,3034,3687,39396,48325,5240,64129
8600000US64130,15168,6732,8436,31166,48790,8151,64130
8600000US64131,18237,8367,9870,45688,64728,4790,64131
8600000US64132,10562,4590,5972,36074,45703,4811,64132
8600000US64133,27571,13000,14571,50681,62094,3750,64133
8600000US64134,16565,7289,9276,41543,51027,2817,64134
8600000US64136,1795,795,1000,36538,72358,25374,64136
8600000US64137,8227,3744,4483,47324,57159,3976,64137
8600000US64138,19683,9239,10444,46915,59443,3655,64138
8600000US64139,1528,724,804,113553,135654,29742,64139
8600000US64145,4412,1985,2427,71611,104391,13100,64145
8600000US64146,1092,477,615,60667,77449,14330,64146
8600000US64147,308,96,212,7622,9728,3880,64147
8600000US64149,271,125,146,116719,109679,33417,64149
8600000US64150,2578,1322,1256,34489,64888,10884,64150
8600000US64151,20830,10180,10650,71190,87214,4776,64151
8600000US64152,21689,10815,10874,88919,125570,9658,64152
8600000US64153,4002,1951,2051,77874,87084,9917,64153
8600000US64154,8638,3899,4739,73458,95488,7587,64154
8600000US64155,17125,8500,8625,84614,91217,3817,64155
8600000US64156,5606,2622,2984,111000,132991,12208,64156
8600000US64157,12728,6101,6627,112481,136562,8040,64157
8600000US64158,3528,1723,1805,82739,88335,8528,64158
8600000US64161,253,136,117,67250,72581,14365,64161
8600000US64163,646,317,329,56250,51770,7343,64163
8600000US64164,213,88,125,,107773,77494,64164
8600000US64165,123,64,59,109844,109833,22993,64165
8600000US64166,251,136,115,75536,85048,33274,64166
8600000US64167,334,148,186,158125,161686,41169,64167
8600000US64192,0,0,0,,,,64192
8600000US64401,1101,572,529,67554,73402,9372,64401
8600000US64402,2095,965,1130,41768,53341,5675,64402
8600000US64420,50,24,26,57708,47783,9976,64420
8600000US64421,729,360,369,48125,56025,7073,64421
8600000US64422,287,168,119,90478,73365,13106,64422
8600000US64423,643,317,326,59423,73248,10725,64423
8600000US64424,3345,1566,1779,38958,48610,4039,64424
8600000US64426,289,151,138,37361,53075,8353,64426
8600000US64427,520,251,269,52417,67297,12151,64427
8600000US64428,620,311,309,38125,48622,6502,64428
8600000US64429,10618,6851,3767,50011,63207,4727,64429
8600000US64430,624,315,309,57566,57347,7888,64430
8600000US64431,266,125,141,61625,137441,98332,64431
8600000US64432,108,24,84,56250,67557,23603,64432
8600000US64433,290,248,42,55417,54797,11273,64433
8600000US64434,369,180,189,63750,88552,33471,64434
8600000US64436,607,288,319,65729,77592,12779,64436
8600000US64437,504,237,267,38409,50400,5481,64437
8600000US64438,91,36,55,28750,31385,6659,64438
8600000US64439,1319,556,763,71131,80244,9388,64439
8600000US64440,506,259,247,62143,60717,9197,64440
8600000US64441,127,76,51,54464,54789,16356,64441
8600000US64442,617,331,286,40417,48168,6698,64442
8600000US64443,1138,563,575,70750,76571,12750,64443
8600000US64444,1027,501,526,73304,76854,9891,64444
8600000US64445,235,102,133,37500,57298,15388,64445
8600000US64446,817,395,422,44453,58834,6178,64446
8600000US64448,791,359,432,64766,75779,21552,64448
8600000US64449,401,248,153,35625,55638,10673,64449
8600000US64451,313,153,160,42250,52522,9187,64451
8600000US64453,134,69,65,49773,51199,16449,64453
8600000US64454,1917,922,995,58786,69188,8237,64454
8600000US64455,257,113,144,48750,58178,11393,64455
8600000US64456,1135,517,618,50481,58254,4845,64456
8600000US64457,196,119,77,60000,64525,12284,64457
8600000US64458,110,57,53,48750,49238,10979,64458
8600000US64459,330,166,164,52356,63076,10343,64459
8600000US64461,507,257,250,48750,63009,9579,64461
8600000US64463,1278,646,632,42188,54485,6285,64463
8600000US64465,3489,1689,1800,58074,68605,6585,64465
8600000US64466,347,169,178,36875,49074,10405,64466
8600000US64467,196,99,97,,50129,14068,64467
8600000US64468,13477,6675,6802,41676,53745,3771,64468
8600000US64469,1677,817,860,50139,64261,9478,64469
8600000US64470,1219,596,623,51734,62421,4096,64470
8600000US64471,301,157,144,43125,49395,7646,64471
8600000US64473,1127,566,561,47143,54575,5764,64473
8600000US64474,679,349,330,57778,66993,8936,64474
8600000US64475,258,137,121,41250,52081,8204,64475
8600000US64476,248,109,139,41875,53154,10031,64476
8600000US64477,2859,1454,1405,60071,66345,5405,64477
8600000US64479,678,318,360,52396,61122,7448,64479
8600000US64480,148,84,64,51250,49357,11206,64480
8600000US64481,757,396,361,39000,46324,4374,64481
8600000US64482,1748,841,907,49656,68455,6704,64482
8600000US64483,563,291,272,62875,70900,8871,64483
8600000US64484,764,366,398,46500,55031,8625,64484
8600000US64485,6132,2915,3217,51285,65985,6187,64485
8600000US64486,386,191,195,53056,52646,6657,64486
8600000US64487,541,276,265,44300,65892,20669,64487
8600000US64489,1529,764,765,54583,58005,4671,64489
8600000US64490,1523,725,798,60536,70450,7406,64490
8600000US64491,1415,726,689,46833,54023,4064,64491
8600000US64492,1433,682,751,69563,85626,11031,64492
8600000US64493,455,236,219,44167,73925,37461,64493
8600000US64494,688,359,329,56250,68651,11887,64494
8600000US64496,33,15,18,41250,45663,16302,64496
8600000US64497,297,161,136,44141,53297,11409,64497
8600000US64498,216,111,105,48456,53998,7917,64498
8600000US64499,62,29,33,44583,46706,12176,64499
8600000US64501,9404,4847,4557,33133,41503,2556,64501
8600000US64503,9544,4532,5012,48569,56719,4068,64503
8600000US64504,8283,4314,3969,47946,60090,4791,64504
8600000US64505,9786,4688,5098,48927,63054,3183,64505
8600000US64506,19718,10233,9485,60970,82373,5359,64506
8600000US64507,10310,5073,5237,53927,64259,5652,64507
8600000US64601,9402,3867,5535,46911,58352,3421,64601
8600000US64620,344,170,174,52222,56891,9476,64620
8600000US64622,306,174,132,42378,67542,24854,64622
8600000US64623,357,182,175,50000,61398,12468,64623
8600000US64624,1155,531,624,39875,49443,4013,64624
8600000US64625,375,201,174,40000,63264,19996,64625
8600000US64628,4452,2011,2441,37830,49539,3955,64628
8600000US64630,496,224,272,59167,83200,27231,64630
8600000US64631,600,298,302,50208,53781,6659,64631
8600000US64632,335,176,159,38984,46338,7100,64632
8600000US64633,3629,1676,1953,35270,53860,6109,64633
8600000US64635,429,224,205,50000,57388,7173,64635
8600000US64636,199,104,95,33750,38079,9559,64636
8600000US64637,448,224,224,48750,53441,6326,64637
8600000US64638,564,281,283,51573,73432,18317,64638
8600000US64639,187,94,93,40625,47417,13691,64639
8600000US64640,2218,1042,1176,50333,61439,6070,64640
8600000US64641,485,235,250,44750,49896,5709,64641
8600000US64642,618,284,334,38750,52547,7507,64642
8600000US64643,884,467,417,49740,58232,6699,64643
8600000US64644,2342,1158,1184,51593,65893,7720,64644
8600000US64645,117,46,71,48750,45434,8246,64645
8600000US64646,140,64,76,29583,40987,14611,64646
8600000US64647,293,155,138,43958,52060,12063,64647
8600000US64648,1498,739,759,47159,61097,7948,64648
8600000US64649,479,226,253,37589,46198,8729,64649
8600000US64650,568,321,247,35938,46502,9477,64650
8600000US64651,523,259,264,52813,64476,11074,64651
8600000US64652,345,194,151,45875,58227,9768,64652
8600000US64653,539,252,287,52500,54422,4821,64653
8600000US64654,40,24,16,55417,48794,9207,64654
8600000US64655,153,72,81,,131986,75274,64655
8600000US64656,216,106,110,43889,51459,10464,64656
8600000US64657,210,122,88,50556,58761,18835,64657
8600000US64658,2385,1184,1201,49808,69654,10220,64658
8600000US64659,783,387,396,60625,67538,6791,64659
8600000US64660,437,228,209,54167,72251,23595,64660
8600000US64661,683,328,355,35417,44273,5972,64661
8600000US64664,345,167,178,63194,68781,9116,64664
8600000US64667,315,182,133,58125,71524,19601,64667
8600000US64668,1280,625,655,55417,72714,11832,64668
8600000US64670,864,476,388,50859,57492,10844,64670
8600000US64671,1462,761,701,52833,68533,14204,64671
8600000US64672,114,50,64,,39910,13029,64672
8600000US64673,1759,867,892,46591,58395,6959,64673
8600000US64674,306,137,169,54688,58361,8936,64674
8600000US64676,112,64,48,49583,67881,17256,64676
8600000US64679,537,238,299,39167,50773,10193,64679
8600000US64681,138,87,51,41250,52816,16127,64681
8600000US64682,372,177,195,57838,54953,6699,64682
8600000US64683,6291,3084,3207,43432,58829,6110,64683
8600000US64686,146,70,76,48750,50809,10779,64686
8600000US64688,464,239,225,51518,57340,6227,64688
8600000US64689,473,228,245,50714,58200,6843,64689
8600000US64701,10551,4897,5654,53810,63663,3858,64701
8600000US64720,2784,1264,1520,47672,63227,7071,64720
8600000US64722,368,168,200,59464,61454,9641,64722
8600000US64723,657,353,304,52083,71377,11029,64723
8600000US64724,1519,717,802,48009,64925,10717,64724
8600000US64725,1817,936,881,54615,68936,7611,64725
8600000US64726,246,147,99,65074,67041,18317,64726
8600000US64728,482,246,236,54554,61776,8369,64728
8600000US64730,5039,2428,2611,41591,68489,18170,64730
8600000US64733,971,467,504,50625,62968,10086,64733
8600000US64734,1546,774,772,81667,88879,8746,64734
8600000US64735,10260,4940,5320,44181,61363,5042,64735
8600000US64738,816,416,400,37414,50674,6021,64738
8600000US64739,728,336,392,48375,66387,9609,64739
8600000US64740,1418,673,745,36932,46864,5280,64740
8600000US64741,163,91,72,68333,67158,17549,64741
8600000US64742,1656,846,810,60284,68072,4526,64742
8600000US64743,157,71,86,39375,45576,9202,64743
8600000US64744,6039,2819,3220,35817,43921,4113,64744
8600000US64745,187,90,97,113611,91014,20143,64745
8600000US64746,1114,544,570,56250,84874,21997,64746
8600000US64747,2837,1370,1467,54375,65345,5375,64747
8600000US64748,1074,529,545,42361,52665,6779,64748
8600000US64750,371,170,201,37554,55166,16951,64750
8600000US64752,602,313,289,49659,68007,12144,64752
8600000US64755,2100,1129,971,56447,67738,7264,64755
8600000US64756,596,312,284,59625,73156,28941,64756
8600000US64759,5975,2832,3143,40668,63720,6932,64759
8600000US64761,994,467,527,53875,60278,7196,64761
8600000US64762,1179,590,589,38304,52854,7013,64762
8600000US64763,1232,614,618,35542,48648,7330,64763
8600000US64765,22,11,11,,31171,18541,64765
8600000US64767,473,265,208,53810,64203,12721,64767
8600000US64769,435,213,222,40139,54511,10561,64769
8600000US64770,750,388,362,52250,63849,9249,64770
8600000US64771,404,220,184,41719,42472,6089,64771
8600000US64772,10344,4686,5658,42752,63175,11608,64772
8600000US64776,3154,1646,1508,38494,49816,5617,64776
8600000US64778,556,283,273,54375,56797,7683,64778
8600000US64779,1801,886,915,41667,50340,3646,64779
8600000US64780,449,222,227,44886,65584,21439,64780
8600000US64781,56,27,29,64063,75276,36794,64781
8600000US64783,729,401,328,41875,55772,16833,64783
8600000US64784,799,425,374,42500,58944,11404,64784
8600000US64788,1273,636,637,45395,58284,8714,64788
8600000US64790,634,310,324,41563,50010,8473,64790
8600000US64801,28971,14111,14860,42004,56848,2798,64801
8600000US64804,27373,12821,14552,51534,75955,5304,64804
8600000US64830,519,248,271,52708,54989,8418,64830
8600000US64831,4650,2333,2317,52437,61718,6520,64831
8600000US64832,556,309,247,49375,63156,13273,64832
8600000US64833,43,19,24,29375,35544,11308,64833
8600000US64834,6726,2991,3735,66663,81928,7657,64834
8600000US64835,1450,721,729,39408,48309,5230,64835
8600000US64836,17739,8893,8846,45589,59913,5052,64836
8600000US64840,2256,1094,1162,61097,66422,8927,64840
8600000US64841,423,189,234,60893,57702,9405,64841
8600000US64842,618,341,277,41719,46214,7877,64842
8600000US64843,2612,1345,1267,45851,62813,11374,64843
8600000US64844,3700,1931,1769,40025,61888,19768,64844
8600000US64847,334,192,142,26458,34004,6813,64847
8600000US64848,542,294,248,46979,60691,14331,64848
8600000US64849,136,73,63,61964,59141,11934,64849
8600000US64850,17372,8380,8992,44593,57575,3087,64850
8600000US64854,2867,1448,1419,30439,44696,6414,64854
8600000US64855,1841,912,929,66384,83777,16018,64855
8600000US64856,2947,1457,1490,37355,50643,5277,64856
8600000US64857,292,147,145,50000,54208,10232,64857
8600000US64858,121,61,60,,,,64858
8600000US64859,1036,508,528,48523,54916,9496,64859
8600000US64861,1185,594,591,48443,58161,15372,64861
8600000US64862,2548,1257,1291,43750,59219,8074,64862
8600000US64863,1065,514,551,40149,46663,10371,64863
8600000US64865,4727,2291,2436,44288,57754,8018,64865
8600000US64866,935,508,427,53036,63171,10522,64866
8600000US64867,895,481,414,48517,61092,16878,64867
8600000US64870,11062,5188,5874,51270,63368,5785,64870
8600000US64873,813,393,420,49375,63655,15149,64873
8600000US64874,604,313,291,30729,46978,18973,64874
8600000US65001,203,121,82,50313,55658,9009,65001
8600000US65010,4604,2276,2328,74785,84217,8837,65010
8600000US65011,1828,937,891,34861,44806,7618,65011
8600000US65013,2227,1066,1161,34047,46165,5332,65013
8600000US65014,1673,814,859,43875,50265,7046,65014
8600000US65016,1202,633,569,70417,75626,6762,65016
8600000US65017,694,319,375,33333,39421,10019,65017
8600000US65018,5664,2766,2898,58731,68263,5822,65018
8600000US65020,13380,6346,7034,54013,69982,5160,65020
8600000US65023,1330,696,634,75329,82761,12893,65023
8600000US65024,883,428,455,56287,75363,16476,65024
8600000US65025,539,289,250,39934,49612,5585,65025
8600000US65026,8871,4269,4602,37997,52396,5901,65026
8600000US65032,1286,649,637,80884,100863,45179,65032
8600000US65034,617,261,356,34716,50692,15630,65034
8600000US65035,1459,741,718,66114,72424,8496,65035
8600000US65037,3961,1880,2081,37616,56799,10144,65037
8600000US65039,2104,1114,990,79023,93686,12910,65039
8600000US65040,1073,595,478,44043,61694,13100,65040
8600000US65041,4384,2187,2197,57237,74870,9313,65041
8600000US65043,8023,3632,4391,63659,65588,3482,65043
8600000US65046,1006,525,481,59022,68974,7438,65046
8600000US65047,937,465,472,49091,52041,10769,65047
8600000US65048,118,75,43,,69619,34131,65048
8600000US65049,5168,2511,2657,60067,77573,7475,65049
8600000US65050,496,263,233,60682,78034,13224,65050
8600000US65051,3768,2031,1737,50595,60671,6387,65051
8600000US65052,2950,1618,1332,58444,72852,11367,65052
8600000US65053,1288,642,646,75903,131733,80520,65053
8600000US65054,474,240,234,62875,84215,20624,65054
8600000US65058,700,363,337,48894,56580,7930,65058
8600000US65059,634,297,337,52632,69191,18935,65059
8600000US65061,524,267,257,39205,50948,8709,65061
8600000US65062,36,30,6,,,,65062
8600000US65063,2842,1460,1382,77688,88642,12883,65063
8600000US65064,396,162,234,68438,82515,28852,65064
8600000US65065,5739,2886,2853,56589,76677,10716,65065
8600000US65066,4878,2333,2545,54654,61619,4862,65066
8600000US65067,264,143,121,36683,50223,18169,65067
8600000US65068,517,284,233,58125,76312,12760,65068
8600000US65069,492,264,228,52120,61884,11406,65069
8600000US65072,1098,536,562,51192,63415,13339,65072
8600000US65074,2151,984,1167,58945,65309,4541,65074
8600000US65075,727,393,334,66500,76951,11831,65075
8600000US65076,526,252,274,67273,73860,13163,65076
8600000US65077,337,157,180,48125,73069,30051,65077
8600000US65078,3044,1491,1553,33470,43351,6618,65078
8600000US65079,3360,1621,1739,53421,73169,11820,65079
8600000US65080,836,464,372,48718,68197,17941,65080
8600000US65081,3432,2242,1190,46136,54443,5737,65081
8600000US65082,894,478,416,53750,70812,12143,65082
8600000US65083,178,93,85,51220,56566,26464,65083
8600000US65084,4985,2426,2559,36645,53167,11983,65084
8600000US65085,991,482,509,63750,66857,8290,65085
8600000US65101,23793,13131,10662,54781,69403,2996,65101
8600000US65109,29847,14025,15822,59017,74751,3545,65109
8600000US65201,40158,19575,20583,36590,56228,3130,65201
8600000US65202,36817,17844,18973,51287,62778,3140,65202
8600000US65203,44811,20774,24037,64629,90355,4643,65203
8600000US65215,249,37,212,,,,65215
8600000US65230,576,249,327,44659,66565,15740,65230
8600000US65231,2528,1165,1363,54228,62892,6022,65231
8600000US65232,205,108,97,40000,47970,7572,65232
8600000US65233,9524,5043,4481,48071,59555,2804,65233
8600000US65236,1153,559,594,36944,57254,7961,65236
8600000US65237,711,369,342,50893,65977,11449,65237
8600000US65239,967,492,475,51875,61194,9235,65239
8600000US65240,6397,3076,3321,58573,65405,5428,65240
8600000US65243,1786,880,906,56591,64880,8760,65243
8600000US65244,276,150,126,41161,53749,8888,65244
8600000US65246,33,14,19,,124900,97969,65246
8600000US65247,482,232,250,34167,43136,9322,65247
8600000US65248,3523,1725,1798,47972,60059,4423,65248
8600000US65250,502,272,230,47431,58533,10008,65250
8600000US65251,17704,9669,8035,51517,62913,3949,65251
8600000US65254,1597,769,828,59130,83114,14204,65254
8600000US65255,2735,1158,1577,56935,70414,9050,65255
8600000US65256,1308,660,648,81576,87933,13537,65256
8600000US65257,1209,611,598,48690,55973,5450,65257
8600000US65258,339,181,158,48750,67394,11539,65258
8600000US65259,2452,1222,1230,67663,68297,8157,65259
8600000US65260,421,260,161,51875,62172,13048,65260
8600000US65261,642,350,292,38125,46413,5086,65261
8600000US65262,751,398,353,61797,88704,26696,65262
8600000US65263,1394,731,663,43194,51929,4412,65263
8600000US65264,532,232,300,60313,75858,13351,65264
8600000US65265,11384,5336,6048,42711,54680,3566,65265
8600000US65270,13401,7120,6281,43313,56104,3045,65270
8600000US65274,1382,722,660,45000,58389,6159,65274
8600000US65275,2091,1015,1076,45066,58924,9721,65275
8600000US65276,1226,610,616,43672,55316,3581,65276
8600000US65278,102,57,45,34167,40543,9993,65278
8600000US65279,1398,670,728,77148,110230,27068,65279
8600000US65280,239,109,130,42206,56151,14663,65280
8600000US65281,2161,999,1162,43451,56023,6039,65281
8600000US65282,119,61,58,42250,57143,14062,65282
8600000US65283,409,217,192,45948,91420,66595,65283
8600000US65284,1608,779,829,65571,77660,10153,65284
8600000US65285,502,264,238,78690,97383,49014,65285
8600000US65286,89,23,66,61000,49420,16568,65286
8600000US65287,276,133,143,66042,69825,15452,65287
8600000US65301,25720,12321,13399,41879,57592,2785,65301
8600000US65305,2990,1933,1057,48824,56766,4705,65305
8600000US65320,36,11,25,65125,55744,15363,65320
8600000US65321,353,192,161,51354,117122,91413,65321
8600000US65322,437,217,220,53333,64990,13527,65322
8600000US65323,725,387,338,44286,50392,5673,65323
8600000US65324,1189,633,556,36833,50721,10557,65324
8600000US65325,2712,1283,1429,43068,55929,5629,65325
8600000US65326,1782,905,877,36536,45085,8601,65326
8600000US65327,182,97,85,52321,58413,14067,65327
8600000US65329,364,199,165,111000,89271,26291,65329
8600000US65330,355,188,167,60208,60445,7225,65330
8600000US65332,1038,537,501,54821,62496,5328,65332
8600000US65333,495,276,219,45938,77107,19827,65333
8600000US65334,686,330,356,53304,65308,6355,65334
8600000US65335,112,56,56,41250,54186,23650,65335
8600000US65336,4086,2189,1897,52738,65679,5264,65336
8600000US65337,1408,687,721,48000,57524,6206,65337
8600000US65338,2250,1100,1150,33571,48715,6700,65338
8600000US65339,402,220,182,42917,49685,6505,65339
8600000US65340,12106,5904,6202,42405,57550,3733,65340
8600000US65344,176,95,81,56125,87409,34374,65344
8600000US65345,228,119,109,49779,66703,23100,65345
8600000US65347,495,254,241,50441,57287,5754,65347
8600000US65348,1029,527,502,42589,51062,4590,65348
8600000US65349,1986,1014,972,40288,47874,5222,65349
8600000US65350,1531,761,770,53170,57744,6204,65350
8600000US65351,2026,1055,971,49554,57560,4690,65351
8600000US65354,451,186,265,57000,60265,11699,65354
8600000US65355,8788,4305,4483,36976,57639,11905,65355
8600000US65360,3845,1918,1927,42679,56157,5810,65360
8600000US65401,26166,14083,12083,41905,61878,4166,65401
8600000US65436,46,26,20,73333,83077,23139,65436
8600000US65438,1918,830,1088,28565,39493,5728,65438
8600000US65439,183,71,112,,56340,18329,65439
8600000US65440,318,142,176,39167,48556,14969,65440
8600000US65441,4249,2229,2020,51267,57966,7998,65441
8600000US65443,64,25,39,103603,95355,29544,65443
8600000US65444,892,517,375,37257,44193,7504,65444
8600000US65446,193,89,104,,78794,51825,65446
8600000US65449,184,90,94,,39516,19459,65449
8600000US65452,2254,1139,1115,43766,55416,7592,65452
8600000US65453,6635,3155,3480,36815,46926,3934,65453
8600000US65456,917,438,479,35893,62534,22589,65456
8600000US65457,97,42,55,123281,122037,36386,65457
8600000US65459,5107,2597,2510,45000,61743,8355,65459
8600000US65461,65,32,33,45682,37732,10765,65461
8600000US65462,1157,482,675,40917,52069,8337,65462
8600000US65463,851,534,317,64297,77466,25524,65463
8600000US65464,854,389,465,33923,42721,10639,65464
8600000US65466,1422,683,739,33438,46916,7740,65466
8600000US65468,153,96,57,,,,65468
8600000US65470,758,377,381,39792,51738,8426,65470
8600000US65473,12970,9355,3615,51750,62677,6595,65473
8600000US65479,166,107,59,26071,37138,16660,65479
8600000US65483,3460,1669,1791,31045,41423,4396,65483
8600000US65484,99,55,44,,,,65484
8600000US65486,2792,1393,1399,47727,67821,20306,65486
8600000US65501,142,71,71,55833,65379,23851,65501
8600000US65529,163,71,92,85338,66784,23092,65529
8600000US65534,1044,710,334,69659,70250,11042,65534
8600000US65535,1107,494,613,38021,44028,5688,65535
8600000US65536,21889,10580,11309,46089,54079,2905,65536
8600000US65541,217,124,93,,97900,57879,65541
8600000US65542,5021,2903,2118,34871,50489,7640,65542
8600000US65543,142,76,66,31083,38884,14470,65543
8600000US65548,4318,1998,2320,29578,41639,5044,65548
8600000US65550,2315,1122,1193,38938,53025,7184,65550
8600000US65552,1641,931,710,57925,79423,31706,65552
8600000US65555,953,491,462,37632,42024,4436,65555
8600000US65556,5208,2856,2352,40200,61576,10367,65556
8600000US65557,114,69,45,,,,65557
8600000US65559,6763,3497,3266,51663,60343,6730,65559
8600000US65560,11062,5454,5608,39248,53589,5700,65560
8600000US65564,86,24,62,,64757,48571,65564
8600000US65565,4053,2005,2048,35121,48660,7475,65565
8600000US65566,619,295,324,46442,55014,8133,65566
8600000US65567,1073,566,507,36458,49296,10198,65567
8600000US65570,525,288,237,47614,53570,12229,65570
8600000US65571,1517,765,752,24507,37497,8179,65571
8600000US65580,594,307,287,51250,62370,14829,65580
8600000US65582,1914,892,1022,47850,62264,8250,65582
8600000US65583,8984,4445,4539,55488,61716,5922,65583
8600000US65584,8584,4410,4174,55481,60740,5940,65584
8600000US65586,75,35,40,,,,65586
8600000US65588,2223,1076,1147,32574,41743,5969,65588
8600000US65589,73,40,33,,27033,22780,65589
8600000US65590,966,518,448,36250,42909,8449,65590
8600000US65591,1446,747,699,38750,46205,8492,65591
8600000US65601,513,232,281,62708,61969,10965,65601
8600000US65603,143,82,61,55167,55043,9991,65603
8600000US65604,2701,1264,1437,54359,71764,13301,65604
8600000US65605,10019,4817,5202,40798,52889,4273,65605
8600000US65606,2528,1316,1212,31385,38341,7667,65606
8600000US65608,7035,3445,3590,33560,45285,4312,65608
8600000US65609,613,318,295,32167,40147,10794,65609
8600000US65610,3793,1795,1998,56906,69400,5870,65610
8600000US65611,1709,758,951,37473,49803,12054,65611
8600000US65612,879,425,454,53173,62831,12550,65612
8600000US65613,13812,6723,7089,44548,61609,4432,65613
8600000US65614,452,221,231,52500,55145,6683,65614
8600000US65616,21462,10036,11426,44721,55002,2895,65616
8600000US65617,993,476,517,46167,60463,17550,65617
8600000US65618,266,165,101,,54076,25180,65618
8600000US65619,5223,2443,2780,59259,70696,6629,65619
8600000US65620,206,89,117,,93257,47428,65620
8600000US65622,6835,3165,3670,39040,57697,12475,65622
8600000US65623,9,3,6,,,,65623
8600000US65624,1342,652,690,43039,50437,8689,65624
8600000US65625,6114,2868,3246,40141,56945,7669,65625
8600000US65626,1318,706,612,38589,44185,5439,65626
8600000US65627,351,171,180,33438,44652,13393,65627
8600000US65629,533,270,263,39063,42734,6405,65629
8600000US65630,255,127,128,100357,102697,13606,65630
8600000US65631,3853,1741,2112,53109,62388,5426,65631
8600000US65632,1881,930,951,43718,64508,18120,65632
8600000US65633,2902,1358,1544,46563,54527,5465,65633
8600000US65634,557,245,312,31172,39594,10148,65634
8600000US65635,505,253,252,66023,76455,10765,65635
8600000US65637,946,443,503,30547,59899,20132,65637
8600000US65638,438,201,237,39205,47755,12282,65638
8600000US65640,655,293,362,39902,51565,8422,65640
8600000US65641,978,518,460,53036,63660,12427,65641
8600000US65644,1421,679,742,54231,51913,7171,65644
8600000US65646,1374,711,663,49423,60267,5916,65646
8600000US65647,1645,784,861,41875,49054,5492,65647
8600000US65648,4377,2261,2116,55250,65270,5611,65648
8600000US65649,1352,688,664,38188,77206,37175,65649
8600000US65650,1242,672,570,43409,56094,10061,65650
8600000US65652,3148,1890,1258,42981,55187,6343,65652
8600000US65653,4959,2311,2648,36574,51782,6799,65653
8600000US65654,145,73,72,38611,44273,7942,65654
8600000US65655,2437,1170,1267,25790,33276,5614,65655
8600000US65656,3519,1705,1814,43167,59708,15624,65656
8600000US65657,116,50,66,,48981,21421,65657
8600000US65658,1122,563,559,26232,55851,20555,65658
8600000US65660,128,66,62,38272,30817,8455,65660
8600000US65661,2180,998,1182,35095,43690,4581,65661
8600000US65662,1049,573,476,41250,44433,7820,65662
8600000US65663,1882,806,1076,41094,63447,18049,65663
8600000US65664,94,49,45,17500,27948,16187,65664
8600000US65667,2313,1147,1166,35933,66366,13425,65667
8600000US65668,1583,759,824,37847,46327,7537,65668
8600000US65669,1692,700,992,49022,62595,7377,65669
8600000US65672,7723,3632,4091,42246,57527,7666,65672
8600000US65674,2195,1075,1120,37407,45545,5177,65674
8600000US65676,340,182,158,39244,46773,8796,65676
8600000US65679,1919,1025,894,44375,56377,5882,65679
8600000US65680,997,511,486,31484,40028,8364,65680
8600000US65681,1376,663,713,56185,73537,14249,65681
8600000US65682,1529,803,726,38681,51509,5608,65682
8600000US65685,477,235,242,39125,49225,18001,65685
8600000US65686,4409,2183,2226,60166,77805,15358,65686
8600000US65689,4008,2025,1983,35282,50434,7074,65689
8600000US65690,169,86,83,40417,56310,20402,65690
8600000US65692,1162,582,580,37143,45767,10176,65692
8600000US65702,235,118,117,35486,40577,10597,65702
8600000US65704,2711,1242,1469,34331,44257,4609,65704
8600000US65705,3007,1432,1575,43413,52630,6162,65705
8600000US65706,11733,5887,5846,47364,60116,4960,65706
8600000US65707,1652,815,837,46000,66982,11193,65707
8600000US65708,9829,4904,4925,46845,64807,10294,65708
8600000US65710,919,433,486,57386,61495,14247,65710
8600000US65711,7358,3451,3907,33029,48775,6178,65711
8600000US65712,6611,3172,3439,44688,57216,8200,65712
8600000US65713,1877,917,960,44625,51322,5637,65713
8600000US65714,24366,11877,12489,57911,77162,4481,65714
8600000US65715,31,8,23,,22971,19998,65715
8600000US65717,2114,1110,1004,40450,51990,5345,65717
8600000US65720,700,389,311,35000,56622,20375,65720
8600000US65721,22541,10782,11759,57980,70282,3318,65721
8600000US65722,1234,546,688,44063,56849,11889,65722
8600000US65723,2502,1294,1208,41686,56423,10220,65723
8600000US65724,1315,666,649,32125,36990,4312,65724
8600000US65725,2300,1071,1229,53125,65690,7821,65725
8600000US65727,116,56,60,57396,45969,27649,65727
8600000US65728,0,0,0,,,,65728
8600000US65729,254,157,97,43393,77411,45351,65729
8600000US65730,40,19,21,,,,65730
8600000US65731,432,198,234,73793,83083,21270,65731
8600000US65732,660,296,364,42986,58473,10186,65732
8600000US65733,701,394,307,28402,32824,7636,65733
8600000US65734,2462,1279,1183,48839,54426,5922,65734
8600000US65735,51,30,21,,71043,42144,65735
8600000US65737,7266,3635,3631,41736,66950,10563,65737
8600000US65738,13573,6616,6957,51375,61812,2882,65738
8600000US65739,825,414,411,47222,63277,14097,65739
8600000US65740,2357,1146,1211,33045,40635,3205,65740
8600000US65742,9937,4753,5184,61560,77928,6615,65742
8600000US65744,67,39,28,46125,43746,9271,65744
8600000US65745,2332,1110,1222,31772,47594,6838,65745
8600000US65746,5478,2673,2805,40534,50624,3754,65746
8600000US65747,3332,1679,1653,40988,55283,8112,65747
8600000US65752,334,182,152,40517,46704,9513,65752
8600000US65753,3922,1861,2061,47616,62358,8336,65753
8600000US65754,671,329,342,59810,80903,42095,65754
8600000US65755,423,187,236,32326,76818,54546,65755
8600000US65756,495,257,238,75000,81563,17342,65756
8600000US65757,5413,2583,2830,61957,70406,6216,65757
8600000US65759,1014,512,502,41250,45540,4672,65759
8600000US65760,420,196,224,43816,48116,14921,65760
8600000US65761,953,527,426,32232,38710,5464,65761
8600000US65762,307,162,145,36250,42057,7391,65762
8600000US65764,1028,568,460,46413,73307,40760,65764
8600000US65766,78,35,43,,50986,24803,65766
8600000US65767,1494,830,664,39345,52447,7911,65767
8600000US65768,373,199,174,28514,41957,20590,65768
8600000US65769,1992,1028,964,45231,58490,8409,65769
8600000US65770,2509,1309,1200,52167,70439,17799,65770
8600000US65771,1019,530,489,41118,67402,18432,65771
8600000US65772,1237,603,634,33611,48268,7941,65772
8600000US65773,501,231,270,39554,50673,12742,65773
8600000US65774,823,415,408,33125,46420,9897,65774
8600000US65775,19245,9280,9965,36847,52781,3581,65775
8600000US65777,392,218,174,,28233,17590,65777
8600000US65778,372,194,178,42083,50606,11428,65778
8600000US65779,1447,708,739,32121,42377,6207,65779
8600000US65781,6073,2860,3213,65441,69597,7234,65781
8600000US65783,58,33,25,,,,65783
8600000US65784,16,7,9,,,,65784
8600000US65785,3950,1981,1969,40707,51275,5442,65785
8600000US65786,1667,820,847,44000,56367,10848,65786
8600000US65787,1240,563,677,42067,55552,9759,65787
8600000US65788,297,147,150,35556,55099,40579,65788
8600000US65789,1314,710,604,48125,66500,19128,65789
8600000US65790,708,320,388,30721,40672,11650,65790
8600000US65791,3575,1750,1825,35825,43899,4461,65791
8600000US65793,4675,2232,2443,36792,52331,6089,65793
8600000US65802,36769,17749,19020,37192,49350,2730,65802
8600000US65803,32063,15934,16129,36729,49640,2367,65803
8600000US65804,30861,14465,16396,50196,70149,2823,65804
8600000US65806,10380,5042,5338,16501,25692,3452,65806
8600000US65807,48848,22959,25889,40170,51826,2241,65807
8600000US65809,9034,4329,4705,101559,134559,13425,65809
8600000US65810,17737,8497,9240,67115,88746,4735,65810
8600000US66002,10206,4701,5505,47439,62621,6031,66002
8600000US66006,6023,3032,2991,71843,89313,11500,66006
8600000US66007,5256,2450,2806,75128,91302,9783,66007
8600000US66008,208,86,122,47917,62410,19514,66008
8600000US66010,627,303,324,54464,67941,21367,66010
8600000US66012,8795,4114,4681,71583,83874,4298,66012
8600000US66013,1823,872,951,111011,132679,20767,66013
8600000US66014,123,83,40,31118,54265,38023,66014
8600000US66015,633,334,299,42692,51411,8418,66015
8600000US66016,271,139,132,64318,71636,15687,66016
8600000US66017,314,164,150,49519,60371,9397,66017
8600000US66018,4404,2228,2176,62850,90480,11943,66018
8600000US66019,275,154,121,33958,30441,16764,66019
8600000US66020,1263,611,652,67232,66433,8140,66020
8600000US66021,1915,965,950,66359,81993,8011,66021
8600000US66023,832,482,350,43021,65384,18664,66023
8600000US66024,582,323,259,28092,36094,5134,66024
8600000US66025,5413,2647,2766,82632,86941,8734,66025
8600000US66026,355,188,167,61406,66795,10488,66026
8600000US66027,3891,2407,1484,94467,100437,10210,66027
8600000US66030,15879,7537,8342,76017,83090,3688,66030
8600000US66031,641,613,28,,,,66031
8600000US66032,3665,1809,1856,45900,55587,6102,66032
8600000US66033,572,255,317,43563,53379,12811,66033
8600000US66035,1141,610,531,57679,78315,19427,66035
8600000US66039,445,211,234,42500,56300,11070,66039
8600000US66040,2424,1265,1159,51016,57931,6215,66040
8600000US66041,557,299,258,58594,62846,11533,66041
8600000US66042,593,301,292,71481,80283,16138,66042
8600000US66043,8964,5436,3528,83000,103120,16410,66043
8600000US66044,25070,13088,11982,38496,58043,4340,66044
8600000US66045,2138,917,1221,,,,66045
8600000US66046,16073,7711,8362,42293,57093,4048,66046
8600000US66047,16425,8063,8362,57303,80379,5718,66047
8600000US66048,28050,15158,12892,59946,79453,8218,66048
8600000US66049,24103,11604,12499,69729,91869,5842,66049
8600000US66050,1629,807,822,64423,85713,12329,66050
8600000US66052,1943,1056,887,75000,86701,10545,66052
8600000US66053,5358,2643,2715,76004,91888,6126,66053
8600000US66054,2080,1026,1054,58287,67671,5971,66054
8600000US66056,1395,670,725,38889,54873,6604,66056
8600000US66058,208,97,111,40500,55948,18838,66058
8600000US66060,918,447,471,60391,64583,6324,66060
8600000US66061,45097,22301,22796,81253,98862,4230,66061
8600000US66062,57327,28080,29247,94223,112301,3880,66062
8600000US66064,4330,2080,2250,56263,63472,10906,66064
8600000US66066,2049,1055,994,75250,82598,11316,66066
8600000US66067,11825,5647,6178,52029,63319,3843,66067
8600000US66070,1864,1042,822,61042,75030,8411,66070
8600000US66071,9645,4632,5013,64944,76675,5161,66071
8600000US66072,837,461,376,51875,65943,19497,66072
8600000US66073,1860,869,991,61360,65589,7491,66073
8600000US66075,1823,829,994,41518,58715,9388,66075
8600000US66076,1920,932,988,67799,85107,26449,66076
8600000US66078,884,464,420,53529,69070,14741,66078
8600000US66079,595,268,327,57417,60113,17672,66079
8600000US66080,685,321,364,63393,68624,9181,66080
8600000US66083,6827,3444,3383,83981,105442,11644,66083
8600000US66085,5931,2839,3092,125725,163437,15129,66085
8600000US66086,7583,3819,3764,79116,89730,6481,66086
8600000US66087,1552,801,751,54531,73243,9847,66087
8600000US66088,1858,901,957,64896,75669,7595,66088
8600000US66090,2116,1059,1057,51676,58258,6257,66090
8600000US66091,244,120,124,,88883,47825,66091
8600000US66092,2773,1422,1351,71429,78901,7309,66092
8600000US66093,449,220,229,57143,63558,9635,66093
8600000US66094,256,130,126,47917,58857,10688,66094
8600000US66095,633,363,270,48088,53875,10284,66095
8600000US66097,1007,466,541,58088,68377,8968,66097
8600000US66101,8656,4468,4188,26546,33955,1788,66101
8600000US66102,21465,10739,10726,34410,44878,2568,66102
8600000US66103,10792,5560,5232,39110,50238,3140,66103
8600000US66104,18668,8620,10048,38843,45419,1917,66104
8600000US66105,1720,963,757,34417,44358,6086,66105
8600000US66106,17305,8701,8604,50439,58915,2621,66106
8600000US66109,16823,8138,8685,77216,88753,3802,66109
8600000US66111,7243,3413,3830,53058,60829,4666,66111
8600000US66112,9992,4598,5394,47952,56655,3742,66112
8600000US66115,0,0,0,,,,66115
8600000US66118,0,0,0,,,,66118
8600000US66202,13432,6231,7201,58510,75244,4265,66202
8600000US66203,15480,7326,8154,56250,69083,3804,66203
8600000US66204,15994,8012,7982,55122,66418,3553,66204
8600000US66205,10649,5028,5621,82451,112359,7154,66205
8600000US66206,8038,3854,4184,137321,189520,17598,66206
8600000US66207,11460,5624,5836,88368,132782,11927,66207
8600000US66208,16327,7556,8771,95610,149436,8537,66208
8600000US66209,15883,7340,8543,113138,166519,15320,66209
8600000US66210,15600,7627,7973,76485,96088,4478,66210
8600000US66211,4105,2022,2083,104419,246799,73885,66211
8600000US66212,25600,11966,13634,60465,74707,3589,66212
8600000US66213,22332,10662,11670,103444,118121,3965,66213
8600000US66214,9512,4659,4853,58333,75399,5304,66214
8600000US66215,21186,9906,11280,72972,91594,6233,66215
8600000US66216,18887,9242,9645,94248,114130,6478,66216
8600000US66217,4682,2196,2486,65893,99990,9866,66217
8600000US66218,5709,2756,2953,127358,147069,14966,66218
8600000US66219,9663,4607,5056,78107,98183,7086,66219
8600000US66220,5204,2582,2622,145031,193257,16893,66220
8600000US66221,11978,5980,5998,159021,189161,9224,66221
8600000US66223,18544,9270,9274,100142,131219,6287,66223
8600000US66224,9729,4620,5109,158857,222538,20510,66224
8600000US66226,9656,4693,4963,126784,136810,8628,66226
8600000US66227,4434,2044,2390,101250,131479,11987,66227
8600000US66401,1255,627,628,62083,71989,8066,66401
8600000US66402,2163,1052,1111,86114,121574,31442,66402
8600000US66403,542,271,271,53958,67914,12165,66403
8600000US66404,315,175,140,45938,53720,17915,66404
8600000US66406,361,199,162,54943,67655,11380,66406
8600000US66407,451,214,237,49904,65771,12776,66407
8600000US66408,262,136,126,72083,88004,24305,66408
8600000US66409,2696,1381,1315,84020,91454,10289,66409
8600000US66411,980,514,466,57171,64231,8864,66411
8600000US66412,131,67,64,65313,61868,13799,66412
8600000US66413,1425,712,713,52125,58427,5572,66413
8600000US66414,2184,1079,1105,59854,74524,11897,66414
8600000US66415,636,300,336,69861,75962,11388,66415
8600000US66416,409,232,177,48438,55753,12581,66416
8600000US66417,258,138,120,69250,77934,12956,66417
8600000US66418,340,197,143,91667,88971,13542,66418
8600000US66419,312,140,172,61029,114792,70951,66419
8600000US66422,249,128,121,54583,75707,22187,66422
8600000US66423,772,307,465,50625,67650,12623,66423
8600000US66424,399,183,216,59097,73251,11210,66424
8600000US66425,378,195,183,48750,59307,8382,66425
8600000US66427,895,461,434,51094,61833,7791,66427
8600000US66428,313,177,136,73906,73870,15044,66428
8600000US66429,401,197,204,59286,63685,11498,66429
8600000US66431,499,283,216,61625,68324,11628,66431
8600000US66432,282,117,165,56429,68663,13308,66432
8600000US66434,3478,1690,1788,49471,67040,6667,66434
8600000US66436,4642,2227,2415,55617,71728,7429,66436
8600000US66438,116,60,56,48333,55790,20536,66438
8600000US66439,1993,960,1033,40250,54879,4447,66439
8600000US66440,1326,698,628,57279,71040,7412,66440
8600000US66441,19088,10048,9040,50463,59711,2746,66441
8600000US66442,11195,7648,3547,41039,47573,2949,66442
8600000US66449,787,395,392,51000,81018,25518,66449
8600000US66451,1130,546,584,56815,65303,5697,66451
8600000US66501,275,114,161,47404,59699,8947,66501
8600000US66502,38996,20054,18942,43565,60472,2977,66502
8600000US66503,12081,6205,5876,82038,107363,7632,66503
8600000US66506,3438,1623,1815,,,,66506
8600000US66507,869,454,415,73088,73754,7269,66507
8600000US66508,3358,1621,1737,46976,64350,6175,66508
8600000US66509,2019,981,1038,54476,58374,4529,66509
8600000US66510,586,288,298,50469,61972,7285,66510
8600000US66512,2414,1215,1199,61087,71401,8149,66512
8600000US66514,756,446,310,67750,81087,15220,66514
8600000US66515,290,166,124,46339,50806,9312,66515
8600000US66516,270,148,122,61875,59605,6502,66516
8600000US66517,1222,570,652,36406,43616,6245,66517
8600000US66518,111,57,54,65750,71827,12310,66518
8600000US66520,396,221,175,57857,67597,11072,66520
8600000US66521,1223,594,629,57734,63830,7176,66521
8600000US66522,58,33,25,,38178,29934,66522
8600000US66523,2924,1356,1568,47833,59371,6935,66523
8600000US66524,1836,948,888,64081,70860,7516,66524
8600000US66526,526,281,245,59531,71967,19093,66526
8600000US66527,178,98,80,39167,52895,9111,66527
8600000US66528,571,314,257,45833,52390,10531,66528
8600000US66531,1339,651,688,60642,74192,10329,66531
8600000US66532,536,261,275,65625,77549,13281,66532
8600000US66533,1405,655,750,65446,90029,18876,66533
8600000US66534,2753,1351,1402,64196,83115,12814,66534
8600000US66535,1976,1066,910,61063,71077,9440,66535
8600000US66536,2617,1222,1395,67596,75097,6239,66536
8600000US66537,820,399,421,60163,79901,19031,66537
8600000US66538,2546,1230,1316,55703,71034,7011,66538
8600000US66539,1981,983,998,69000,83072,9433,66539
8600000US66540,308,171,137,56875,68815,17141,66540
8600000US66541,142,78,64,39000,43377,7957,66541
8600000US66542,2511,1275,1236,83333,96897,17771,66542
8600000US66543,938,485,453,52656,61339,6745,66543
8600000US66544,275,149,126,51146,56277,7204,66544
8600000US66546,907,474,433,81316,106862,36537,66546
8600000US66547,6300,3156,3144,62280,72404,6332,66547
8600000US66548,672,338,334,50583,64068,10092,66548
8600000US66549,1282,676,606,67500,77850,10262,66549
8600000US66550,444,238,206,39375,59481,14668,66550
8600000US66552,345,169,176,49828,61658,8487,66552
8600000US66554,464,221,243,63625,77083,12919,66554
8600000US66603,1060,571,489,26369,36595,6836,66603
8600000US66604,17869,8697,9172,46245,63556,4666,66604
8600000US66605,13707,6084,7623,54469,61148,3050,66605
8600000US66606,9048,4344,4704,41633,62014,8166,66606
8600000US66607,6853,3246,3607,31856,37592,3066,66607
8600000US66608,4346,2304,2042,37759,43478,3725,66608
8600000US66609,5531,2529,3002,56239,72832,9451,66609
8600000US66610,7867,3867,4000,110197,153016,12387,66610
8600000US66611,8277,3824,4453,47793,59665,3252,66611
8600000US66612,1781,970,811,21029,28759,3916,66612
8600000US66614,24787,11168,13619,61341,70272,2651,66614
8600000US66615,2507,1327,1180,63691,100224,19127,66615
8600000US66616,4197,2094,2103,36178,48818,5256,66616
8600000US66617,6806,3287,3519,78351,87823,6433,66617
8600000US66618,7210,3520,3690,85797,95611,7526,66618
8600000US66619,1767,855,912,53361,52689,5717,66619
8600000US66621,689,215,474,,,,66621
8600000US66622,100,97,3,,,,66622
8600000US66701,9254,4480,4774,39965,56455,5542,66701
8600000US66710,409,192,217,38625,50362,9380,66710
8600000US66711,458,250,208,30500,44658,9030,66711
8600000US66712,1410,603,807,42071,62488,9963,66712
8600000US66713,4062,1932,2130,35943,53881,7188,66713
8600000US66714,191,96,95,43125,59715,16152,66714
8600000US66716,256,123,133,34000,63246,23682,66716
8600000US66717,381,177,204,57868,59740,8507,66717
8600000US66720,8515,4034,4481,43333,57560,5929,66720
8600000US66724,778,345,433,41023,55887,12456,66724
8600000US66725,4171,2000,2171,44921,52352,3249,66725
8600000US66728,29,8,21,26607,22876,7450,66728
8600000US66732,237,136,101,50735,67628,20058,66732
8600000US66733,1642,830,812,47039,58375,8768,66733
8600000US66734,199,93,106,48750,52766,14572,66734
8600000US66735,372,188,184,45417,46817,11628,66735
8600000US66736,2825,1359,1466,40483,59957,8638,66736
8600000US66738,189,96,93,59464,82827,35155,66738
8600000US66739,4283,2163,2120,43721,52554,4846,66739
8600000US66740,326,175,151,66667,69739,11128,66740
8600000US66741,143,71,72,90208,97395,37397,66741
8600000US66743,3146,1504,1642,41921,59212,10701,66743
8600000US66746,185,88,97,41083,51248,14783,66746
8600000US66748,2013,974,1039,45968,63094,9726,66748
8600000US66749,5824,2802,3022,40359,51580,4884,66749
8600000US66751,634,309,325,40395,43865,4815,66751
8600000US66753,906,452,454,63550,70289,11916,66753
8600000US66754,304,160,144,63009,65115,16366,66754
8600000US66755,767,375,392,55395,59097,6458,66755
8600000US66756,706,334,372,29800,44871,11455,66756
8600000US66757,2445,1228,1217,50688,65063,9094,66757
8600000US66758,189,94,95,30938,39453,11973,66758
8600000US66760,0,0,0,,,,66760
8600000US66761,183,119,64,54333,57597,13380,66761
8600000US66762,19875,10093,9782,37298,51739,2553,66762
8600000US66763,2660,1181,1479,55660,71912,12360,66763
8600000US66767,429,188,241,48571,49592,10173,66767
8600000US66769,279,148,131,40417,45348,8696,66769
8600000US66770,851,411,440,44524,57732,8542,66770
8600000US66771,714,372,342,60605,70100,8525,66771
8600000US66772,139,74,65,51250,61529,17651,66772
8600000US66773,659,319,340,32946,54313,8318,66773
8600000US66775,130,60,70,56250,50630,12743,66775
8600000US66776,1003,542,461,51111,57084,8758,66776
8600000US66777,426,228,198,19643,32415,7324,66777
8600000US66778,0,0,0,,,,66778
8600000US66779,440,229,211,34583,52341,9442,66779
8600000US66780,436,275,161,51750,56128,15937,66780
8600000US66781,783,388,395,40469,49266,7686,66781
8600000US66782,96,51,45,32500,43076,11732,66782
8600000US66783,1726,842,884,39777,49554,4145,66783
8600000US66801,22224,10644,11580,41706,62392,4553,66801
8600000US66830,110,43,67,48125,67937,15516,66830
8600000US66833,409,206,203,62500,65828,9020,66833
8600000US66834,645,312,333,55625,57615,7740,66834
8600000US66835,852,451,401,56813,75903,24140,66835
8600000US66838,72,39,33,36875,74928,28504,66838
8600000US66839,2900,1453,1447,59265,75864,4882,66839
8600000US66840,505,246,259,61121,64450,8111,66840
8600000US66842,369,197,172,81250,77968,10132,66842
8600000US66843,133,73,60,,50669,12687,66843
8600000US66845,918,469,449,45385,59709,8345,66845
8600000US66846,2478,1198,1280,49479,65780,6815,66846
8600000US66849,351,187,164,65000,84303,28743,66849
8600000US66850,213,114,99,55521,93269,43812,66850
8600000US66851,438,202,236,26667,57615,21823,66851
8600000US66852,466,233,233,51250,68753,10427,66852
8600000US66853,375,187,188,48250,62838,16144,66853
8600000US66854,507,264,243,51250,55493,8442,66854
8600000US66856,1330,752,578,68533,80920,10801,66856
8600000US66857,824,400,424,55893,65447,9292,66857
8600000US66858,317,159,158,57321,64227,10782,66858
8600000US66859,214,101,113,40000,58368,23328,66859
8600000US66860,1027,522,505,39375,63231,13294,66860
8600000US66861,2219,1108,1111,50893,54412,4991,66861
8600000US66862,55,22,33,,45333,16869,66862
8600000US66863,29,10,19,,97336,68095,66863
8600000US66864,327,150,177,50750,57344,9062,66864
8600000US66865,949,491,458,62083,69157,10116,66865
8600000US66866,1385,688,697,49282,55827,6300,66866
8600000US66868,631,293,338,59338,71346,9725,66868
8600000US66869,552,272,280,47333,59022,7970,66869
8600000US66870,101,45,56,51875,117566,67199,66870
8600000US66871,1014,472,542,57212,74159,9628,66871
8600000US66872,852,448,404,44167,57463,8383,66872
8600000US66873,213,120,93,55769,57168,11720,66873
8600000US66901,4695,2280,2415,43662,56636,7104,66901
8600000US66930,141,63,78,82632,73666,15080,66930
8600000US66932,75,41,34,29500,31748,9351,66932
8600000US66933,314,160,154,42107,57641,14917,66933
8600000US66935,1830,875,955,46346,57550,8155,66935
8600000US66936,251,123,128,31364,36076,6955,66936
8600000US66937,584,269,315,48209,70521,25692,66937
8600000US66938,815,420,395,44583,58870,7929,66938
8600000US66939,452,222,230,56458,90671,31576,66939
8600000US66940,280,117,163,44792,54526,6573,66940
8600000US66941,159,104,55,34861,44775,10959,66941
8600000US66942,229,126,103,40000,42895,9475,66942
8600000US66943,371,184,187,43676,52530,8166,66943
8600000US66944,145,63,82,56250,97961,40579,66944
8600000US66945,727,389,338,54722,63789,7463,66945
8600000US66946,97,43,54,41912,43737,8743,66946
8600000US66948,389,192,197,53875,102072,43482,66948
8600000US66949,542,295,247,42500,46608,8162,66949
8600000US66951,602,283,319,48897,57936,8083,66951
8600000US66952,313,162,151,35000,47851,8268,66952
8600000US66953,570,272,298,50147,62535,10305,66953
8600000US66955,63,33,30,56250,82800,53527,66955
8600000US66956,910,421,489,47396,66041,12970,66956
8600000US66958,210,143,67,52692,58502,23016,66958
8600000US66959,172,91,81,76071,76714,19852,66959
8600000US66960,119,52,67,45139,87014,52734,66960
8600000US66962,259,138,121,58864,72932,13639,66962
8600000US66963,98,48,50,36563,49770,18973,66963
8600000US66964,119,46,73,19167,25952,6206,66964
8600000US66966,565,295,270,50435,56985,7500,66966
8600000US66967,1641,815,826,41659,65806,7709,66967
8600000US66968,1189,588,601,50481,57919,4859,66968
8600000US66970,105,53,52,19375,23698,8988,66970
8600000US67001,895,469,426,95221,97848,9940,67001
8600000US67002,10155,4888,5267,88699,107453,9135,67002
8600000US67003,1970,936,1034,54583,65398,8020,67003
8600000US67004,557,252,305,57500,59378,6166,67004
8600000US67005,11656,5562,6094,43085,56451,3060,67005
8600000US67008,530,228,302,47656,66162,22432,67008
8600000US67009,663,317,346,49917,60996,8179,67009
8600000US67010,10192,4830,5362,59911,69892,3515,67010
8600000US67012,16,3,13,,,,67012
8600000US67013,2193,1198,995,53229,61279,6650,67013
8600000US67016,385,199,186,65000,66826,6605,67016
8600000US67017,1735,850,885,69769,85590,12169,67017
8600000US67018,139,74,65,28889,57169,30227,67018
8600000US67019,903,423,480,73500,74253,7572,67019
8600000US67020,1191,604,587,57868,68934,7565,67020
8600000US67021,33,11,22,76250,69778,22843,67021
8600000US67022,1107,520,587,43472,62935,10565,67022
8600000US67023,253,127,126,68333,74258,15513,67023
8600000US67024,642,319,323,53177,58439,8565,67024
8600000US67025,2676,1313,1363,74196,91197,9308,67025
8600000US67026,3588,1787,1801,77500,82551,6394,67026
8600000US67028,248,103,145,57321,69383,21664,67028
8600000US67029,775,382,393,51250,56028,6972,67029
8600000US67030,2018,912,1106,95427,104986,8014,67030
8600000US67031,1832,907,925,61950,72888,5852,67031
8600000US67035,720,372,348,63214,86206,11886,67035
8600000US67036,47,25,22,72500,139683,99723,67036
8600000US67037,21093,10432,10661,71673,85733,4031,67037
8600000US67038,543,287,256,53073,62177,9023,67038
8600000US67039,2463,1229,1234,64482,80483,8799,67039
8600000US67041,231,110,121,72917,77047,12194,67041
8600000US67042,14315,7748,6567,47383,60402,3417,67042
8600000US67045,2508,1232,1276,41887,58121,8869,67045
8600000US67047,576,269,307,43274,52508,7168,67047
8600000US67049,87,50,37,38125,54418,20815,67049
8600000US67050,1391,716,675,85455,95059,13704,67050
8600000US67051,358,175,183,40625,49767,11320,67051
8600000US67052,6038,2943,3095,86458,105312,9849,67052
8600000US67053,472,200,272,55833,82160,24673,67053
8600000US67054,965,488,477,46250,65411,9528,67054
8600000US67055,111,64,47,,41950,34610,67055
8600000US67056,2195,1017,1178,56207,63599,6024,67056
8600000US67057,171,103,68,47500,57122,11698,67057
8600000US67058,1330,680,650,48750,58248,5724,67058
8600000US67059,743,353,390,58672,68462,7692,67059
8600000US67060,10116,4898,5218,57681,64243,3500,67060
8600000US67061,132,84,48,50114,61977,30702,67061
8600000US67062,3398,1694,1704,64455,74336,7461,67062
8600000US67063,2970,1452,1518,56563,65420,5091,67063
8600000US67065,162,95,67,62500,77553,17546,67065
8600000US67066,242,119,123,67604,60957,8222,67066
8600000US67067,1324,652,672,90536,98280,9347,67067
8600000US67068,3247,1560,1687,54235,73027,6896,67068
8600000US67070,834,415,419,51458,63058,9654,67070
8600000US67071,181,87,94,87875,82285,17600,67071
8600000US67072,144,82,62,32083,40254,13485,67072
8600000US67073,287,147,140,59688,66274,13490,67073
8600000US67074,1156,599,557,51891,62600,7413,67074
8600000US67101,3111,1307,1804,66981,84878,16363,67101
8600000US67103,159,78,81,82679,81039,14947,67103
8600000US67104,1825,931,894,45801,63115,10531,67104
8600000US67105,107,55,52,46250,59297,17527,67105
8600000US67106,235,134,101,58750,87703,28153,67106
8600000US67107,2377,1056,1321,53185,63698,6667,67107
8600000US67108,1223,613,610,61250,75848,7547,67108
8600000US67109,294,148,146,52375,56767,6464,67109
8600000US67110,6427,3130,3297,65775,75261,6251,67110
8600000US67111,190,81,109,34904,55192,15698,67111
8600000US67112,171,91,80,57500,84063,27142,67112
8600000US67114,16155,8007,8148,52903,65402,4363,67114
8600000US67117,1599,745,854,69491,84841,10481,67117
8600000US67118,504,235,269,63281,81739,28771,67118
8600000US67119,1076,447,629,50000,63626,7577,67119
8600000US67120,907,555,352,89327,94992,24731,67120
8600000US67122,138,75,63,,77327,33523,67122
8600000US67123,518,260,258,47841,76747,21689,67123
8600000US67124,6084,3007,3077,53153,67920,6025,67124
8600000US67127,486,225,261,61154,77804,12166,67127
8600000US67131,290,161,129,52981,63712,22291,67131
8600000US67132,302,131,171,45833,60102,14306,67132
8600000US67133,4679,2252,2427,71964,81516,4981,67133
8600000US67134,330,158,172,54375,78720,16680,67134
8600000US67135,2358,1149,1209,76875,86190,9355,67135
8600000US67137,346,172,174,51125,60290,11493,67137
8600000US67138,246,121,125,52500,85707,43408,67138
8600000US67140,662,294,368,47308,60125,6535,67140
8600000US67142,328,178,150,60592,102146,57980,67142
8600000US67143,20,10,10,43125,61442,35606,67143
8600000US67144,1837,917,920,61821,83673,12477,67144
8600000US67146,1421,669,752,53063,85037,21486,67146
8600000US67147,7618,3645,3973,82806,96898,8958,67147
8600000US67149,634,352,282,68304,86544,11054,67149
8600000US67150,34,18,16,23929,25217,4310,67150
8600000US67151,442,201,241,52917,63491,11530,67151
8600000US67152,6764,3252,3512,49773,60192,4316,67152
8600000US67154,1006,510,496,55625,74448,10289,67154
8600000US67155,157,79,78,78929,110881,37240,67155
8600000US67156,11432,5936,5496,49786,60628,3437,67156
8600000US67159,104,61,43,47813,82074,31207,67159
8600000US67202,1653,1161,492,38611,52051,13315,67202
8600000US67203,23323,12018,11305,42291,53423,2588,67203
8600000US67204,15671,7706,7965,52410,61284,2918,67204
8600000US67205,13903,6598,7305,108819,121056,6917,67205
8600000US67206,12787,6344,6443,75983,126572,11693,67206
8600000US67207,21561,10469,11092,50768,65078,4420,67207
8600000US67208,13234,6537,6697,50437,66445,4075,67208
8600000US67209,10213,5122,5091,72461,78133,4074,67209
8600000US67210,6903,3660,3243,42438,51682,4125,67210
8600000US67211,13689,6836,6853,31813,39373,2809,67211
8600000US67212,34663,16646,18017,57588,69376,2207,67212
8600000US67213,16671,8471,8200,35647,44587,3379,67213
8600000US67214,10330,4782,5548,24100,32896,2365,67214
8600000US67215,4386,2186,2200,90341,91660,6660,67215
8600000US67216,16645,8293,8352,40502,52265,6549,67216
8600000US67217,22046,10371,11675,49536,55870,2739,67217
8600000US67218,16706,7788,8918,39365,52342,2541,67218
8600000US67219,9226,4207,5019,56123,65298,4317,67219
8600000US67220,11095,5669,5426,62546,68778,4616,67220
8600000US67223,456,254,202,103750,117863,19469,67223
8600000US67226,16174,7768,8406,70682,98765,6568,67226
8600000US67227,223,125,98,,118091,51925,67227
8600000US67228,1662,773,889,132440,184993,49323,67228
8600000US67230,8300,4107,4193,122383,167749,16123,67230
8600000US67232,366,148,218,58306,98189,91190,67232
8600000US67235,9323,4430,4893,105429,117716,7816,67235
8600000US67260,0,0,0,,,,67260
8600000US67301,9409,4555,4854,46787,55748,4346,67301
8600000US67330,1072,547,525,58750,65561,5798,67330
8600000US67332,83,34,49,46250,57544,21298,67332
8600000US67333,1953,925,1028,47598,60593,8768,67333
8600000US67334,29,17,12,23750,25010,7116,67334
8600000US67335,2532,1286,1246,48041,59426,7792,67335
8600000US67336,1386,702,684,39330,48454,4973,67336
8600000US67337,9788,4776,5012,40330,58867,6402,67337
8600000US67340,363,212,151,50000,58133,13613,67340
8600000US67341,258,155,103,89375,91305,18990,67341
8600000US67342,697,325,372,57443,64874,7493,67342
8600000US67344,680,353,327,43063,51732,7558,67344
8600000US67345,88,40,48,27500,37933,10296,67345
8600000US67346,269,140,129,53125,62633,11640,67346
8600000US67347,353,177,176,61250,71890,20423,67347
8600000US67349,811,392,419,41429,59482,8684,67349
8600000US67351,223,89,134,37875,52897,14334,67351
8600000US67352,383,194,189,36944,40344,5300,67352
8600000US67353,490,245,245,41500,49786,7047,67353
8600000US67354,607,296,311,52708,57807,9754,67354
8600000US67355,149,75,74,30750,61997,26229,67355
8600000US67356,2125,1068,1057,44556,56996,6253,67356
8600000US67357,9089,4362,4727,43731,55559,4601,67357
8600000US67360,318,186,132,43813,54082,13734,67360
8600000US67361,1340,652,688,34615,53152,8104,67361
8600000US67363,88,37,51,63000,66621,17233,67363
8600000US67364,253,143,110,62500,60509,9863,67364
8600000US67401,39145,19254,19891,49809,65061,2631,67401
8600000US67410,7601,3792,3809,49146,66197,6700,67410
8600000US67416,815,407,408,74236,115571,37466,67416
8600000US67417,134,96,38,63090,60140,9101,67417
8600000US67418,80,38,42,,61700,31762,67418
8600000US67420,3606,1899,1707,45000,57435,6141,67420
8600000US67422,1005,485,520,66250,78804,19144,67422
8600000US67423,202,101,101,71250,108335,43153,67423
8600000US67425,532,262,270,63400,73005,9584,67425
8600000US67427,291,136,155,37813,51551,12206,67427
8600000US67428,1241,647,594,64896,101453,26089,67428
8600000US67430,508,261,247,31786,47515,7034,67430
8600000US67431,1528,791,737,56429,68253,7621,67431
8600000US67432,4204,2023,2181,57188,80536,13651,67432
8600000US67436,574,275,299,55227,61937,9833,67436
8600000US67437,837,416,421,52188,68208,11539,67437
8600000US67438,167,75,92,41806,56488,12361,67438
8600000US67439,2951,1921,1030,47969,63377,7823,67439
8600000US67441,1016,497,519,47891,57297,6699,67441
8600000US67442,192,123,69,75682,99357,48826,67442
8600000US67443,1215,589,626,73100,77992,6437,67443
8600000US67444,396,215,181,49250,58581,9849,67444
8600000US67445,503,240,263,48333,53452,6562,67445
8600000US67446,429,177,252,60278,73703,10045,67446
8600000US67447,243,143,100,63000,57065,17078,67447
8600000US67448,908,492,416,57361,59699,7102,67448
8600000US67449,2265,1147,1118,40292,49898,4811,67449
8600000US67450,519,261,258,48661,54219,8363,67450
8600000US67451,759,365,394,43289,56265,11958,67451
8600000US67452,121,49,72,41667,62285,19882,67452
8600000US67454,452,209,243,43500,53741,11746,67454
8600000US67455,1607,776,831,47697,58399,5539,67455
8600000US67456,3314,1490,1824,61761,67090,5233,67456
8600000US67457,601,291,310,49659,57840,6950,67457
8600000US67458,170,84,86,35441,47234,14352,67458
8600000US67459,187,105,82,49375,49460,10111,67459
8600000US67460,11463,5889,5574,55764,72774,5007,67460
8600000US67464,865,403,462,56635,69347,11326,67464
8600000US67466,651,320,331,43750,58378,7211,67466
8600000US67467,1927,993,934,50132,60450,4863,67467
8600000US67468,226,117,109,58026,63893,12438,67468
8600000US67470,382,203,179,59375,60232,11668,67470
8600000US67473,1318,677,641,44519,64147,8718,67473
8600000US67474,193,84,109,52917,54140,12034,67474
8600000US67475,128,59,69,41500,55859,19091,67475
8600000US67478,48,27,21,48125,50757,21756,67478
8600000US67480,1268,602,666,59808,65370,5759,67480
8600000US67481,437,245,192,41250,55372,9028,67481
8600000US67482,96,43,53,41667,48385,18473,67482
8600000US67483,287,148,139,43542,61642,10202,67483
8600000US67484,702,356,346,45938,69253,17561,67484
8600000US67485,226,121,105,41250,45671,12061,67485
8600000US67487,1066,569,497,57583,84403,23311,67487
8600000US67490,723,351,372,40673,56883,10953,67490
8600000US67491,267,122,145,63333,69556,11139,67491
8600000US67492,210,116,94,65433,58536,11750,67492
8600000US67501,20258,10888,9370,39249,47912,2910,67501
8600000US67502,18496,8612,9884,63755,81860,4614,67502
8600000US67505,2061,931,1130,34469,46074,4522,67505
8600000US67510,228,120,108,46250,61652,22185,67510
8600000US67511,229,108,121,51250,67160,16354,67511
8600000US67512,129,68,61,58750,70399,27383,67512
8600000US67513,66,37,29,27083,34854,12543,67513
8600000US67514,691,316,375,45000,51603,5753,67514
8600000US67515,30,18,12,,85483,76322,67515
8600000US67516,320,158,162,44712,68895,29559,67516
8600000US67518,63,35,28,131667,111796,23907,67518
8600000US67519,136,65,71,42500,49188,9405,67519
8600000US67520,221,112,109,48333,53537,11414,67520
8600000US67521,109,60,49,73438,61469,19912,67521
8600000US67522,1515,730,785,59239,80887,16113,67522
8600000US67523,450,213,237,59063,66281,8614,67523
8600000US67524,439,222,217,41250,48013,6776,67524
8600000US67525,757,386,371,49432,62772,10519,67525
8600000US67526,2336,1140,1196,60125,88468,21123,67526
8600000US67529,239,106,133,32300,46733,13264,67529
8600000US67530,14442,7138,7304,48893,63574,4445,67530
8600000US67543,1435,708,727,58971,67960,7693,67543
8600000US67544,2118,975,1143,50816,58017,4334,67544
8600000US67545,130,69,61,45625,59660,17729,67545
8600000US67546,1840,889,951,63242,71088,6726,67546
8600000US67547,1443,722,721,49539,61321,5097,67547
8600000US67548,1018,480,538,37778,52986,5691,67548
8600000US67550,4727,2780,1947,42143,55594,5500,67550
8600000US67552,452,237,215,48958,59173,7932,67552
8600000US67553,158,84,74,39107,49305,11100,67553
8600000US67554,3125,1564,1561,53619,58579,5459,67554
8600000US67556,235,122,113,48309,51007,11585,67556
8600000US67557,393,190,203,46458,53960,7393,67557
8600000US67559,54,21,33,215729,164729,69561,67559
8600000US67560,1289,644,645,57337,73492,10545,67560
8600000US67561,966,509,457,51400,55224,5420,67561
8600000US67563,255,135,120,51917,67732,11358,67563
8600000US67564,189,92,97,49375,64810,16280,67564
8600000US67565,407,201,206,55000,65342,11825,67565
8600000US67566,429,177,252,61875,74107,14436,67566
8600000US67567,389,192,197,44000,55384,9604,67567
8600000US67568,147,80,67,47857,47760,10934,67568
8600000US67570,978,490,488,52381,63535,6535,67570
8600000US67572,374,187,187,46250,68294,19809,67572
8600000US67573,152,74,78,40000,60880,13681,67573
8600000US67574,146,70,76,46250,97829,41702,67574
8600000US67575,367,183,184,33235,54048,10498,67575
8600000US67576,1529,774,755,55556,74927,8351,67576
8600000US67578,985,454,531,40167,50058,5848,67578
8600000US67579,2663,1337,1326,53194,62805,5487,67579
8600000US67581,222,112,110,56875,69852,16914,67581
8600000US67583,681,373,308,49063,57387,6907,67583
8600000US67584,215,106,109,47656,54642,13872,67584
8600000US67601,19215,9490,9725,51823,71720,7405,67601
8600000US67621,278,125,153,45250,59389,10708,67621
8600000US67622,481,259,222,39911,53586,9613,67622
8600000US67623,157,79,78,37639,55052,19895,67623
8600000US67625,232,109,123,39013,49215,11479,67625
8600000US67626,140,66,74,57500,57133,13974,67626
8600000US67628,94,46,48,48375,72475,35177,67628
8600000US67629,160,89,71,72750,60832,14532,67629
8600000US67631,130,71,59,43750,48877,11251,67631
8600000US67632,157,72,85,40750,54554,14063,67632
8600000US67634,193,100,93,47083,54984,12989,67634
8600000US67635,130,53,77,,40703,9334,67635
8600000US67637,1980,974,1006,57569,75921,13104,67637
8600000US67638,193,100,93,56071,61537,14638,67638
8600000US67639,131,83,48,43654,49373,8219,67639
8600000US67640,426,208,218,58036,68058,10121,67640
8600000US67642,1477,729,748,38208,53704,5634,67642
8600000US67643,220,127,93,65781,68546,14572,67643
8600000US67644,200,100,100,50000,58542,15910,67644
8600000US67645,764,394,370,48854,64801,16968,67645
8600000US67646,582,302,280,46250,54971,4761,67646
8600000US67647,172,89,83,47159,61786,12906,67647
8600000US67648,460,219,241,39653,63511,27052,67648
8600000US67649,172,89,83,60000,65899,10045,67649
8600000US67650,129,49,80,62321,73478,18207,67650
8600000US67651,375,184,191,54583,57499,8402,67651
8600000US67653,251,122,129,35313,42154,7008,67653
8600000US67654,3206,1934,1272,51628,71538,20804,67654
8600000US67656,34,17,17,,84104,54367,67656
8600000US67657,203,100,103,43438,54691,10058,67657
8600000US67658,108,45,63,51250,69480,18169,67658
8600000US67659,73,46,27,32969,34631,8949,67659
8600000US67660,47,20,27,,50161,31476,67660
8600000US67661,2539,1209,1330,48963,63546,8239,67661
8600000US67663,2001,942,1059,56563,66365,5746,67663
8600000US67664,223,114,109,61161,67503,13690,67664
8600000US67665,3988,1995,1993,53444,60930,5785,67665
8600000US67667,144,85,59,63750,87199,23942,67667
8600000US67669,1482,759,723,47610,52778,3666,67669
8600000US67671,1157,595,562,55284,64578,6603,67671
8600000US67672,1985,996,989,55250,67870,6910,67672
8600000US67673,102,48,54,32083,42467,11507,67673
8600000US67674,72,32,40,44125,41994,8323,67674
8600000US67675,138,85,53,43750,48130,13375,67675
8600000US67701,5106,2410,2696,57147,67732,6731,67701
8600000US67730,1267,650,617,50556,59346,4695,67730
8600000US67731,573,319,254,48750,58011,8363,67731
8600000US67732,364,176,188,50179,65819,13975,67732
8600000US67733,194,99,95,54455,82037,26581,67733
8600000US67734,212,119,93,53036,52724,14412,67734
8600000US67735,4004,1946,2058,52952,53675,4612,67735
8600000US67736,161,85,76,62917,75094,23946,67736
8600000US67737,340,177,163,48000,60601,8599,67737
8600000US67738,426,181,245,53214,77034,16173,67738
8600000US67739,155,75,80,45625,57337,15143,67739
8600000US67740,1195,604,591,61500,72007,7610,67740
8600000US67741,305,161,144,36111,60604,19218,67741
8600000US67743,93,51,42,76250,80449,17962,67743
8600000US67744,202,101,101,47396,74505,18932,67744
8600000US67745,277,133,144,47500,65037,10933,67745
8600000US67747,189,108,81,,79887,33483,67747
8600000US67748,1714,829,885,50694,64335,9573,67748
8600000US67749,1648,810,838,42244,60153,8720,67749
8600000US67751,191,103,88,26563,39922,11351,67751
8600000US67752,1009,477,532,49821,63187,7226,67752
8600000US67753,350,165,185,60938,72441,13564,67753
8600000US67756,1528,705,823,46058,59867,6753,67756
8600000US67757,391,214,177,51083,68053,10051,67757
8600000US67758,874,439,435,60833,73687,11305,67758
8600000US67761,185,89,96,55625,67882,14513,67761
8600000US67762,149,83,66,63056,68291,9468,67762
8600000US67764,330,175,155,57375,77832,16934,67764
8600000US67801,21263,11087,10176,52730,68796,3413,67801
8600000US67831,673,333,340,42404,60059,8340,67831
8600000US67834,728,349,379,61563,74778,8479,67834
8600000US67835,1940,935,1005,66771,74723,6206,67835
8600000US67836,133,59,74,33125,47015,18785,67836
8600000US67837,701,366,335,65333,111758,32880,67837
8600000US67838,661,332,329,52059,76242,26478,67838
8600000US67839,1020,503,517,45089,59637,8207,67839
8600000US67840,54,32,22,36250,44318,18339,67840
8600000US67841,291,163,128,58523,56975,8487,67841
8600000US67842,342,184,158,45469,77631,20275,67842
8600000US67843,172,130,42,14383,34556,22021,67843
8600000US67844,628,273,355,51250,68770,10215,67844
8600000US67846,23388,11953,11435,55486,69464,3839,67846
8600000US67849,294,146,148,46750,65008,15072,67849
8600000US67850,253,146,107,60250,64303,11085,67850
8600000US67851,1846,912,934,77829,78754,6014,67851
8600000US67853,503,279,224,62167,81997,12464,67853
8600000US67854,1026,513,513,54792,64316,5426,67854
8600000US67855,1203,598,605,47316,57994,8123,67855
8600000US67857,90,65,25,42969,56224,16988,67857
8600000US67859,602,338,264,45104,62729,13082,67859
8600000US67860,2043,975,1068,49231,65713,8654,67860
8600000US67861,1397,663,734,57344,69388,6905,67861
8600000US67862,315,158,157,41071,46277,10385,67862
8600000US67863,227,128,99,61250,79628,33795,67863
8600000US67864,1512,752,760,54886,64516,7425,67864
8600000US67865,864,415,449,59250,69391,8828,67865
8600000US67867,1345,632,713,60682,68689,8420,67867
8600000US67868,197,110,87,,39335,11143,67868
8600000US67869,984,494,490,60769,67854,9509,67869
8600000US67870,872,434,438,54286,65813,8708,67870
8600000US67871,3660,1797,1863,71305,76821,6457,67871
8600000US67876,1045,499,546,81250,84320,8850,67876
8600000US67877,1793,882,911,51413,69098,6494,67877
8600000US67878,1618,823,795,48846,57808,5566,67878
8600000US67879,889,434,455,51250,56567,5738,67879
8600000US67880,5254,2717,2537,55436,70831,7136,67880
8600000US67882,263,174,89,,51809,19887,67882
8600000US67901,14780,7680,7100,47270,60367,3971,67901
8600000US67950,1545,750,795,43878,55839,6391,67950
8600000US67951,3652,1874,1778,54947,64482,7153,67951
8600000US67952,347,167,180,59318,104108,53823,67952
8600000US67953,89,40,49,,41053,21841,67953
8600000US67954,517,253,264,51250,63533,9695,67954
8600000US68001,85,46,39,73472,70387,9312,68001
8600000US68002,2019,1042,977,76250,87521,8589,68002
8600000US68003,3469,1603,1866,67056,88800,12702,68003
8600000US68004,685,333,352,60250,79813,12982,68004
8600000US68005,17814,8839,8975,57455,70830,4088,68005
8600000US68007,6943,3312,3631,109646,132602,14026,68007
8600000US68008,8954,4070,4884,65730,80020,6133,68008
8600000US68010,84,24,60,56563,54909,24025,68010
8600000US68014,184,100,84,45147,48264,10283,68014
8600000US68015,876,461,415,60500,74523,11655,68015
8600000US68016,377,196,181,74875,118250,41737,68016
8600000US68017,1252,635,617,69836,81055,10414,68017
8600000US68018,339,186,153,101667,97974,18059,68018
8600000US68019,334,171,163,45625,59629,10228,68019
8600000US68020,474,246,228,42841,64882,14677,68020
8600000US68022,16044,7872,8172,105584,138709,9536,68022
8600000US68023,1796,923,873,83082,101873,10469,68023
8600000US68025,23269,11169,12100,52256,66556,3639,68025
8600000US68028,9029,4549,4480,106430,118627,5564,68028
8600000US68029,699,311,388,52500,66292,12591,68029
8600000US68030,581,286,295,64583,75410,8429,68030
8600000US68031,1296,669,627,62667,80783,10316,68031
8600000US68033,274,152,122,73482,80119,17613,68033
8600000US68034,554,299,255,87917,103426,20177,68034
8600000US68036,155,81,74,46406,57831,14259,68036
8600000US68037,1880,845,1035,82895,97333,11190,68037
8600000US68038,1052,527,525,48125,65665,7304,68038
8600000US68039,707,316,391,25446,37091,4580,68039
8600000US68040,461,259,202,80714,69124,10852,68040
8600000US68041,850,428,422,67750,77233,9011,68041
8600000US68042,71,42,29,50625,71309,21949,68042
8600000US68044,430,221,209,56458,65272,10095,68044
8600000US68045,1374,651,723,61382,69760,9027,68045
8600000US68046,20060,9917,10143,92422,106883,4024,68046
8600000US68047,1370,676,694,63676,82502,7739,68047
8600000US68048,9602,4804,4798,65704,77494,3669,68048
8600000US68050,488,278,210,50750,59517,8826,68050
8600000US68055,222,122,100,58750,73162,11857,68055
8600000US68057,1159,605,554,53409,63141,6731,68057
8600000US68058,238,118,120,93352,100434,26261,68058
8600000US68059,2426,1308,1118,74701,92005,9098,68059
8600000US68061,1754,790,964,53160,63343,7403,68061
8600000US68062,227,126,101,72500,103173,42519,68062
8600000US68063,193,98,95,41250,47392,9463,68063
8600000US68064,2752,1290,1462,58704,92166,11752,68064
8600000US68065,1122,571,551,70179,81339,11283,68065
8600000US68066,4037,2001,2036,57738,74916,5931,68066
8600000US68067,775,391,384,42708,51206,4572,68067
8600000US68068,62,28,34,73333,81936,16167,68068
8600000US68069,2164,1057,1107,80352,176294,35914,68069
8600000US68070,446,235,211,41750,57271,12432,68070
8600000US68071,1226,551,675,42875,50541,4467,68071
8600000US68072,53,26,27,38750,82862,113476,68072
8600000US68073,1322,685,637,71111,87478,11096,68073
8600000US68102,7547,4393,3154,53199,75891,10042,68102
8600000US68104,26651,12415,14236,44440,57092,2585,68104
8600000US68105,17605,8980,8625,42233,55679,2864,68105
8600000US68106,16736,8255,8481,56294,70791,5462,68106
8600000US68107,20801,10637,10164,42996,51028,2386,68107
8600000US68108,10620,5620,5000,42022,52337,4079,68108
8600000US68110,6904,3917,2987,29523,37188,3443,68110
8600000US68111,14417,6269,8148,26851,34986,2146,68111
8600000US68112,8373,3869,4504,49796,63167,5063,68112
8600000US68113,605,390,215,51447,65020,9631,68113
8600000US68114,14108,6271,7837,56196,89860,4773,68114
8600000US68116,21621,10182,11439,100590,115995,4682,68116
8600000US68117,6211,3038,3173,48819,59054,4527,68117
8600000US68118,7403,3690,3713,126900,162657,14426,68118
8600000US68122,8168,3696,4472,78173,86813,6399,68122
8600000US68123,22624,11336,11288,79234,94239,3941,68123
8600000US68124,12227,5500,6727,73418,104168,7541,68124
8600000US68127,18011,9481,8530,53490,69559,3772,68127
8600000US68128,14100,6884,7216,70580,84317,3175,68128
8600000US68130,15246,7349,7897,103560,140813,8560,68130
8600000US68131,10895,5524,5371,37105,51671,5486,68131
8600000US68132,11318,5743,5575,60000,98461,8036,68132
8600000US68133,8002,3910,4092,114066,126659,7433,68133
8600000US68134,22571,10471,12100,51784,62744,2251,68134
8600000US68135,19989,9636,10353,111386,124024,4303,68135
8600000US68136,11938,5724,6214,100797,117567,6645,68136
8600000US68137,19457,9651,9806,70041,80341,2914,68137
8600000US68138,9029,4403,4626,77666,88365,9281,68138
8600000US68142,3104,1628,1476,85027,115692,15188,68142
8600000US68144,18376,8750,9626,71063,86330,3637,68144
8600000US68147,8392,4075,4317,58849,68628,5473,68147
8600000US68152,4875,2293,2582,68491,91328,7809,68152
8600000US68154,18352,9367,8985,72097,105285,5646,68154
8600000US68157,4826,2480,2346,67861,77034,5776,68157
8600000US68164,21913,10514,11399,69011,85321,3134,68164
8600000US68178,1507,621,886,,,,68178
8600000US68301,1076,523,553,61528,79993,13842,68301
8600000US68303,238,118,120,50000,75838,17977,68303
8600000US68304,268,131,137,76691,89636,25665,68304
8600000US68305,3134,1572,1562,55099,67667,7011,68305
8600000US68307,382,206,176,48750,65875,16035,68307
8600000US68309,96,47,49,50781,48038,13187,68309
8600000US68310,10884,5168,5716,46969,58979,3380,68310
8600000US68313,476,256,220,65125,79596,14986,68313
8600000US68314,339,166,173,36023,71727,23284,68314
8600000US68315,78,42,36,66250,61672,14168,68315
8600000US68316,450,209,241,67625,70561,12801,68316
8600000US68317,1281,687,594,73750,86277,10696,68317
8600000US68318,351,189,162,48750,59555,13751,68318
8600000US68319,430,241,189,60625,72923,9342,68319
8600000US68320,279,142,137,48529,69205,17385,68320
8600000US68321,253,125,128,35000,49270,10037,68321
8600000US68322,351,195,156,55208,68600,11757,68322
8600000US68323,217,103,114,43750,88547,56467,68323
8600000US68324,83,49,34,,112736,44466,68324
8600000US68325,149,81,68,78438,95896,28410,68325
8600000US68326,180,95,85,49625,74510,16447,68326
8600000US68327,229,108,121,39091,48999,12984,68327
8600000US68328,361,189,172,67969,81515,18823,68328
8600000US68329,458,232,226,48750,65179,11322,68329
8600000US68331,682,346,336,58523,77461,10535,68331
8600000US68332,100,49,51,25694,40461,12143,68332
8600000US68333,6260,3121,3139,48235,60262,5918,68333
8600000US68335,408,211,197,42206,61019,11260,68335
8600000US68336,411,198,213,97500,126063,39667,68336
8600000US68337,250,125,125,44402,56577,16268,68337
8600000US68338,245,131,114,46875,88433,23750,68338
8600000US68339,1049,532,517,97417,115925,20384,68339
8600000US68340,684,340,344,50313,55505,4974,68340
8600000US68341,849,465,384,66058,77169,11411,68341
8600000US68342,429,245,184,50417,72121,10742,68342
8600000US68343,773,400,373,56964,69058,6941,68343
8600000US68344,295,131,164,73199,71245,9845,68344
8600000US68345,190,105,85,53750,58730,9701,68345
8600000US68346,441,238,203,63056,64163,11710,68346
8600000US68347,1984,1043,941,85000,125970,21154,68347
8600000US68348,235,127,108,62672,59720,8569,68348
8600000US68349,831,432,399,81786,94192,13959,68349
8600000US68350,164,79,85,50000,84458,42234,68350
8600000US68351,703,370,333,62500,83302,16387,68351
8600000US68352,3786,1752,2034,38241,50504,4647,68352
8600000US68354,806,383,423,63512,70766,7110,68354
8600000US68355,3765,1781,1984,46591,60663,6296,68355
8600000US68357,268,143,125,67500,96101,18118,68357
8600000US68358,1347,674,673,112621,112913,12188,68358
8600000US68359,1248,689,559,61923,78044,10364,68359
8600000US68360,428,213,215,96637,120239,23637,68360
8600000US68361,1691,803,888,55909,75824,10073,68361
8600000US68362,27,19,8,,67620,20318,68362
8600000US68364,82,40,42,69063,67494,10625,68364
8600000US68365,211,96,115,63333,61318,10222,68365
8600000US68366,784,364,420,66583,75989,11518,68366
8600000US68367,264,137,127,55000,80695,17409,68367
8600000US68368,449,239,210,81346,95959,22206,68368
8600000US68370,1683,807,876,54135,65727,5392,68370
8600000US68371,1104,550,554,56172,67362,8382,68371
8600000US68372,2167,1061,1106,98384,101817,11257,68372
8600000US68375,73,33,40,21797,32980,9999,68375
8600000US68376,1218,586,632,49327,60831,6680,68376
8600000US68377,325,164,161,48646,67311,23779,68377
8600000US68378,521,249,272,56518,63524,7289,68378
8600000US68379,44,19,25,52000,62254,19123,68379
8600000US68380,72,44,28,39750,51316,17650,68380
8600000US68381,165,85,80,38882,48708,11968,68381
8600000US68382,19,8,11,86250,93256,33239,68382
8600000US68401,499,242,257,73224,82977,13998,68401
8600000US68402,957,501,456,82656,91284,12259,68402
8600000US68403,137,67,70,64792,74522,9214,68403
8600000US68404,728,367,361,69076,78746,12683,68404
8600000US68405,2618,1338,1280,56250,75201,8702,68405
8600000US68406,368,188,180,33295,50004,11663,68406
8600000US68407,547,273,274,66719,75180,9248,68407
8600000US68409,655,326,329,85000,95963,12431,68409
8600000US68410,6662,3197,3465,47446,63041,5837,68410
8600000US68413,457,212,245,76326,85779,22697,68413
8600000US68414,193,106,87,,93428,35255,68414
8600000US68415,497,261,236,50938,71153,10447,68415
8600000US68416,205,115,90,34500,52763,10056,68416
8600000US68417,244,110,134,61500,68987,15776,68417
8600000US68418,876,444,432,68906,78160,9876,68418
8600000US68419,203,99,104,82708,92075,16894,68419
8600000US68420,1042,477,565,44643,56898,6800,68420
8600000US68421,1086,513,573,54063,61621,11913,68421
8600000US68422,384,200,184,81645,90055,12929,68422
8600000US68423,875,436,439,80189,74762,7721,68423
8600000US68424,564,302,262,47206,58296,10878,68424
8600000US68428,1041,498,543,105833,101648,13929,68428
8600000US68430,1215,626,589,89286,100473,13769,68430
8600000US68431,256,146,110,63828,61897,10916,68431
8600000US68433,164,79,85,24375,44775,16262,68433
8600000US68434,6698,3387,3311,69167,77370,4231,68434
8600000US68436,442,234,208,51146,66719,9970,68436
8600000US68437,207,106,101,63333,88930,29498,68437
8600000US68438,86,50,36,72500,86096,23913,68438
8600000US68439,389,190,199,64605,71267,9875,68439
8600000US68440,70,39,31,33750,47783,16035,68440
8600000US68441,138,60,78,70938,76691,18970,68441
8600000US68442,257,127,130,45833,62818,18319,68442
8600000US68443,726,362,364,63958,76882,7546,68443
8600000US68444,61,31,30,76875,64052,21765,68444
8600000US68445,84,47,37,53750,58813,8718,68445
8600000US68446,2111,979,1132,59695,75062,5735,68446
8600000US68447,451,220,231,36875,55230,11313,68447
8600000US68448,315,158,157,50313,72445,22481,68448
8600000US68450,2678,1799,879,46397,63739,8681,68450
8600000US68452,60,34,26,41875,50631,12691,68452
8600000US68453,300,181,119,54511,61237,11911,68453
8600000US68454,488,223,265,75234,79168,9659,68454
8600000US68455,353,159,194,57500,78506,22745,68455
8600000US68456,894,469,425,68864,89589,12490,68456
8600000US68457,263,149,114,68750,66484,8657,68457
8600000US68458,121,68,53,61250,69903,17031,68458
8600000US68460,534,276,258,70833,78743,9810,68460
8600000US68461,431,211,220,,113841,53163,68461
8600000US68462,2978,1467,1511,86538,88553,6706,68462
8600000US68463,1040,525,515,61985,69640,6170,68463
8600000US68464,443,240,203,60500,60594,6662,68464
8600000US68465,1665,795,870,56500,62139,4502,68465
8600000US68466,1381,770,611,44559,55731,5011,68466
8600000US68467,7373,3355,4018,58221,76848,9475,68467
8600000US68502,21009,11271,9738,51944,68858,3965,68502
8600000US68503,12170,6411,5759,33773,47569,3067,68503
8600000US68504,14069,7147,6922,40907,48429,2572,68504
8600000US68505,12878,6408,6470,57522,66732,3413,68505
8600000US68506,23095,10677,12418,57473,75088,3352,68506
8600000US68507,11311,5454,5857,55850,67083,3651,68507
8600000US68508,15534,8187,7347,23678,33159,2577,68508
8600000US68510,16690,8030,8660,53987,67179,3547,68510
8600000US68512,10035,5024,5011,76667,105438,6131,68512
8600000US68514,110,40,70,171250,158253,27206,68514
8600000US68516,33022,15870,17152,82008,102713,3617,68516
8600000US68517,412,218,194,132500,119639,36989,68517
8600000US68520,1286,646,640,130278,164806,24985,68520
8600000US68521,26296,12917,13379,54659,71227,4212,68521
8600000US68522,9945,5432,4513,67148,74402,4330,68522
8600000US68523,1049,574,475,110096,127532,32407,68523
8600000US68524,4035,1950,2085,63605,75433,12156,68524
8600000US68526,4849,2377,2472,119375,137672,12646,68526
8600000US68527,549,266,283,141591,199796,52899,68527
8600000US68528,4952,2504,2448,63590,69857,5282,68528
8600000US68531,214,96,118,59821,62839,14009,68531
8600000US68532,428,235,193,101607,108673,17600,68532
8600000US68601,21234,10698,10536,61888,74257,3537,68601
8600000US68620,2009,975,1034,54294,75694,8328,68620
8600000US68621,442,231,211,60625,59697,9553,68621
8600000US68622,234,133,101,54375,60342,12168,68622
8600000US68623,217,97,120,42250,47648,7854,68623
8600000US68624,776,426,350,65854,70431,10108,68624
8600000US68626,494,272,222,50250,64011,8730,68626
8600000US68627,545,282,263,62083,82956,15378,68627
8600000US68628,613,308,305,54076,75316,22445,68628
8600000US68629,1012,509,503,54167,61318,5542,68629
8600000US68631,319,153,166,42083,55963,12093,68631
8600000US68632,2972,1423,1549,52440,64186,5178,68632
8600000US68633,954,450,504,53917,66453,7260,68633
8600000US68634,380,198,182,68750,75215,13868,68634
8600000US68635,308,162,146,77857,81418,13336,68635
8600000US68636,1056,519,537,57083,62514,5509,68636
8600000US68637,310,141,169,49417,55388,12095,68637
8600000US68638,1332,616,716,47143,72678,19244,68638
8600000US68640,1215,643,572,52212,72400,11967,68640
8600000US68641,928,464,464,60625,64092,5944,68641
8600000US68642,1303,666,637,69583,74765,6760,68642
8600000US68643,754,374,380,65341,72458,9047,68643
8600000US68644,445,232,213,72308,78189,11188,68644
8600000US68647,481,245,236,65417,82598,18065,68647
8600000US68648,340,159,181,72102,80040,11832,68648
8600000US68649,1569,803,766,72944,83446,8883,68649
8600000US68651,1068,515,553,67857,78156,6242,68651
8600000US68652,496,250,246,46250,62906,10094,68652
8600000US68653,525,268,257,52663,70476,12865,68653
8600000US68654,414,206,208,53542,66846,8500,68654
8600000US68655,138,76,62,70417,72109,23473,68655
8600000US68658,582,305,277,61250,74284,14505,68658
8600000US68659,133,67,66,48750,53979,11635,68659
8600000US68660,909,452,457,54318,64014,8423,68660
8600000US68661,4982,2843,2139,57281,64755,6070,68661
8600000US68662,1088,530,558,65500,68723,7607,68662
8600000US68663,544,260,284,42647,48647,5599,68663
8600000US68664,254,130,124,45000,58797,11371,68664
8600000US68665,667,339,328,48125,59278,6331,68665
8600000US68666,1131,528,603,58913,80129,13978,68666
8600000US68667,91,43,48,,89811,31660,68667
8600000US68669,349,186,163,50000,61970,11997,68669
8600000US68701,23036,11308,11728,52859,69521,4012,68701
8600000US68710,561,253,308,52917,68355,12720,68710
8600000US68711,247,139,108,118143,91310,26447,68711
8600000US68713,1627,802,825,51569,67948,8702,68713
8600000US68714,985,492,493,52955,76715,9643,68714
8600000US68715,1155,595,560,58942,68114,6164,68715
8600000US68716,842,387,455,57778,63528,7241,68716
8600000US68717,174,96,78,71250,82684,17306,68717
8600000US68718,1285,655,630,44688,61864,9028,68718
8600000US68719,111,60,51,48958,66455,31641,68719
8600000US68720,224,119,105,59861,91252,29733,68720
8600000US68722,454,226,228,60917,67071,10793,68722
8600000US68723,401,198,203,62333,69403,12728,68723
8600000US68724,117,49,68,43167,44556,8878,68724
8600000US68725,404,192,212,53542,68773,15794,68725
8600000US68726,456,231,225,48393,49400,7570,68726
8600000US68727,625,328,297,61875,83604,20700,68727
8600000US68728,180,97,83,54375,55550,12223,68728
8600000US68729,1486,706,780,51607,68065,7366,68729
8600000US68730,1302,675,627,63125,74274,6544,68730
8600000US68731,2030,1077,953,71324,83602,11873,68731
8600000US68732,171,100,71,54444,61263,11473,68732
8600000US68733,1047,549,498,58894,73495,12346,68733
8600000US68734,69,32,37,76667,69456,8701,68734
8600000US68735,559,265,294,52188,60073,7687,68735
8600000US68736,481,236,245,56406,63612,10164,68736
8600000US68739,2178,1122,1056,63673,76070,6923,68739
8600000US68740,800,421,379,80250,78571,8067,68740
8600000US68741,527,283,244,67250,83425,13888,68741
8600000US68742,174,77,97,48750,49259,13366,68742
8600000US68743,411,209,202,65714,90189,27778,68743
8600000US68745,1102,501,601,53000,69126,7210,68745
8600000US68746,292,159,133,35938,49174,8014,68746
8600000US68747,91,39,52,66250,63772,12309,68747
8600000US68748,2151,1131,1020,56375,63029,5400,68748
8600000US68749,58,32,26,47500,53209,15939,68749
8600000US68751,69,33,36,45938,66376,26393,68751
8600000US68752,629,338,291,58173,68943,9623,68752
8600000US68753,82,40,42,72917,92376,33720,68753
8600000US68755,260,125,135,54706,61947,11211,68755
8600000US68756,1409,640,769,45855,63442,8586,68756
8600000US68757,637,338,299,50417,55905,7975,68757
8600000US68758,979,500,479,48625,61195,6883,68758
8600000US68759,192,99,93,42750,59826,13159,68759
8600000US68760,920,431,489,41116,49350,4010,68760
8600000US68761,300,143,157,38750,44272,7151,68761
8600000US68763,3547,1781,1766,61489,71611,6652,68763
8600000US68764,640,344,296,41953,59892,13028,68764
8600000US68765,984,517,467,52039,63282,7205,68765
8600000US68766,331,146,185,56823,78133,24524,68766
8600000US68767,2527,1264,1263,63413,73997,6042,68767
8600000US68768,471,260,211,54583,69700,13470,68768
8600000US68769,1297,621,676,49688,59071,6034,68769
8600000US68770,1124,558,566,55313,72316,10220,68770
8600000US68771,1126,554,572,55167,65979,6014,68771
8600000US68773,141,102,39,68750,56790,13073,68773
8600000US68774,174,78,96,58750,67274,12960,68774
8600000US68776,10392,5014,5378,53387,64440,7629,68776
8600000US68777,515,246,269,46750,69154,15828,68777
8600000US68778,441,222,219,49297,63616,7790,68778
8600000US68779,1923,902,1021,61875,69111,5212,68779
8600000US68780,815,426,389,54417,70166,16017,68780
8600000US68781,1198,603,595,51679,65377,8653,68781
8600000US68783,750,336,414,41250,50072,6721,68783
8600000US68784,1421,706,715,66111,72696,5744,68784
8600000US68785,182,95,87,110625,122233,35523,68785
8600000US68786,811,432,379,63750,84059,13831,68786
8600000US68787,5278,2592,2686,45500,64595,7150,68787
8600000US68788,3410,1799,1611,48234,66119,7148,68788
8600000US68789,126,59,67,,60148,20126,68789
8600000US68790,654,330,324,62188,77233,13297,68790
8600000US68791,1361,689,672,55956,72991,9349,68791
8600000US68792,312,144,168,61250,70853,15790,68792
8600000US68801,21528,11274,10254,51570,65251,2933,68801
8600000US68803,18309,8457,9852,56788,75907,6641,68803
8600000US68810,702,348,354,47250,57658,7310,68810
8600000US68812,413,219,194,64583,81041,14115,68812
8600000US68813,368,197,171,58571,70931,23562,68813
8600000US68814,698,375,323,51786,66196,8449,68814
8600000US68815,433,217,216,39940,62228,11827,68815
8600000US68816,174,103,71,54792,52498,17155,68816
8600000US68817,231,117,114,45833,46936,8076,68817
8600000US68818,4118,1982,2136,65426,79581,5409,68818
8600000US68820,291,171,120,52813,57841,8830,68820
8600000US68821,47,22,25,34375,41839,7732,68821
8600000US68822,3476,1637,1839,50257,85600,25187,68822
8600000US68823,1787,870,917,49250,60533,5535,68823
8600000US68824,1054,523,531,66250,75217,8717,68824
8600000US68825,893,416,477,48533,59796,8310,68825
8600000US68826,3155,1542,1613,54129,69425,7725,68826
8600000US68827,446,220,226,63281,75843,16023,68827
8600000US68828,233,133,100,60000,72803,15762,68828
8600000US68831,608,315,293,73750,71228,9352,68831
8600000US68832,1624,829,795,80197,91715,10019,68832
8600000US68833,294,166,128,51029,60353,10100,68833
8600000US68834,130,66,64,42188,50241,11274,68834
8600000US68835,465,288,177,52639,52728,5215,68835
8600000US68836,1267,641,626,63382,75862,10507,68836
8600000US68837,118,59,59,70885,65591,9642,68837
8600000US68838,196,99,97,61696,64330,9224,68838
8600000US68840,2277,1173,1104,59179,68954,6024,68840
8600000US68841,378,198,180,65938,75078,7137,68841
8600000US68842,484,223,261,50577,66151,9760,68842
8600000US68843,586,272,314,64531,77466,8926,68843
8600000US68844,212,122,90,43971,55170,9811,68844
8600000US68845,15939,7935,8004,57672,85002,7295,68845
8600000US68846,200,117,83,60625,62949,7601,68846
8600000US68847,13006,6379,6627,55236,66129,4041,68847
8600000US68849,1020,363,657,,,,68849
8600000US68850,8699,4718,3981,54231,62978,4097,68850
8600000US68852,433,220,213,63125,62918,5956,68852
8600000US68853,1222,581,641,47250,55325,5647,68853
8600000US68854,652,330,322,50469,79268,16424,68854
8600000US68855,284,156,128,48333,63383,14092,68855
8600000US68856,510,279,231,54792,77054,15566,68856
8600000US68858,232,109,123,51250,59527,16834,68858
8600000US68859,439,204,235,46023,56539,13850,68859
8600000US68860,252,124,128,53889,53517,9895,68860
8600000US68861,81,44,37,,77244,39403,68861
8600000US68862,2356,1149,1207,55347,69439,8802,68862
8600000US68863,886,469,417,51438,82557,17259,68863
8600000US68864,850,414,436,58235,71618,10118,68864
8600000US68865,745,377,368,64063,90352,16877,68865
8600000US68866,681,359,322,58750,72081,7652,68866
8600000US68869,1592,801,791,49479,72113,10792,68869
8600000US68870,438,220,218,75938,88429,11344,68870
8600000US68871,234,120,114,62981,71624,18586,68871
8600000US68872,661,378,283,50167,66379,9796,68872
8600000US68873,2552,1146,1406,53333,63464,5387,68873
8600000US68874,685,331,354,35500,64893,27714,68874
8600000US68875,517,256,261,46458,57661,5992,68875
8600000US68876,1222,629,593,53500,66166,7595,68876
8600000US68878,291,149,142,56094,61732,9123,68878
8600000US68879,318,166,152,47188,60794,10436,68879
8600000US68881,20,10,10,,,,68881
8600000US68882,275,139,136,40250,53715,10914,68882
8600000US68883,1945,1024,921,57083,74429,7986,68883
8600000US68901,20072,9888,10184,48552,68287,4259,68901
8600000US68920,1394,718,676,51048,64593,6472,68920
8600000US68922,1039,484,555,57917,70603,8189,68922
8600000US68923,78,34,44,75625,82189,29413,68923
8600000US68924,849,400,449,63750,81373,13980,68924
8600000US68925,395,212,183,72875,83822,15948,68925
8600000US68926,494,248,246,38661,48284,7689,68926
8600000US68927,974,494,480,57500,75361,10618,68927
8600000US68928,260,128,132,48125,70847,13675,68928
8600000US68929,148,88,60,47500,42373,9441,68929
8600000US68930,1119,576,543,53125,70570,9379,68930
8600000US68932,378,179,199,47750,57192,7996,68932
8600000US68933,701,363,338,57143,60649,5145,68933
8600000US68934,94,85,9,,46382,14159,68934
8600000US68935,476,205,271,49722,59584,9164,68935
8600000US68936,175,97,78,31250,41646,9366,68936
8600000US68937,1328,618,710,61862,79029,9896,68937
8600000US68938,397,226,171,48750,62572,13241,68938
8600000US68939,940,414,526,46100,58308,7912,68939
8600000US68940,474,278,196,64833,84596,13941,68940
8600000US68941,627,352,275,70795,93788,18729,68941
8600000US68942,251,134,117,51000,63478,10235,68942
8600000US68943,186,84,102,44500,53567,11247,68943
8600000US68944,1016,492,524,55114,63964,6885,68944
8600000US68945,202,88,114,70658,70368,11883,68945
8600000US68946,12,6,6,42500,48460,19936,68946
8600000US68947,479,266,213,57292,76766,11538,68947
8600000US68948,254,122,132,41250,51975,11252,68948
8600000US68949,4904,2316,2588,55160,66323,5719,68949
8600000US68950,308,171,137,45625,64565,10747,68950
8600000US68952,99,54,45,45833,44322,11753,68952
8600000US68954,14,0,14,,,,68954
8600000US68955,1531,771,760,76063,81032,7694,68955
8600000US68956,1048,502,546,60057,70736,6810,68956
8600000US68957,474,246,228,50250,69877,15798,68957
8600000US68958,486,261,225,59167,77354,10571,68958
8600000US68959,2958,1446,1512,54948,71669,8320,68959
8600000US68960,108,53,55,36667,45739,7693,68960
8600000US68961,638,327,311,50000,66059,9653,68961
8600000US68964,50,28,22,52500,48824,7903,68964
8600000US68966,560,313,247,47721,55092,7440,68966
8600000US68967,679,379,300,49145,67634,14863,68967
8600000US68969,35,19,16,63333,61360,15270,68969
8600000US68970,1130,566,564,36193,53356,8834,68970
8600000US68971,255,125,130,37500,49246,8884,68971
8600000US68972,102,49,53,46875,74837,29587,68972
8600000US68973,292,155,137,60833,73984,9953,68973
8600000US68974,157,77,80,68125,69269,15434,68974
8600000US68975,125,64,61,75417,76217,7793,68975
8600000US68976,281,128,153,83864,89958,11822,68976
8600000US68977,138,66,72,57813,59916,15393,68977
8600000US68978,1727,802,925,37457,55674,11322,68978
8600000US68979,1402,692,710,56250,68567,6561,68979
8600000US68980,315,162,153,63125,85407,16098,68980
8600000US68981,309,159,150,59417,56905,8702,68981
8600000US68982,503,250,253,59926,77524,12606,68982
8600000US69001,6946,3395,3551,45907,59354,5069,69001
8600000US69020,352,181,171,53750,79900,26038,69020
8600000US69021,1036,478,558,43125,59426,7541,69021
8600000US69022,1467,706,761,53000,64242,5918,69022
8600000US69023,237,113,124,61442,72001,34372,69023
8600000US69024,897,435,462,52708,62291,7204,69024
8600000US69025,908,422,486,44688,65647,13136,69025
8600000US69026,155,73,82,35662,38614,12145,69026
8600000US69027,28,15,13,,28517,13903,69027
8600000US69028,643,329,314,60469,71999,9351,69028
8600000US69029,334,160,174,60357,65997,13031,69029
8600000US69030,233,113,120,52000,52191,9454,69030
8600000US69032,429,230,199,44432,58745,7919,69032
8600000US69033,1906,922,984,59625,69872,6547,69033
8600000US69034,821,421,400,61364,70099,10377,69034
8600000US69036,64,35,29,56458,52557,8989,69036
8600000US69037,93,49,44,36250,60832,25802,69037
8600000US69038,422,226,196,53333,73691,15873,69038
8600000US69039,65,29,36,,101527,34488,69039
8600000US69040,487,220,267,42386,63620,15052,69040
8600000US69041,54,25,29,27143,35500,14709,69041
8600000US69042,12,6,6,,53375,32525,69042
8600000US69043,389,179,210,43833,52163,10722,69043
8600000US69044,631,351,280,35417,61336,23856,69044
8600000US69045,891,474,417,51713,57915,6516,69045
8600000US69046,123,69,54,49327,56080,12262,69046
8600000US69101,22114,10805,11309,55226,68769,4097,69101
8600000US69120,906,463,443,60069,77366,12224,69120
8600000US69121,257,128,129,42813,58380,13626,69121
8600000US69122,545,273,272,50781,63359,10539,69122
8600000US69123,676,333,343,63750,97400,31624,69123
8600000US69125,277,156,121,40341,50779,11718,69125
8600000US69127,759,399,360,54861,70027,10483,69127
8600000US69128,115,64,51,38125,50773,12209,69128
8600000US69129,963,432,531,47260,60921,7076,69129
8600000US69130,3916,1824,2092,46378,68554,12582,69130
8600000US69131,420,204,216,54444,66567,11499,69131
8600000US69132,113,52,61,65809,61797,12119,69132
8600000US69133,384,197,187,40893,55646,12184,69133
8600000US69134,309,151,158,62188,68381,13427,69134
8600000US69135,94,38,56,62891,90660,65253,69135
8600000US69138,2887,1449,1438,66612,81536,8708,69138
8600000US69140,1383,677,706,67639,87176,13519,69140
8600000US69141,321,148,173,48500,65436,9990,69141
8600000US69142,68,32,36,35313,47153,17563,69142
8600000US69143,1005,520,485,63500,71286,6923,69143
8600000US69144,130,56,74,,43301,25614,69144
8600000US69145,2432,1223,1209,44969,55168,4813,69145
8600000US69146,278,183,95,41591,49270,18076,69146
8600000US69147,420,224,196,39444,58168,16017,69147
8600000US69148,131,75,56,66563,228959,180510,69148
8600000US69149,569,274,295,53333,65362,8295,69149
8600000US69150,242,140,102,38542,50521,10586,69150
8600000US69151,672,350,322,63281,74705,10185,69151
8600000US69152,690,353,337,39554,58953,9045,69152
8600000US69153,4347,2094,2253,45703,58145,4122,69153
8600000US69154,905,448,457,41708,56702,6547,69154
8600000US69155,892,501,391,65089,71756,6799,69155
8600000US69156,549,288,261,50417,83642,23516,69156
8600000US69157,54,26,28,,82857,38854,69157
8600000US69161,80,34,46,19861,39437,23819,69161
8600000US69162,5696,2870,2826,57950,71530,4342,69162
8600000US69163,702,354,348,57500,66582,6069,69163
8600000US69165,1437,713,724,71852,79148,10091,69165
8600000US69166,545,278,267,57188,66564,9007,69166
8600000US69167,279,138,141,48304,59608,11238,69167
8600000US69168,182,98,84,68929,65096,14334,69168
8600000US69169,477,233,244,61875,81569,13399,69169
8600000US69170,231,127,104,44500,61555,11045,69170
8600000US69171,7,3,4,,,,69171
8600000US69201,2911,1340,1571,53674,57363,5634,69201
8600000US69210,1771,859,912,44375,64734,12533,69210
8600000US69211,333,190,143,40417,59130,11695,69211
8600000US69212,164,82,82,28523,31403,13452,69212
8600000US69214,249,130,119,41875,49701,8452,69214
8600000US69216,104,58,46,47500,58073,19355,69216
8600000US69217,375,164,211,27963,43093,10520,69217
8600000US69218,188,110,78,52159,54737,8401,69218
8600000US69219,146,67,79,72778,73126,16524,69219
8600000US69220,20,11,9,42813,99309,95084,69220
8600000US69221,154,64,90,48854,61237,12370,69221
8600000US69301,7270,3560,3710,54583,66420,4754,69301
8600000US69331,49,22,27,44583,77040,59250,69331
8600000US69333,218,116,102,59167,90241,46887,69333
8600000US69334,1480,781,699,44167,63960,13048,69334
8600000US69335,40,22,18,,40391,13222,69335
8600000US69336,1988,960,1028,47257,61459,5141,69336
8600000US69337,5826,3000,2826,53414,62099,6618,69337
8600000US69339,1179,540,639,42379,53247,7055,69339
8600000US69340,99,62,37,43516,56673,22651,69340
8600000US69341,7941,3760,4181,57857,74332,8227,69341
8600000US69343,1721,786,935,36348,60518,12203,69343
8600000US69345,330,168,162,58906,97399,22587,69345
8600000US69346,493,232,261,41458,59772,9765,69346
8600000US69347,1106,540,566,56964,78217,15748,69347
8600000US69348,1176,596,580,65972,72532,6557,69348
8600000US69350,351,182,169,35750,66608,19326,69350
8600000US69351,188,114,74,50417,62577,24935,69351
8600000US69352,540,279,261,53625,60238,8860,69352
8600000US69353,15,8,7,36250,38733,28130,69353
8600000US69354,135,61,74,53333,45876,17451,69354
8600000US69355,133,76,57,61875,59463,19273,69355
8600000US69356,1480,711,769,45000,51544,5691,69356
8600000US69357,2837,1427,1410,51165,66415,8705,69357
8600000US69358,1470,730,740,63750,72754,8370,69358
8600000US69360,1073,524,549,42118,52697,6338,69360
8600000US69361,13040,6117,6923,46729,66369,5194,69361
8600000US69365,21,12,9,,,,69365
8600000US69366,194,99,95,48194,55474,10023,69366
8600000US69367,193,105,88,70813,70407,16519,69367
8600000US70001,31565,15178,16387,51132,71218,3291,70001
8600000US70002,16769,7852,8917,56786,88894,8115,70002
8600000US70003,32640,15599,17041,58624,74662,2634,70003
8600000US70005,20623,9871,10752,62982,105106,6923,70005
8600000US70006,12885,6166,6719,63695,86943,7171,70006
8600000US70030,2847,1477,1370,59735,82617,14600,70030
8600000US70031,1050,480,570,62143,68648,9894,70031
8600000US70032,3483,1725,1758,47717,58601,5029,70032
8600000US70036,862,544,318,45819,58194,9809,70036
8600000US70037,11784,5907,5877,64280,83890,6768,70037
8600000US70038,184,80,104,14868,29367,10983,70038
8600000US70039,1905,906,999,33500,46977,8845,70039
8600000US70040,837,358,479,32697,59922,26317,70040
8600000US70041,1906,945,961,32852,45350,7556,70041
8600000US70043,16867,8125,8742,43520,55143,2828,70043
8600000US70047,9580,4352,5228,89109,101425,7420,70047
8600000US70049,1672,759,913,34875,59208,23164,70049
8600000US70050,84,53,31,28158,26894,13514,70050
8600000US70051,1260,597,663,46585,59264,13035,70051
8600000US70052,2940,1422,1518,52072,67669,9611,70052
8600000US70053,13208,6828,6380,42311,56324,4300,70053
8600000US70056,29487,14632,14855,51182,71517,4628,70056
8600000US70057,3751,2309,1442,60294,74012,13595,70057
8600000US70058,29169,14090,15079,47935,63713,3128,70058
8600000US70062,12997,6113,6884,39632,50588,2925,70062
8600000US70065,39392,18853,20539,59243,79035,4111,70065
8600000US70067,2148,1079,1069,45556,63805,8226,70067
8600000US70068,25450,12310,13140,61252,78379,5275,70068
8600000US70070,10016,4901,5115,82218,96201,6515,70070
8600000US70071,2786,1291,1495,47083,59808,6977,70071
8600000US70072,42904,19816,23088,50954,65278,2922,70072
8600000US70075,4284,2089,2195,70642,82156,8330,70075
8600000US70076,162,87,75,47083,43225,8206,70076
8600000US70079,2281,1046,1235,66462,89371,23037,70079
8600000US70080,1306,529,777,75250,72435,11161,70080
8600000US70082,287,102,185,12188,17106,13415,70082
8600000US70083,1891,909,982,28534,36801,8979,70083
8600000US70084,5111,2567,2544,42870,53299,5003,70084
8600000US70085,3462,1747,1715,37316,51895,5568,70085
8600000US70086,1647,782,865,31168,55800,9841,70086
8600000US70087,5647,2633,3014,49167,65729,6262,70087
8600000US70090,5540,2567,2973,43681,58818,5282,70090
8600000US70091,266,182,84,50313,56812,14532,70091
8600000US70092,5276,2474,2802,41927,54048,5514,70092
8600000US70094,22694,10371,12323,34746,48023,2546,70094
8600000US70112,2355,1344,1011,48934,63860,9078,70112
8600000US70113,6315,3298,3017,16083,39625,5792,70113
8600000US70114,18918,8340,10578,30009,48128,3046,70114
8600000US70115,28793,14118,14675,65158,114418,7523,70115
8600000US70116,10186,5702,4484,35391,70458,9614,70116
8600000US70117,21936,10163,11773,27757,44169,1867,70117
8600000US70118,30515,13997,16518,43743,90261,5115,70118
8600000US70119,32730,17023,15707,36785,56612,2272,70119
8600000US70121,9600,4554,5046,50719,66512,4162,70121
8600000US70122,28660,12402,16258,36939,57347,2405,70122
8600000US70123,21938,10451,11487,65006,87770,4496,70123
8600000US70124,16116,7818,8298,93428,134279,8186,70124
8600000US70125,14913,6782,8131,44866,71112,4025,70125
8600000US70126,20327,8256,12071,26425,39387,2404,70126
8600000US70127,18793,8240,10553,26530,40216,2444,70127
8600000US70128,14718,6087,8631,36294,56681,4345,70128
8600000US70129,7525,3737,3788,35386,49290,3618,70129
8600000US70130,12779,6615,6164,50743,88225,7868,70130
8600000US70131,25329,11601,13728,48576,74523,4182,70131
8600000US70139,0,0,0,,,,70139
8600000US70163,0,0,0,,,,70163
8600000US70301,34986,16388,18598,49838,71564,3671,70301
8600000US70339,4621,2229,2392,45526,70946,14471,70339
8600000US70340,19,0,19,,,,70340
8600000US70341,3078,1630,1448,39222,57430,10618,70341
8600000US70342,3501,1662,1839,44330,66733,9163,70342
8600000US70343,3914,2014,1900,60753,69444,9252,70343
8600000US70344,4260,2125,2135,40238,53213,6411,70344
8600000US70345,7291,3470,3821,56828,67559,8899,70345
8600000US70346,8723,4104,4619,31134,49370,4972,70346
8600000US70352,110,49,61,,67331,27964,70352
8600000US70353,1216,769,447,33664,40836,10619,70353
8600000US70354,3607,1859,1748,55000,61970,7836,70354
8600000US70355,904,409,495,58906,75176,15441,70355
8600000US70356,1561,814,747,33864,45566,7710,70356
8600000US70357,1989,1022,967,46385,59483,8669,70357
8600000US70358,610,304,306,34830,53451,9199,70358
8600000US70359,6050,2880,3170,47490,63686,7272,70359
8600000US70360,21895,10198,11697,66398,86660,6120,70360
8600000US70363,18790,9691,9099,36157,51332,4559,70363
8600000US70364,22926,11234,11692,56571,69651,4419,70364
8600000US70372,2322,1202,1120,49351,65149,11418,70372
8600000US70373,5251,2667,2584,53821,67762,8267,70373
8600000US70374,5227,2571,2656,61198,66454,4971,70374
8600000US70375,77,35,42,40875,38040,10360,70375
8600000US70377,3397,1783,1614,39284,51238,5986,70377
8600000US70380,15827,7752,8075,38242,51832,3045,70380
8600000US70390,5329,2362,2967,43125,63616,13167,70390
8600000US70391,217,114,103,76546,77161,16867,70391
8600000US70392,6442,3254,3188,48472,59741,4873,70392
8600000US70393,742,318,424,61875,84976,21129,70393
8600000US70394,11665,5677,5988,46502,67228,5865,70394
8600000US70395,3374,1588,1786,58940,70445,10884,70395
8600000US70397,652,357,295,42344,59816,16736,70397
8600000US70401,14297,6327,7970,41921,61879,5984,70401
8600000US70402,1879,660,1219,,,,70402
8600000US70403,22935,10407,12528,45912,61996,4162,70403
8600000US70420,6640,3243,3397,63390,78724,7401,70420
8600000US70422,10759,5541,5218,39485,56378,7187,70422
8600000US70426,4870,3026,1844,39593,57733,9975,70426
8600000US70427,14098,6185,7913,32917,46079,4752,70427
8600000US70431,4382,2241,2141,55734,78046,12658,70431
8600000US70433,29304,14341,14963,71708,96403,6154,70433
8600000US70435,13958,6691,7267,71931,89248,7344,70435
8600000US70436,501,243,258,23271,23313,5120,70436
8600000US70437,6611,3128,3483,76250,88195,13518,70437
8600000US70438,14658,7114,7544,38333,50307,3701,70438
8600000US70441,3423,1629,1794,44167,55473,9164,70441
8600000US70442,227,102,125,90959,95028,39942,70442
8600000US70443,7789,4001,3788,34350,45496,6279,70443
8600000US70444,7715,3193,4522,30797,51151,4814,70444
8600000US70445,7982,3840,4142,52326,70276,7516,70445
8600000US70446,5664,3515,2149,59542,67467,12988,70446
8600000US70447,9827,4888,4939,107546,118286,10312,70447
8600000US70448,19089,9213,9876,85028,115009,7828,70448
8600000US70449,3128,1584,1544,55366,70660,13737,70449
8600000US70450,1976,1033,943,29392,51652,11878,70450
8600000US70451,0,0,0,,,,70451
8600000US70452,9957,4710,5247,50398,71380,7902,70452
8600000US70453,657,354,303,70202,144813,123284,70453
8600000US70454,21908,10615,11293,55872,71772,5703,70454
8600000US70455,700,440,260,,80599,46528,70455
8600000US70456,1809,827,982,41111,58317,20461,70456
8600000US70458,28796,13385,15411,62761,79103,4645,70458
8600000US70460,17062,7999,9063,49898,61078,4263,70460
8600000US70461,20837,9736,11101,64481,85081,5542,70461
8600000US70462,4007,1896,2111,50350,68995,13274,70462
8600000US70463,103,51,52,,30646,8830,70463
8600000US70464,516,213,303,38843,54194,17822,70464
8600000US70465,464,233,231,31250,37615,7234,70465
8600000US70466,7071,3363,3708,45557,59042,6155,70466
8600000US70471,15896,7737,8159,88428,126324,9139,70471
8600000US70501,23854,11051,12803,27345,43467,3872,70501
8600000US70503,24824,12224,12600,71882,103534,7379,70503
8600000US70506,33277,16062,17215,46225,60552,2429,70506
8600000US70507,12101,5561,6540,48376,63821,6158,70507
8600000US70508,31230,15450,15780,71684,106107,7769,70508
8600000US70510,18999,9048,9951,49879,62309,3759,70510
8600000US70512,7599,3646,3953,52798,64020,5745,70512
8600000US70513,223,127,96,49831,57469,28894,70513
8600000US70514,1968,914,1054,42013,58592,9365,70514
8600000US70515,2650,1503,1147,24182,49793,9987,70515
8600000US70516,414,240,174,,79241,23629,70516
8600000US70517,20460,10140,10320,43662,62350,5741,70517
8600000US70518,10371,5117,5254,69188,88172,8192,70518
8600000US70519,218,108,110,,51502,27152,70519
8600000US70520,14228,6990,7238,46885,66345,4127,70520
8600000US70523,637,307,330,55625,60690,12790,70523
8600000US70524,134,75,59,31250,31452,8499,70524
8600000US70525,10438,5048,5390,40180,60120,6728,70525
8600000US70526,13248,6517,6731,31459,51504,5425,70526
8600000US70528,1841,853,988,40114,55222,7286,70528
8600000US70529,9090,4390,4700,48719,71967,11764,70529
8600000US70531,1067,401,666,30993,50501,16366,70531
8600000US70532,1618,633,985,33125,47931,8346,70532
8600000US70533,5466,2737,2729,50396,66990,9272,70533
8600000US70534,618,287,331,38056,70107,17081,70534
8600000US70535,13075,6258,6817,40240,62808,5784,70535
8600000US70537,353,180,173,37500,43089,12753,70537
8600000US70538,10872,5492,5380,37243,49308,2956,70538
8600000US70541,279,128,151,21071,43563,12410,70541
8600000US70542,2818,1368,1450,64342,71454,10091,70542
8600000US70543,3072,1370,1702,52284,66817,9402,70543
8600000US70544,8055,3678,4377,37195,48868,4497,70544
8600000US70546,12497,5943,6554,36372,60801,6524,70546
8600000US70548,8051,3723,4328,44879,60030,7955,70548
8600000US70549,2847,1420,1427,41773,66034,15214,70549
8600000US70550,55,0,55,,,,70550
8600000US70552,1231,598,633,36742,58892,14085,70552
8600000US70554,4069,2021,2048,31233,40959,6020,70554
8600000US70555,5842,2884,2958,64912,81168,10254,70555
8600000US70556,233,109,124,,42489,12783,70556
8600000US70558,0,0,0,,,,70558
8600000US70559,2105,986,1119,42273,53729,5006,70559
8600000US70560,30121,14797,15324,39150,54260,3676,70560
8600000US70563,14362,6936,7426,65091,83173,7080,70563
8600000US70570,29244,13216,16028,30027,50004,3891,70570
8600000US70575,74,45,29,,36876,15313,70575
8600000US70576,968,648,320,36500,59670,14854,70576
8600000US70577,2904,1322,1582,33699,43189,5263,70577
8600000US70578,13282,6346,6936,55448,62996,4979,70578
8600000US70580,151,101,50,50488,40424,13323,70580
8600000US70581,474,235,239,36903,61931,20768,70581
8600000US70582,14755,6933,7822,50829,65717,7474,70582
8600000US70583,9030,4352,4678,48189,62544,5721,70583
8600000US70584,5510,2798,2712,44472,58101,6254,70584
8600000US70585,222,109,113,29063,42487,13599,70585
8600000US70586,15092,7472,7620,33013,48436,3626,70586
8600000US70589,2516,1241,1275,34867,54899,8662,70589
8600000US70591,4164,2006,2158,48553,63338,7103,70591
8600000US70592,17437,8045,9392,77463,95097,6849,70592
8600000US70601,24547,10982,13565,32068,49249,3317,70601
8600000US70605,27232,12811,14421,70160,93881,4469,70605
8600000US70607,21210,9817,11393,38676,54569,3319,70607
8600000US70611,15500,7642,7858,69972,86928,5165,70611
8600000US70615,10562,5503,5059,38091,57618,11999,70615
8600000US70630,1908,1009,899,68846,99547,26490,70630
8600000US70631,388,202,186,63438,73611,20465,70631
8600000US70632,502,270,232,63882,85799,27567,70632
8600000US70633,6116,2902,3214,51055,67897,9138,70633
8600000US70634,19739,9875,9864,50287,68368,4948,70634
8600000US70637,410,229,181,,45904,22603,70637
8600000US70638,793,410,383,46667,86566,38617,70638
8600000US70639,304,123,181,21111,34692,16033,70639
8600000US70640,213,87,126,24583,35967,10109,70640
8600000US70643,180,106,74,64464,70860,13276,70643
8600000US70644,171,95,76,,94221,81072,70644
8600000US70645,1010,513,497,45893,75086,20689,70645
8600000US70646,525,257,268,,45881,30935,70646
8600000US70647,6600,3197,3403,54886,67790,5837,70647
8600000US70648,6899,4292,2607,49071,70616,9287,70648
8600000US70650,147,66,81,51591,64634,22420,70650
8600000US70651,133,93,40,,26838,13494,70651
8600000US70652,1628,738,890,49265,80465,30778,70652
8600000US70653,2634,1403,1231,41667,55905,6258,70653
8600000US70654,155,78,77,,74929,56952,70654
8600000US70655,2051,865,1186,39737,51530,7582,70655
8600000US70656,3135,1622,1513,38056,53504,8393,70656
8600000US70657,3690,1973,1717,66084,73773,14609,70657
8600000US70658,576,322,254,52891,55520,9697,70658
8600000US70659,1276,608,668,52721,65734,9322,70659
8600000US70660,1168,639,529,45069,56545,12717,70660
8600000US70661,1563,692,871,37292,47281,9853,70661
8600000US70662,225,114,111,35481,38304,18013,70662
8600000US70663,20198,9996,10202,55135,66279,3406,70663
8600000US70665,8165,4088,4077,68390,85576,7224,70665
8600000US70668,5296,2623,2673,47967,62736,7234,70668
8600000US70669,7466,3968,3498,55364,62952,6242,70669
8600000US70706,16576,7793,8783,69783,85555,4765,70706
8600000US70710,3372,1765,1607,69833,85975,11091,70710
8600000US70711,3243,1644,1599,73672,82228,13311,70711
8600000US70712,3672,3396,276,66875,82538,27168,70712
8600000US70714,14775,7078,7697,53285,71681,10609,70714
8600000US70715,973,464,509,45288,50210,7904,70715
8600000US70719,3132,1427,1705,64545,83516,11018,70719
8600000US70721,638,319,319,26856,52819,27404,70721
8600000US70722,3755,1642,2113,48158,62754,7252,70722
8600000US70723,979,465,514,42763,60858,17684,70723
8600000US70725,1324,605,719,61984,61463,16338,70725
8600000US70726,42131,20962,21169,64052,81027,5244,70726
8600000US70729,675,255,420,,54967,21598,70729
8600000US70730,2872,1261,1611,50156,59244,8488,70730
8600000US70732,986,445,541,45804,58239,13413,70732
8600000US70733,1010,476,534,47232,70250,14089,70733
8600000US70734,5061,2553,2508,92692,98956,12469,70734
8600000US70736,310,174,136,21162,27920,13312,70736
8600000US70737,32277,15992,16285,73011,90252,4434,70737
8600000US70739,10758,5032,5726,77982,89713,6274,70739
8600000US70740,1286,633,653,43049,53969,17453,70740
8600000US70743,133,83,50,94531,81573,19227,70743
8600000US70744,4451,2096,2355,47750,85490,17347,70744
8600000US70747,157,45,112,,40582,15127,70747
8600000US70748,6309,4619,1690,46432,65818,10277,70748
8600000US70749,1141,457,684,49024,59527,10060,70749
8600000US70750,1100,504,596,25104,56550,21130,70750
8600000US70752,609,337,272,,51147,17723,70752
8600000US70753,733,405,328,26094,40472,8920,70753
8600000US70754,9811,4861,4950,58447,72298,5225,70754
8600000US70755,1388,617,771,56458,67090,10674,70755
8600000US70756,284,130,154,,86761,49193,70756
8600000US70757,2441,1133,1308,41326,53636,8670,70757
8600000US70759,1394,720,674,41386,52874,10891,70759
8600000US70760,5007,2277,2730,37978,58449,8719,70760
8600000US70761,492,216,276,36467,53796,13703,70761
8600000US70762,761,417,344,41285,76387,30595,70762
8600000US70763,3055,1440,1615,79618,91813,10823,70763
8600000US70764,12256,5653,6603,46798,62177,5451,70764
8600000US70767,12477,6148,6329,57280,76074,8219,70767
8600000US70769,30546,14765,15781,88950,101415,4336,70769
8600000US70770,2740,1303,1437,61647,77307,15899,70770
8600000US70772,627,299,328,43304,58235,11368,70772
8600000US70773,161,83,78,70313,52981,24208,70773
8600000US70774,7737,3872,3865,81426,98251,17554,70774
8600000US70775,8827,4961,3866,55483,77518,7296,70775
8600000US70776,5545,3402,2143,69676,82711,12535,70776
8600000US70777,2866,1188,1678,53464,68538,8448,70777
8600000US70778,2705,1147,1558,64648,71330,8411,70778
8600000US70780,1045,587,458,72861,119360,44696,70780
8600000US70782,163,40,123,35536,41010,20874,70782
8600000US70783,2330,1156,1174,58438,103492,33459,70783
8600000US70785,15498,7076,8422,59679,75633,6373,70785
8600000US70787,176,24,152,,,,70787
8600000US70788,2910,1420,1490,46167,64337,9250,70788
8600000US70789,430,204,226,40833,45531,8659,70789
8600000US70791,19289,8898,10391,69190,89520,7045,70791
8600000US70801,85,65,20,,68982,29754,70801
8600000US70802,20232,9738,10494,25566,41738,4761,70802
8600000US70803,708,274,434,,,,70803
8600000US70805,19798,9467,10331,25680,37232,2972,70805
8600000US70806,22599,10433,12166,43235,72383,3868,70806
8600000US70807,13836,6347,7489,31670,41064,4074,70807
8600000US70808,27992,12959,15033,66190,110277,8294,70808
8600000US70809,20670,10328,10342,74117,100392,7601,70809
8600000US70810,31123,14440,16683,81616,115778,7514,70810
8600000US70811,9663,4173,5490,40756,52271,4377,70811
8600000US70812,8206,3454,4752,38593,53160,6978,70812
8600000US70814,10713,5167,5546,49444,63719,5252,70814
8600000US70815,22417,10522,11895,51603,66158,4124,70815
8600000US70816,33114,15463,17651,51848,72055,3806,70816
8600000US70817,26084,12740,13344,84994,106147,5203,70817
8600000US70818,7346,3410,3936,67625,80503,8511,70818
8600000US70819,3358,1535,1823,63676,64943,6469,70819
8600000US70820,16567,8238,8329,29169,56360,11586,70820
8600000US70836,0,0,0,,,,70836
8600000US71001,3458,1605,1853,22976,46696,8037,71001
8600000US71003,1002,421,581,31906,85423,57960,71003
8600000US71004,532,211,321,34375,53527,10229,71004
8600000US71006,9852,4557,5295,70371,86416,6926,71006
8600000US71007,648,291,357,51960,60041,14250,71007
8600000US71008,614,328,286,29185,50072,17667,71008
8600000US71016,1414,662,752,40270,49438,6214,71016
8600000US71018,974,451,523,23750,33637,6100,71018
8600000US71019,5983,2717,3266,32767,57912,10147,71019
8600000US71021,599,255,344,16883,19798,3046,71021
8600000US71023,2404,1272,1132,31514,48711,8098,71023
8600000US71024,1234,577,657,31228,41491,10963,71024
8600000US71027,1102,481,621,50200,56033,13793,71027
8600000US71028,1002,429,573,28494,40963,7005,71028
8600000US71029,143,77,66,,54089,15399,71029
8600000US71030,1293,576,717,57131,74451,25792,71030
8600000US71031,806,381,425,39318,59714,13818,71031
8600000US71032,1918,1011,907,41094,63343,9504,71032
8600000US71033,3011,1543,1468,58327,87465,22942,71033
8600000US71034,271,143,128,62917,66891,13317,71034
8600000US71037,13701,6525,7176,49924,72124,6505,71037
8600000US71038,3366,1686,1680,27500,40374,3757,71038
8600000US71039,1078,508,570,51178,51934,9594,71039
8600000US71040,7739,5010,2729,25595,37085,3764,71040
8600000US71043,335,178,157,28587,39061,9033,71043
8600000US71044,532,264,268,43750,75413,21825,71044
8600000US71045,513,264,249,58077,66077,11162,71045
8600000US71046,1009,490,519,46500,95473,57162,71046
8600000US71047,9096,4221,4875,57717,74541,11870,71047
8600000US71048,49,30,19,,75223,32661,71048
8600000US71049,2543,1076,1467,50898,64331,10215,71049
8600000US71051,1299,683,616,49408,71856,22382,71051
8600000US71052,6963,3216,3747,29375,44757,4766,71052
8600000US71055,15227,7317,7910,30772,44365,2802,71055
8600000US71060,1754,852,902,46500,58188,7941,71060
8600000US71061,1380,665,715,37269,51776,9492,71061
8600000US71063,638,332,306,40978,76066,31502,71063
8600000US71064,2903,1416,1487,31863,47489,9598,71064
8600000US71065,954,468,486,27056,44323,7934,71065
8600000US71067,2364,1013,1351,46745,53570,9776,71067
8600000US71068,2779,1391,1388,31446,48391,8971,71068
8600000US71069,558,296,262,35139,78975,47736,71069
8600000US71070,1386,624,762,46250,84809,23860,71070
8600000US71071,1995,993,1002,39265,55317,11210,71071
8600000US71072,1055,527,528,35179,47972,7213,71072
8600000US71073,2106,986,1120,27196,47039,8316,71073
8600000US71075,4757,2114,2643,26340,38724,6173,71075
8600000US71078,5152,2530,2622,59938,82115,9301,71078
8600000US71079,138,45,93,30481,25854,7116,71079
8600000US71082,3707,1777,1930,35375,46516,6673,71082
8600000US71101,5397,2526,2871,17654,27566,3332,71101
8600000US71103,5175,2392,2783,21285,34430,4951,71103
8600000US71104,11563,5718,5845,40661,56532,4808,71104
8600000US71105,17110,8075,9035,55315,77022,6471,71105
8600000US71106,26362,11932,14430,52755,91258,5757,71106
8600000US71107,24752,12100,12652,36854,56018,3835,71107
8600000US71108,13325,6103,7222,29937,37908,2913,71108
8600000US71109,15669,7212,8457,24851,33740,2879,71109
8600000US71110,3779,2617,1162,51146,65020,7339,71110
8600000US71111,31591,15149,16442,57222,73952,3939,71111
8600000US71112,26532,12865,13667,52982,63477,2785,71112
8600000US71115,12774,5718,7056,54087,89888,12036,71115
8600000US71118,18283,8136,10147,43822,57495,4410,71118
8600000US71119,8751,3982,4769,48980,71404,8359,71119
8600000US71129,10024,4579,5445,40616,59087,7241,71129
8600000US71201,15968,7572,8396,48767,80758,6403,71201
8600000US71202,21469,11191,10278,22840,31972,1842,71202
8600000US71203,29044,12714,16330,40950,58921,3486,71203
8600000US71209,177,69,108,,,,71209
8600000US71219,1081,525,556,54837,64237,18760,71219
8600000US71220,16372,7489,8883,32679,47071,6372,71220
8600000US71222,2497,1186,1311,31845,45173,7205,71222
8600000US71223,328,205,123,21000,33050,9404,71223
8600000US71225,5114,2567,2547,65255,81741,10033,71225
8600000US71226,1373,597,776,41042,54141,10381,71226
8600000US71227,2724,1400,1324,55109,81878,12866,71227
8600000US71229,1241,732,509,48404,70377,20379,71229
8600000US71232,5309,2720,2589,32024,48961,4032,71232
8600000US71233,160,80,80,,24189,9128,71233
8600000US71234,3029,1544,1485,60893,71813,8360,71234
8600000US71235,3733,1726,2007,39024,63237,9466,71235
8600000US71237,1593,1044,549,30250,40317,6343,71237
8600000US71238,2388,1105,1283,62439,93308,40448,71238
8600000US71241,7847,3856,3991,44303,61206,8065,71241
8600000US71243,168,90,78,56250,71986,23834,71243
8600000US71245,4167,1848,2319,24387,36002,6422,71245
8600000US71247,753,376,377,29167,36082,5783,71247
8600000US71250,117,68,49,,20574,13229,71250
8600000US71251,7166,3724,3442,33576,47481,3449,71251
8600000US71253,168,74,94,29167,38229,10891,71253
8600000US71254,5306,3271,2035,18750,46642,20618,71254
8600000US71256,830,476,354,36125,54601,14953,71256
8600000US71259,1228,469,759,39643,56555,10436,71259
8600000US71260,2335,1075,1260,40275,65498,19751,71260
8600000US71261,1015,449,566,24141,48246,22615,71261
8600000US71263,5942,2779,3163,35977,59295,9955,71263
8600000US71264,923,426,497,50625,67298,16971,71264
8600000US71266,1073,501,572,53750,65685,10851,71266
8600000US71268,1892,905,987,67847,79471,10167,71268
8600000US71269,9255,4498,4757,36096,53745,4875,71269
8600000US71270,24722,11957,12765,33114,56816,3087,71270
8600000US71272,1639,1025,614,,,,71272
8600000US71275,1744,789,955,49250,57654,7119,71275
8600000US71276,94,44,50,61719,67659,14197,71276
8600000US71277,1163,650,513,46250,48532,8774,71277
8600000US71279,36,0,36,,,,71279
8600000US71280,3190,1426,1764,61385,75888,9989,71280
8600000US71282,8072,3932,4140,27546,42525,3335,71282
8600000US71286,345,153,192,48155,53729,11934,71286
8600000US71291,24452,10920,13532,50762,67891,4740,71291
8600000US71292,15455,7401,8054,39013,56685,4889,71292
8600000US71295,10181,4880,5301,34551,50516,4663,71295
8600000US71301,17518,8573,8945,33570,58612,4557,71301
8600000US71302,10500,4793,5707,28814,48887,6737,71302
8600000US71303,16607,7508,9099,52878,74520,5154,71303
8600000US71316,39,27,12,,27704,17020,71316
8600000US71322,4516,2385,2131,33977,50165,8704,71322
8600000US71323,774,372,402,34306,67404,22476,71323
8600000US71325,798,332,466,20395,36450,9142,71325
8600000US71326,735,361,374,33606,47136,11887,71326
8600000US71327,4772,3061,1711,53611,74750,13435,71327
8600000US71328,4811,2345,2466,63237,71088,8361,71328
8600000US71331,784,435,349,41815,82045,33247,71331
8600000US71333,463,232,231,24375,42685,16203,71333
8600000US71334,7744,4110,3634,26207,51312,9166,71334
8600000US71336,1256,589,667,38667,53755,14253,71336
8600000US71339,123,67,56,,,,71339
8600000US71340,1607,1266,341,35769,55116,21016,71340
8600000US71341,2724,1318,1406,44034,64159,12865,71341
8600000US71342,5586,2562,3024,32664,49458,6583,71342
8600000US71343,5398,2474,2924,37048,56176,5195,71343
8600000US71345,41,0,41,,,,71345
8600000US71346,2067,917,1150,41587,55176,7610,71346
8600000US71350,3087,1334,1753,31766,52755,7866,71350
8600000US71351,8249,3920,4329,34715,50704,5223,71351
8600000US71353,1437,718,719,30833,52040,16429,71353
8600000US71354,1335,632,703,45481,67664,20513,71354
8600000US71355,2033,938,1095,40990,52829,8269,71355
8600000US71356,620,315,305,24750,37665,16687,71356
8600000US71357,1408,676,732,24625,37496,5959,71357
8600000US71358,754,419,335,29688,39087,10555,71358
8600000US71360,27193,12926,14267,51250,66661,3677,71360
8600000US71362,1451,620,831,43558,70322,19641,71362
8600000US71366,1207,572,635,25318,35654,4680,71366
8600000US71367,1137,663,474,27237,42997,10734,71367
8600000US71368,937,459,478,30972,45831,10234,71368
8600000US71369,1828,724,1104,25427,40842,6062,71369
8600000US71371,1803,1083,720,52045,61369,11000,71371
8600000US71373,4768,2270,2498,37549,47058,4862,71373
8600000US71375,929,419,510,18649,31933,6866,71375
8600000US71377,115,90,25,,24605,23208,71377
8600000US71378,1687,748,939,24010,41962,6121,71378
8600000US71401,205,130,75,118017,104050,34851,71401
8600000US71403,3574,1817,1757,59811,83493,22491,71403
8600000US71404,659,325,334,51734,68188,17822,71404
8600000US71405,4503,2284,2219,43542,59970,12577,71405
8600000US71406,132,46,86,68417,63834,11541,71406
8600000US71407,570,229,341,26571,35728,13622,71407
8600000US71409,4412,2276,2136,43947,60571,8949,71409
8600000US71410,73,35,38,,53900,28039,71410
8600000US71411,2418,1108,1310,27855,37967,5250,71411
8600000US71414,92,47,45,13375,22299,11130,71414
8600000US71416,659,240,419,24167,46312,12361,71416
8600000US71417,4304,2126,2178,30855,41259,5022,71417
8600000US71418,4859,2385,2474,28927,51143,10536,71418
8600000US71419,1689,891,798,41691,53012,7854,71419
8600000US71422,1296,679,617,39000,46747,9167,71422
8600000US71423,3110,1672,1438,51705,67192,8536,71423
8600000US71424,702,328,374,78750,70937,12697,71424
8600000US71425,80,44,36,,56961,31268,71425
8600000US71426,215,109,106,41000,59685,24984,71426
8600000US71427,378,139,239,27647,25533,4395,71427
8600000US71429,2304,1138,1166,47667,70239,11901,71429
8600000US71430,1917,928,989,42346,56379,8995,71430
8600000US71432,961,510,451,46563,55772,9876,71432
8600000US71433,3254,1660,1594,44744,52799,6205,71433
8600000US71435,2880,1622,1258,40994,57612,7522,71435
8600000US71438,1675,835,840,62917,68609,11944,71438
8600000US71439,1448,635,813,41713,54740,10892,71439
8600000US71441,452,232,220,29524,36241,19748,71441
8600000US71446,16899,8821,8078,48145,61316,2809,71446
8600000US71447,1185,625,560,27500,41352,8724,71447
8600000US71449,7121,3462,3659,38350,58448,5808,71449
8600000US71450,974,419,555,41042,53499,11786,71450
8600000US71452,125,38,87,40329,48142,27970,71452
8600000US71454,1417,777,640,33056,42525,7399,71454
8600000US71455,98,58,40,,75545,61048,71455
8600000US71456,1176,714,462,43295,53028,10395,71456
8600000US71457,20704,9483,11221,25780,45556,3240,71457
8600000US71459,8044,5321,2723,41815,49153,2945,71459
8600000US71461,1729,885,844,50625,59184,6246,71461
8600000US71462,1321,621,700,33214,46985,5717,71462
8600000US71463,8515,5102,3413,36516,53583,6814,71463
8600000US71465,2418,1194,1224,39701,68046,12949,71465
8600000US71466,415,197,218,60122,59948,20157,71466
8600000US71467,6899,4762,2137,45417,55447,6718,71467
8600000US71468,706,335,371,33333,47368,12785,71468
8600000US71469,1700,803,897,32450,44691,5669,71469
8600000US71472,335,149,186,,63600,23594,71472
8600000US71473,340,165,175,44531,47881,12412,71473
8600000US71474,425,215,210,72857,79359,16158,71474
8600000US71479,531,232,299,48688,54523,11268,71479
8600000US71480,1241,1007,234,47361,59658,12406,71480
8600000US71483,8160,4571,3589,33766,55811,5305,71483
8600000US71485,1578,747,831,60461,86046,14981,71485
8600000US71486,3897,1874,2023,33715,45041,3070,71486
8600000US71601,11098,4963,6135,30710,39103,2716,71601
8600000US71602,12109,5703,6406,50406,59333,3952,71602
8600000US71603,24791,11671,13120,40796,56804,3377,71603
8600000US71630,389,183,206,35326,43728,9981,71630
8600000US71631,267,133,134,31458,41252,9088,71631
8600000US71635,9287,4315,4972,39049,56725,8177,71635
8600000US71638,3042,1707,1335,32292,54395,14062,71638
8600000US71639,4237,1900,2337,35326,47344,5839,71639
8600000US71640,2263,984,1279,24476,41625,10032,71640
8600000US71642,520,256,264,21250,48488,35691,71642
8600000US71643,780,298,482,33333,42043,7446,71643
8600000US71644,5220,4891,329,26648,44351,9224,71644
8600000US71646,4607,2279,2328,44355,58633,5990,71646
8600000US71647,1617,825,792,52689,68487,12953,71647
8600000US71651,97,76,21,45698,46203,19882,71651
8600000US71652,740,346,394,42969,48965,8941,71652
8600000US71653,3505,1619,1886,41641,63216,12429,71653
8600000US71654,3014,1391,1623,24578,40540,4246,71654
8600000US71655,11870,5662,6208,43992,57407,5185,71655
8600000US71658,550,288,262,33958,39439,6295,71658
8600000US71659,63,32,31,,22467,20281,71659
8600000US71660,679,359,320,54615,72497,14792,71660
8600000US71661,310,143,167,18011,26930,10654,71661
8600000US71662,180,76,104,27924,26752,2273,71662
8600000US71663,403,204,199,38359,56662,11082,71663
8600000US71665,4517,2207,2310,40699,56000,4994,71665
8600000US71666,37,20,17,,,,71666
8600000US71667,5017,1982,3035,46690,57310,6034,71667
8600000US71670,996,481,515,31429,41994,6912,71670
8600000US71671,6593,3018,3575,39100,51521,3709,71671
8600000US71674,523,248,275,31713,43943,8665,71674
8600000US71675,1466,745,721,55250,60882,9287,71675
8600000US71676,428,156,272,31473,45146,11870,71676
8600000US71677,132,53,79,25833,30429,8352,71677
8600000US71701,13782,6256,7526,35073,51586,4052,71701
8600000US71711,81,39,42,,,,71711
8600000US71720,1948,749,1199,43000,47226,7001,71720
8600000US71722,47,29,18,53125,59356,28305,71722
8600000US71724,375,146,229,60019,51325,9424,71724
8600000US71725,459,252,207,43452,51696,9564,71725
8600000US71726,1203,631,572,29583,40225,7442,71726
8600000US71730,23324,11340,11984,45634,61755,4013,71730
8600000US71740,1150,604,546,27583,46542,13445,71740
8600000US71742,4044,1947,2097,34737,43557,4433,71742
8600000US71743,3020,1449,1571,37768,49176,6882,71743
8600000US71744,2275,1215,1060,43788,55285,6572,71744
8600000US71745,301,94,207,29737,43265,8433,71745
8600000US71747,774,325,449,39792,51817,10396,71747
8600000US71749,1876,928,948,47393,56369,10220,71749
8600000US71751,1027,548,479,47361,59600,15760,71751
8600000US71752,700,357,343,28304,39506,8285,71752
8600000US71753,13212,5740,7472,36191,56298,7536,71753
8600000US71758,331,172,159,35667,59251,32774,71758
8600000US71759,441,222,219,41192,50660,10025,71759
8600000US71762,1620,657,963,36008,52682,8160,71762
8600000US71763,1370,672,698,40541,50243,6968,71763
8600000US71764,1531,737,794,36250,45588,7241,71764
8600000US71765,1507,675,832,28438,36153,7824,71765
8600000US71766,605,297,308,38750,50168,9884,71766
8600000US71770,2877,1621,1256,38100,51997,8181,71770
8600000US71772,5,3,2,,,,71772
8600000US71801,12243,5619,6624,42116,52879,4108,71801
8600000US71820,56,16,40,,,,71820
8600000US71822,6598,3157,3441,46390,59538,6522,71822
8600000US71823,30,18,12,35625,36316,17963,71823
8600000US71825,491,245,246,56667,65810,11582,71825
8600000US71826,850,382,468,31705,52781,13390,71826
8600000US71827,670,339,331,34200,70112,35366,71827
8600000US71832,7767,3901,3866,46626,59259,6009,71832
8600000US71833,1709,818,891,36927,71524,24136,71833
8600000US71834,999,378,621,40720,42157,9265,71834
8600000US71835,1000,545,455,40069,58154,15825,71835
8600000US71836,2281,1065,1216,39219,58708,8494,71836
8600000US71837,3954,2071,1883,45446,50740,6077,71837
8600000US71838,724,338,386,40106,38905,6505,71838
8600000US71839,309,177,132,40156,37831,11764,71839
8600000US71841,823,433,390,51544,58329,19354,71841
8600000US71842,1569,781,788,36563,48958,6778,71842
8600000US71845,1691,779,912,32171,68900,30424,71845
8600000US71846,2168,1059,1109,50994,59104,8301,71846
8600000US71847,499,279,220,36577,48068,13596,71847
8600000US71851,1636,837,799,41500,63452,14375,71851
8600000US71852,7268,3385,3883,36691,56869,7987,71852
8600000US71853,152,63,89,26417,45781,16330,71853
8600000US71854,28064,13419,14645,41392,58634,3184,71854
8600000US71855,487,251,236,,42023,12969,71855
8600000US71857,3733,1747,1986,37034,43882,6462,71857
8600000US71858,1753,835,918,40096,44009,5390,71858
8600000US71859,456,219,237,32008,51703,12587,71859
8600000US71860,1863,903,960,29831,48950,9211,71860
8600000US71861,1449,713,736,39306,48402,6560,71861
8600000US71862,439,234,205,36515,44419,13727,71862
8600000US71865,130,55,75,40000,38750,11914,71865
8600000US71866,452,224,228,56875,60541,13816,71866
8600000US71901,23081,10591,12490,38430,57506,4429,71901
8600000US71909,14320,6945,7375,57000,68731,3570,71909
8600000US71913,37322,17498,19824,42883,65647,6060,71913
8600000US71921,2669,1367,1302,42500,53139,6204,71921
8600000US71922,57,28,29,38438,40724,12130,71922
8600000US71923,12442,5633,6809,40025,56254,3002,71923
8600000US71929,3530,1805,1725,48545,56257,6038,71929
8600000US71933,798,448,350,29538,47587,13430,71933
8600000US71935,393,222,171,28917,36051,9301,71935
8600000US71937,1539,763,776,37194,49449,9456,71937
8600000US71940,1381,748,633,34397,44077,5704,71940
8600000US71941,1735,939,796,42778,55982,7449,71941
8600000US71943,3476,1651,1825,32202,53092,7757,71943
8600000US71944,619,295,324,32063,42461,7153,71944
8600000US71945,1124,596,528,36420,40196,7231,71945
8600000US71949,1638,789,849,38373,42386,7814,71949
8600000US71950,721,364,357,43500,49280,9311,71950
8600000US71952,79,45,34,,114598,65837,71952
8600000US71953,10827,5224,5603,37822,49596,3546,71953
8600000US71956,1387,633,754,31250,39756,8074,71956
8600000US71957,2622,1198,1424,42399,54179,5929,71957
8600000US71958,1946,905,1041,36317,48881,5317,71958
8600000US71959,351,184,167,39712,63304,25663,71959
8600000US71960,1266,650,616,29167,38294,5782,71960
8600000US71961,775,394,381,42500,49107,8046,71961
8600000US71962,480,203,277,37557,49218,11108,71962
8600000US71964,2806,1407,1399,58558,79376,18944,71964
8600000US71965,217,76,141,,40507,16042,71965
8600000US71968,3355,1916,1439,64857,73964,10778,71968
8600000US71969,229,129,100,,52612,16288,71969
8600000US71970,703,364,339,38214,79119,28593,71970
8600000US71971,452,209,243,37361,44063,12816,71971
8600000US71972,259,123,136,57667,53526,17517,71972
8600000US71973,1083,485,598,35096,48693,10599,71973
8600000US71998,384,384,0,,,,71998
8600000US71999,714,239,475,,,,71999
8600000US72001,518,268,250,32500,54704,23365,72001
8600000US72002,12823,6484,6339,59485,78218,5403,72002
8600000US72003,612,336,276,53625,57151,7664,72003
8600000US72004,741,352,389,29688,38015,5335,72004
8600000US72005,113,79,34,22708,24323,11407,72005
8600000US72006,2017,920,1097,29554,47707,7560,72006
8600000US72007,5359,2691,2668,64192,70854,5887,72007
8600000US72010,4947,2312,2635,36097,51043,7948,72010
8600000US72011,3116,1538,1578,57014,77722,19931,72011
8600000US72012,9566,4689,4877,57696,72027,8688,72012
8600000US72013,1672,822,850,42946,61114,11990,72013
8600000US72014,32,10,22,,38555,23673,72014
8600000US72015,22446,10954,11492,54706,65694,3193,72015
8600000US72016,2512,1255,1257,49599,66282,8610,72016
8600000US72017,445,228,217,28438,42567,8049,72017
8600000US72019,19537,9388,10149,70635,85325,3784,72019
8600000US72020,3039,1583,1456,34788,57006,14687,72020
8600000US72021,3045,1390,1655,31523,46773,5865,72021
8600000US72022,12926,5949,6977,64699,76960,5865,72022
8600000US72023,27898,13919,13979,60807,72240,2890,72023
8600000US72024,2844,1201,1643,57134,64800,7909,72024
8600000US72025,670,321,349,54076,68133,10733,72025
8600000US72026,244,167,77,35893,41882,12713,72026
8600000US72027,1035,539,496,54000,66634,12668,72027
8600000US72029,1508,715,793,31384,43117,6114,72029
8600000US72030,521,248,273,27000,41651,10917,72030
8600000US72031,5766,2924,2842,38934,51026,5133,72031
8600000US72032,25980,12216,13764,45234,60393,2922,72032
8600000US72034,38816,18950,19866,52581,72861,4472,72034
8600000US72035,1640,684,956,,,,72035
8600000US72036,623,282,341,18224,32038,6136,72036
8600000US72037,35,21,14,,53188,33112,72037
8600000US72038,52,21,31,145625,113031,50263,72038
8600000US72039,1694,815,879,47045,61660,10501,72039
8600000US72040,2401,1163,1238,41806,54833,5855,72040
8600000US72041,955,418,537,32269,42697,7225,72041
8600000US72042,3820,1789,2031,33906,49592,5253,72042
8600000US72044,618,251,367,51042,60635,12585,72044
8600000US72045,930,464,466,50597,74536,34155,72045
8600000US72046,3248,1467,1781,39531,57191,9018,72046
8600000US72047,697,337,360,48947,55579,7791,72047
8600000US72048,98,58,40,,81921,44065,72048
8600000US72051,586,319,267,40574,51331,11384,72051
8600000US72055,712,303,409,48125,58779,9848,72055
8600000US72057,671,356,315,41148,61409,20477,72057
8600000US72058,12213,5881,6332,55019,73554,7108,72058
8600000US72059,21,9,12,,,,72059
8600000US72060,476,278,198,38345,51601,20768,72060
8600000US72061,112,56,56,107143,111476,27648,72061
8600000US72063,1517,759,758,40274,53069,9621,72063
8600000US72064,1838,924,914,44872,53748,6632,72064
8600000US72065,3971,1937,2034,59185,73826,7842,72065
8600000US72067,2257,1097,1160,37835,52413,8741,72067
8600000US72068,284,121,163,42188,45935,9243,72068
8600000US72069,882,415,467,41739,55018,10717,72069
8600000US72070,1414,721,693,33295,46860,9535,72070
8600000US72072,357,185,172,52857,71649,21602,72072
8600000US72073,882,481,401,54038,81057,26095,72073
8600000US72074,105,63,42,25156,37506,17886,72074
8600000US72076,28537,13406,15131,47245,56783,2536,72076
8600000US72079,602,270,332,42917,50516,14726,72079
8600000US72080,292,134,158,28906,39669,9716,72080
8600000US72081,5799,3172,2627,41302,53137,5532,72081
8600000US72082,1481,690,791,24284,29539,2763,72082
8600000US72083,166,72,94,29118,57550,38620,72083
8600000US72084,907,449,458,43920,55024,8809,72084
8600000US72085,173,92,81,25000,35392,8121,72085
8600000US72086,7693,3999,3694,52191,65750,5066,72086
8600000US72087,1707,948,759,64286,87216,19562,72087
8600000US72088,2323,1030,1293,39073,55485,5995,72088
8600000US72099,664,512,152,,,,72099
8600000US72101,2273,1077,1196,46736,56384,7372,72101
8600000US72102,2387,1069,1318,51818,56038,6596,72102
8600000US72103,9662,4450,5212,51705,63448,6734,72103
8600000US72104,18721,9737,8984,41208,55594,4886,72104
8600000US72106,4170,2171,1999,56131,70520,8603,72106
8600000US72107,126,73,53,44375,60460,19196,72107
8600000US72108,72,46,26,,105239,86635,72108
8600000US72110,8846,4212,4634,39716,57723,6713,72110
8600000US72111,1126,529,597,66424,77282,15353,72111
8600000US72112,9038,4103,4935,29616,47488,3905,72112
8600000US72113,19364,8345,11019,58456,87340,6425,72113
8600000US72114,8464,3670,4794,20274,30209,2136,72114
8600000US72116,17520,8211,9309,62030,88432,6652,72116
8600000US72117,10988,4923,6065,37104,46913,4073,72117
8600000US72118,16159,7674,8485,45730,56975,4953,72118
8600000US72119,0,0,0,,,,72119
8600000US72120,25941,12146,13795,63482,75802,3400,72120
8600000US72121,2622,1320,1302,40049,50231,8107,72121
8600000US72122,423,250,173,60795,68491,15904,72122
8600000US72123,319,177,142,30625,35455,8129,72123
8600000US72125,645,335,310,36094,47501,7608,72125
8600000US72126,2719,1296,1423,47917,59015,5588,72126
8600000US72127,1891,917,974,42500,62257,11533,72127
8600000US72128,614,286,328,48125,52277,8480,72128
8600000US72129,935,462,473,37446,47898,7187,72129
8600000US72130,585,283,302,36154,38648,10010,72130
8600000US72131,3838,1871,1967,54219,77904,16242,72131
8600000US72132,2625,1306,1319,53787,69046,9568,72132
8600000US72134,195,103,92,26964,39716,11667,72134
8600000US72135,1994,1045,949,79167,129817,28412,72135
8600000US72136,1054,552,502,53333,64511,12092,72136
8600000US72137,1893,993,900,43929,71862,23834,72137
8600000US72139,168,83,85,21500,37415,12238,72139
8600000US72140,378,202,176,55938,63533,13246,72140
8600000US72141,552,256,296,31266,30310,7257,72141
8600000US72142,1978,1037,941,55333,79735,11623,72142
8600000US72143,27836,13079,14757,45251,65511,6071,72143
8600000US72149,0,0,0,,,,72149
8600000US72150,9662,4747,4915,52604,70297,7520,72150
8600000US72152,262,137,125,18913,31478,11497,72152
8600000US72153,1883,1007,876,28913,48922,7831,72153
8600000US72156,324,212,112,,53282,16052,72156
8600000US72157,985,415,570,49167,56388,11756,72157
8600000US72160,7584,3480,4104,39839,59615,5665,72160
8600000US72165,105,34,71,,18709,8508,72165
8600000US72166,105,53,52,24034,35049,13736,72166
8600000US72167,1215,635,580,38398,56950,14738,72167
8600000US72168,2411,2227,184,18167,42889,19835,72168
8600000US72169,110,56,54,40536,52782,19927,72169
8600000US72170,181,81,100,39375,52868,13618,72170
8600000US72173,6715,3210,3505,58617,71901,7866,72173
8600000US72175,226,107,119,32000,42582,12108,72175
8600000US72176,6955,3292,3663,51364,67323,6652,72176
8600000US72179,261,143,118,39410,53110,19269,72179
8600000US72181,8,0,8,,,,72181
8600000US72201,958,602,356,59286,122483,39031,72201
8600000US72202,8567,4066,4501,38827,59681,8767,72202
8600000US72204,22932,10665,12267,35942,44463,2590,72204
8600000US72205,19312,9182,10130,48963,69806,4539,72205
8600000US72206,18352,9014,9338,37461,50760,4001,72206
8600000US72207,8317,3704,4613,74892,119525,11999,72207
8600000US72209,22100,10572,11528,35539,43569,3190,72209
8600000US72210,12861,5581,7280,57316,76020,6337,72210
8600000US72211,17280,7763,9517,61819,88490,5727,72211
8600000US72212,9773,4858,4915,96591,133842,14556,72212
8600000US72223,18174,9080,9094,98199,151852,11800,72223
8600000US72227,9202,4322,4880,70000,98977,9147,72227
8600000US72301,17558,7575,9983,31740,44494,3080,72301
8600000US72311,90,36,54,24000,40370,22226,72311
8600000US72315,16101,7665,8436,39379,52008,3792,72315
8600000US72320,1578,1543,35,38500,34183,8459,72320
8600000US72321,118,66,52,52750,58965,11684,72321
8600000US72322,96,32,64,20588,24878,7116,72322
8600000US72324,1817,899,918,46357,49216,5651,72324
8600000US72325,43,19,24,39750,44047,10769,72325
8600000US72326,1486,781,705,37477,49757,11603,72326
8600000US72327,1265,618,647,35250,55155,12978,72327
8600000US72328,93,34,59,,,,72328
8600000US72329,141,62,79,,61148,47850,72329
8600000US72330,359,178,181,42000,57688,7934,72330
8600000US72331,2316,1188,1128,34195,43591,4655,72331
8600000US72332,27,13,14,13636,17410,9208,72332
8600000US72333,474,199,275,20313,31439,8628,72333
8600000US72335,14660,8736,5924,36336,45669,3472,72335
8600000US72338,6,6,0,,,,72338
8600000US72339,104,53,51,,33959,17459,72339
8600000US72340,147,58,89,,88976,98341,72340
8600000US72341,180,102,78,32292,36601,7876,72341
8600000US72342,3660,1629,2031,25985,50149,7251,72342
8600000US72346,443,231,212,22788,40872,18273,72346
8600000US72347,512,255,257,42404,53673,14280,72347
8600000US72348,1968,943,1025,31898,40990,6577,72348
8600000US72350,828,372,456,26417,44252,9518,72350
8600000US72351,417,200,217,31429,40877,7849,72351
8600000US72353,46,13,33,,,,72353
8600000US72354,1911,960,951,40353,53986,8951,72354
8600000US72355,1782,812,970,45254,58104,10844,72355
8600000US72358,1260,708,552,25167,37233,6885,72358
8600000US72359,294,119,175,23365,26118,6317,72359
8600000US72360,4346,1938,2408,22214,40422,5493,72360
8600000US72364,11323,5416,5907,64228,74781,3829,72364
8600000US72365,2087,935,1152,23673,33563,4337,72365
8600000US72366,1745,727,1018,33276,47418,9002,72366
8600000US72367,52,40,12,24583,21013,5899,72367
8600000US72368,948,538,410,46833,51670,7298,72368
8600000US72370,5532,2538,2994,30180,43854,3639,72370
8600000US72372,1650,797,853,40250,52692,5778,72372
8600000US72373,813,367,446,20565,30114,4372,72373
8600000US72374,635,270,365,,49711,14235,72374
8600000US72376,1535,788,747,48636,77339,22889,72376
8600000US72377,9,0,9,,,,72377
8600000US72379,0,0,0,,,,72379
8600000US72383,65,32,33,,,,72383
8600000US72384,631,386,245,22734,33005,5374,72384
8600000US72386,1537,710,827,41842,57900,10121,72386
8600000US72389,142,66,76,78929,90376,53421,72389
8600000US72390,5676,2679,2997,25625,35714,4660,72390
8600000US72392,417,204,213,37857,59857,24772,72392
8600000US72394,405,174,231,29444,36322,7759,72394
8600000US72395,860,428,432,53375,68463,7840,72395
8600000US72396,9685,4527,5158,46207,67784,8915,72396
8600000US72401,43776,20401,23375,40122,57740,3033,72401
8600000US72404,19441,9403,10038,55597,90510,8905,72404
8600000US72410,311,171,140,30875,43297,11614,72410
8600000US72411,1896,942,954,38980,53293,6241,72411
8600000US72412,370,207,163,35750,75159,37704,72412
8600000US72413,374,188,186,46364,61287,41600,72413
8600000US72414,264,128,136,51250,73173,22664,72414
8600000US72415,1144,588,556,42583,53536,10920,72415
8600000US72416,4132,2131,2001,52166,61251,5624,72416
8600000US72417,3921,1925,1996,45346,61994,8209,72417
8600000US72419,1246,626,620,41667,63118,22497,72419
8600000US72421,411,233,178,34833,106657,88354,72421
8600000US72422,3402,1622,1780,29743,41292,4290,72422
8600000US72424,69,35,34,,33492,12007,72424
8600000US72425,377,187,190,55156,47811,9735,72425
8600000US72426,142,67,75,48000,59115,13567,72426
8600000US72427,159,54,105,,24790,6748,72427
8600000US72428,56,20,36,76875,67892,15763,72428
8600000US72429,275,146,129,41875,59860,22841,72429
8600000US72430,322,175,147,32500,39453,8444,72430
8600000US72431,326,188,138,30096,58057,35378,72431
8600000US72432,5172,2513,2659,41024,48561,5227,72432
8600000US72433,2328,1152,1176,31486,48285,7648,72433
8600000US72434,1581,783,798,43603,47135,5186,72434
8600000US72435,310,147,163,42250,54491,11595,72435
8600000US72436,688,344,344,48790,46853,5878,72436
8600000US72437,2833,1295,1538,45778,54206,6141,72437
8600000US72438,1997,958,1039,35684,53403,12070,72438
8600000US72440,211,98,113,46750,55905,14854,72440
8600000US72441,63,36,27,,18972,13104,72441
8600000US72442,3368,1637,1731,41716,65866,14909,72442
8600000US72443,2390,1205,1185,42183,51117,6580,72443
8600000US72444,1339,578,761,37283,47094,6420,72444
8600000US72445,61,33,28,35208,35454,10160,72445
8600000US72447,1746,804,942,43958,65167,10490,72447
8600000US72449,200,114,86,26964,37078,10431,72449
8600000US72450,29133,14126,15007,47074,59197,2542,72450
8600000US72453,143,72,71,41389,50503,10897,72453
8600000US72454,3954,1936,2018,34048,45070,4111,72454
8600000US72455,9604,4731,4873,38604,53060,5786,72455
8600000US72456,398,210,188,28864,40297,9042,72456
8600000US72457,134,47,87,41786,48382,12498,72457
8600000US72458,562,242,320,61029,67497,17332,72458
8600000US72459,1062,505,557,31446,43412,9264,72459
8600000US72460,622,367,255,21500,42139,20728,72460
8600000US72461,2974,1443,1531,41102,57609,10106,72461
8600000US72462,278,145,133,28684,30212,6113,72462
8600000US72464,20,10,10,20833,22106,5839,72464
8600000US72466,1055,532,523,40956,53642,10075,72466
8600000US72467,278,278,0,,,,72467
8600000US72469,793,397,396,34688,46489,8998,72469
8600000US72470,167,98,69,31563,45922,18709,72470
8600000US72471,792,375,417,32348,58353,20691,72471
8600000US72472,6761,3246,3515,40709,47688,3820,72472
8600000US72473,1875,1041,834,38359,47324,5279,72473
8600000US72476,5182,2460,2722,37755,48713,4232,72476
8600000US72478,286,138,148,,35972,16105,72478
8600000US72479,980,459,521,48026,52480,5776,72479
8600000US72482,915,501,414,28807,39463,6576,72482
8600000US72501,20019,9537,10482,43515,59021,3605,72501
8600000US72512,1968,878,1090,30661,38165,3199,72512
8600000US72513,2324,1172,1152,32318,42662,6685,72513
8600000US72515,0,0,0,,,,72515
8600000US72517,232,94,138,36326,47574,19644,72517
8600000US72519,3095,1943,1152,36176,46012,5442,72519
8600000US72520,102,39,63,,17371,10401,72520
8600000US72521,4178,1941,2237,37895,64336,26941,72521
8600000US72522,480,284,196,44271,51878,10749,72522
8600000US72523,934,450,484,26912,39506,9788,72523
8600000US72524,264,136,128,44426,60393,19683,72524
8600000US72526,152,63,89,,50986,18517,72526
8600000US72527,375,170,205,,147897,131427,72527
8600000US72528,7,7,0,,,,72528
8600000US72529,3861,1840,2021,39118,48449,6024,72529
8600000US72530,1121,546,575,37411,44250,7913,72530
8600000US72531,728,392,336,39720,56790,16925,72531
8600000US72532,913,417,496,32500,35046,6199,72532
8600000US72533,342,154,188,34083,55349,26197,72533
8600000US72534,1154,615,539,60972,66897,20368,72534
8600000US72536,353,192,161,29432,44612,14267,72536
8600000US72537,605,328,277,45000,57103,13328,72537
8600000US72538,304,144,160,27708,43303,18706,72538
8600000US72539,143,81,62,60282,49090,16128,72539
8600000US72540,171,101,70,46250,73495,39901,72540
8600000US72542,3168,1559,1609,39262,45716,4518,72542
8600000US72543,9660,4708,4952,45145,58716,4271,72543
8600000US72544,537,266,271,25234,31891,11357,72544
8600000US72546,171,71,100,40500,55003,24591,72546
8600000US72550,411,228,183,,48131,16492,72550
8600000US72553,40,17,23,61250,49463,13145,72553
8600000US72554,1999,929,1070,24846,41553,9528,72554
8600000US72555,133,65,68,48571,78436,39867,72555
8600000US72556,2697,1264,1433,41914,47340,6340,72556
8600000US72560,7312,3627,3685,34510,46555,4924,72560
8600000US72561,637,305,332,41136,52817,9377,72561
8600000US72562,1638,779,859,40461,62690,14909,72562
8600000US72564,308,140,168,29345,56725,36763,72564
8600000US72565,569,277,292,45179,51599,7491,72565
8600000US72566,456,262,194,29732,48459,14241,72566
8600000US72567,236,134,102,37039,75371,36665,72567
8600000US72568,882,413,469,39545,44147,7670,72568
8600000US72569,229,103,126,,45030,17146,72569
8600000US72571,268,154,114,51917,72338,19425,72571
8600000US72572,94,60,34,44500,47427,20579,72572
8600000US72573,188,116,72,58875,62169,18898,72573
8600000US72576,3275,1579,1696,36912,43711,3826,72576
8600000US72577,617,361,256,56250,65435,11141,72577
8600000US72578,49,24,25,,,,72578
8600000US72579,999,461,538,44493,55402,7954,72579
8600000US72581,815,413,402,53906,69078,25709,72581
8600000US72583,1475,708,767,33571,51464,10123,72583
8600000US72584,316,134,182,36618,41065,14632,72584
8600000US72585,328,166,162,86250,160872,148650,72585
8600000US72587,75,21,54,,54829,28359,72587
8600000US72601,23193,11254,11939,44220,60307,3428,72601
8600000US72611,1336,584,752,47825,86183,31909,72611
8600000US72616,8233,4172,4061,49360,72769,12767,72616
8600000US72617,54,31,23,37885,44413,31316,72617
8600000US72619,1700,734,966,39132,45934,5705,72619
8600000US72623,835,508,327,46875,63902,18975,72623
8600000US72624,386,128,258,44063,53353,15167,72624
8600000US72626,1121,567,554,35388,47224,9476,72626
8600000US72628,627,310,317,34602,54591,16758,72628
8600000US72629,344,173,171,21193,35903,16007,72629
8600000US72630,193,81,112,36875,39970,7803,72630
8600000US72631,3257,1550,1707,42500,52812,5592,72631
8600000US72632,3674,1771,1903,41003,50934,5943,72632
8600000US72633,1210,543,667,41338,57846,15979,72633
8600000US72634,3426,1727,1699,38438,50482,5433,72634
8600000US72635,2922,1482,1440,41223,50366,5331,72635
8600000US72636,6,3,3,,43933,28672,72636
8600000US72638,5483,2858,2625,41963,48902,4777,72638
8600000US72639,522,255,267,42708,36917,7556,72639
8600000US72640,293,149,144,,50213,20488,72640
8600000US72641,2319,1142,1177,30898,44197,6382,72641
8600000US72642,1864,869,995,51310,63039,10181,72642
8600000US72644,2019,1025,994,38050,45214,5995,72644
8600000US72645,1611,882,729,28042,42721,13056,72645
8600000US72648,542,323,219,69803,73060,16172,72648
8600000US72650,3213,1510,1703,35048,49707,6905,72650
8600000US72651,908,510,398,45526,47547,6840,72651
8600000US72653,23251,10817,12434,41339,59218,4539,72653
8600000US72655,274,142,132,37321,42007,10558,72655
8600000US72658,1282,592,690,36755,57827,14522,72658
8600000US72660,397,189,208,30250,43118,8559,72660
8600000US72661,531,301,230,31100,33746,10461,72661
8600000US72662,2287,1113,1174,36898,48350,5203,72662
8600000US72663,182,87,95,,75014,49410,72663
8600000US72666,140,51,89,,22780,15111,72666
8600000US72668,219,111,108,60357,56157,10537,72668
8600000US72669,35,22,13,,39939,16663,72669
8600000US72670,87,42,45,,,,72670
8600000US72672,211,99,112,18938,25347,7081,72672
8600000US72675,1051,611,440,44063,47182,6930,72675
8600000US72677,286,128,158,21339,31434,7537,72677
8600000US72679,31,15,16,,,,72679
8600000US72680,693,312,381,53147,60377,18271,72680
8600000US72682,571,253,318,46563,52246,21538,72682
8600000US72683,251,111,140,46964,43027,11474,72683
8600000US72685,978,469,509,35938,43435,7105,72685
8600000US72686,122,93,29,,30896,24828,72686
8600000US72687,5137,2415,2722,33986,41812,4601,72687
8600000US72701,36385,17911,18474,37686,63499,4392,72701
8600000US72703,25822,12675,13147,42482,76254,5990,72703
8600000US72704,19751,10062,9689,62693,84555,7122,72704
8600000US72712,38417,19517,18900,83327,110951,5958,72712
8600000US72714,10113,4851,5262,69176,81812,4892,72714
8600000US72715,13670,6402,7268,62275,82193,6277,72715
8600000US72717,683,291,392,42083,46917,10685,72717
8600000US72718,2038,1042,996,120417,136285,19014,72718
8600000US72719,8075,3782,4293,70600,77538,5868,72719
8600000US72721,339,143,196,48400,66208,32053,72721
8600000US72722,2475,1273,1202,47929,59070,10097,72722
8600000US72727,4273,2099,2174,53625,61604,7138,72727
8600000US72729,156,87,69,25885,37514,16149,72729
8600000US72730,6398,3123,3275,54834,74642,8497,72730
8600000US72732,3669,1893,1776,66016,82211,13123,72732
8600000US72734,6291,3114,3177,55964,69121,9837,72734
8600000US72736,4884,2338,2546,53006,80324,13416,72736
8600000US72738,1875,969,906,52692,65964,14477,72738
8600000US72739,471,197,274,54853,67677,17868,72739
8600000US72740,7088,3436,3652,45336,67368,10375,72740
8600000US72742,552,309,243,47356,52934,12676,72742
8600000US72744,4203,1980,2223,40147,55496,8860,72744
8600000US72745,9762,4782,4980,62260,76873,6838,72745
8600000US72747,268,142,126,55313,45079,16562,72747
8600000US72749,52,35,17,,,,72749
8600000US72751,5099,2287,2812,56695,64188,5803,72751
8600000US72752,320,140,180,24063,30134,12655,72752
8600000US72753,6723,3348,3375,63995,73967,6608,72753
8600000US72756,31268,15577,15691,50015,71579,3633,72756
8600000US72758,29516,14194,15322,72568,110151,7129,72758
8600000US72760,246,130,116,54688,56582,14784,72760
8600000US72761,16203,7959,8244,49659,65662,4481,72761
8600000US72762,29200,14311,14889,59421,82986,4448,72762
8600000US72764,38294,19134,19160,47245,68822,7336,72764
8600000US72768,795,407,388,62721,65654,12364,72768
8600000US72769,837,456,381,61429,72080,14952,72769
8600000US72773,936,528,408,57900,70220,24867,72773
8600000US72774,4456,2137,2319,52209,64703,5396,72774
8600000US72776,481,237,244,32453,42057,10085,72776
8600000US72801,15669,7530,8139,33653,43416,3574,72801
8600000US72802,16346,8076,8270,51637,70067,3842,72802
8600000US72821,1539,708,831,37131,46297,9800,72821
8600000US72823,4662,2281,2381,39583,50585,5895,72823
8600000US72824,1369,715,654,45903,57659,8763,72824
8600000US72826,38,18,20,59583,66993,34636,72826
8600000US72827,139,68,71,,41592,19570,72827
8600000US72828,45,24,21,,78678,57264,72828
8600000US72830,11697,5680,6017,37394,51426,4565,72830
8600000US72832,958,488,470,36786,44958,7075,72832
8600000US72833,3114,1582,1532,43763,57299,8298,72833
8600000US72834,8024,3908,4116,43851,61883,7256,72834
8600000US72835,496,244,252,28194,38859,8369,72835
8600000US72837,5758,2941,2817,41673,58781,8437,72837
8600000US72838,101,53,48,26528,36498,24158,72838
8600000US72839,259,155,104,,41211,11553,72839
8600000US72840,1742,863,879,35139,41501,8344,72840
8600000US72841,146,82,64,22438,22045,1218,72841
8600000US72842,935,430,505,45125,73015,23635,72842
8600000US72843,1985,1042,943,44342,76185,32202,72843
8600000US72845,823,410,413,46786,58134,9603,72845
8600000US72846,3046,1477,1569,39767,52082,5541,72846
8600000US72847,1916,949,967,40909,54609,8429,72847
8600000US72851,554,335,219,45192,48512,12548,72851
8600000US72852,115,60,55,,34805,22974,72852
8600000US72853,1456,698,758,30074,52027,18518,72853
8600000US72854,655,384,271,26607,33476,6733,72854
8600000US72855,4796,2208,2588,33765,50856,7961,72855
8600000US72856,235,130,105,44076,49553,13135,72856
8600000US72857,1029,553,476,38929,48771,7897,72857
8600000US72858,3073,1399,1674,42847,61341,11309,72858
8600000US72860,478,256,222,43698,45887,9019,72860
8600000US72863,1320,644,676,45962,59202,8642,72863
8600000US72865,1160,595,565,47444,55710,11472,72865
8600000US72901,16359,8619,7740,32424,48032,3307,72901
8600000US72903,20388,9414,10974,44690,70623,5561,72903
8600000US72904,15805,7438,8367,31207,38612,2164,72904
8600000US72908,10439,4813,5626,50898,80304,11636,72908
8600000US72916,6451,3208,3243,69891,87659,10031,72916
8600000US72921,10482,5156,5326,52965,62836,4369,72921
8600000US72923,3726,1752,1974,43184,51125,9646,72923
8600000US72926,497,252,245,27031,35108,7286,72926
8600000US72927,6452,3061,3391,39536,51028,4534,72927
8600000US72928,565,309,256,55096,62956,15208,72928
8600000US72930,235,111,124,,60788,33262,72930
8600000US72932,1305,688,617,43271,51614,8510,72932
8600000US72933,4327,2051,2276,52321,68635,9741,72933
8600000US72934,654,355,299,32500,46015,11766,72934
8600000US72935,329,143,186,31875,43291,11457,72935
8600000US72936,10803,5299,5504,54941,65512,4502,72936
8600000US72937,2506,1121,1385,41711,60289,14526,72937
8600000US72938,889,433,456,50800,58941,8799,72938
8600000US72940,2374,1141,1233,62741,71854,11443,72940
8600000US72941,4089,2036,2053,50469,59013,4619,72941
8600000US72943,1749,947,802,40486,52946,7578,72943
8600000US72944,2665,1241,1424,41250,48587,5300,72944
8600000US72945,173,80,93,34318,43289,11238,72945
8600000US72946,3116,1645,1471,50087,55140,6077,72946
8600000US72947,3079,1777,1302,36082,43451,4202,72947
8600000US72948,227,138,89,,37539,29708,72948
8600000US72949,7321,3490,3831,35259,45342,4408,72949
8600000US72950,285,171,114,55156,82860,25979,72950
8600000US72951,739,385,354,38320,50923,10593,72951
8600000US72952,2137,1060,1077,46786,53661,9790,72952
8600000US72955,200,105,95,46607,54566,30595,72955
8600000US72956,26381,12398,13983,46316,65097,7023,72956
8600000US72958,5155,2524,2631,34299,41782,3721,72958
8600000US72959,2046,1060,986,36827,60812,15662,72959
8600000US73002,729,338,391,58393,73738,14314,73002
8600000US73003,17703,8240,9463,62849,87216,8560,73003
8600000US73004,696,340,356,63000,86107,13962,73004
8600000US73005,6860,3477,3383,39518,58418,6256,73005
8600000US73006,2530,1248,1282,50288,59126,5281,73006
8600000US73007,1844,935,909,80250,179145,69282,73007
8600000US73008,14958,7270,7688,50204,61867,3858,73008
8600000US73009,1028,559,469,44904,64043,8881,73009
8600000US73010,14597,7329,7268,69482,84548,4642,73010
8600000US73011,281,146,135,47083,54486,11056,73011
8600000US73012,25681,12704,12977,97982,123224,5802,73012
8600000US73013,37909,17661,20248,88254,121803,5763,73013
8600000US73014,1503,773,730,62833,92741,17750,73014
8600000US73015,2260,1093,1167,32782,50269,4042,73015
8600000US73016,1216,606,610,74306,87953,12372,73016
8600000US73017,1241,629,612,39405,48188,6512,73017
8600000US73018,15341,7295,8046,45112,62462,3528,73018
8600000US73019,0,0,0,,,,73019
8600000US73020,18131,9026,9105,78956,90847,5100,73020
8600000US73021,203,104,99,58750,55044,9877,73021
8600000US73024,632,280,352,53750,64662,9393,73024
8600000US73025,8939,4559,4380,127306,172280,16849,73025
8600000US73026,8260,4104,4156,73456,100958,11199,73026
8600000US73027,944,365,579,49178,73312,32679,73027
8600000US73028,2904,1390,1514,48804,64671,6798,73028
8600000US73029,1209,610,599,50446,56624,8485,73029
8600000US73030,3176,1613,1563,51034,61997,6078,73030
8600000US73032,169,102,67,51250,70634,20273,73032
8600000US73033,327,153,174,39167,52090,12274,73033
8600000US73034,33976,16530,17446,84419,124121,4919,73034
8600000US73036,15887,8370,7517,51810,68638,4912,73036
8600000US73038,1485,778,707,45188,57620,5141,73038
8600000US73040,1327,585,742,44045,57043,7659,73040
8600000US73041,283,130,153,58750,72912,21851,73041
8600000US73042,830,410,420,52045,61824,6229,73042
8600000US73043,125,49,76,28375,56550,25522,73043
8600000US73044,18044,8800,9244,53810,65834,4806,73044
8600000US73045,8569,4303,4266,60339,74967,5933,73045
8600000US73047,3963,2492,1471,55417,68736,4554,73047
8600000US73048,1814,918,896,60227,78802,11643,73048
8600000US73049,4217,2178,2039,64632,88224,11446,73049
8600000US73050,927,350,577,,58671,30238,73050
8600000US73051,8476,5458,3018,51031,64807,5961,73051
8600000US73052,5044,2349,2695,49798,63288,4802,73052
8600000US73053,521,271,250,43906,61042,7371,73053
8600000US73054,3244,1682,1562,58585,81813,10381,73054
8600000US73055,7855,3768,4087,53888,68698,4557,73055
8600000US73056,279,148,131,63625,75241,14715,73056
8600000US73057,1763,833,930,43221,57159,9136,73057
8600000US73058,154,80,74,,84904,25253,73058
8600000US73059,2265,1146,1119,55952,68136,5072,73059
8600000US73061,1188,606,582,66645,90430,20763,73061
8600000US73062,1040,463,577,34647,53986,8844,73062
8600000US73063,489,214,275,45833,57796,11763,73063
8600000US73064,17487,8284,9203,74283,85499,4056,73064
8600000US73065,6311,3204,3107,72756,85226,7785,73065
8600000US73066,237,108,129,34318,43523,12148,73066
8600000US73067,1796,908,888,63036,80312,12002,73067
8600000US73068,9312,4460,4852,55851,67875,7721,73068
8600000US73069,20069,9960,10109,48667,63389,3534,73069
8600000US73071,34240,17607,16633,49467,63136,3212,73071
8600000US73072,38228,18115,20113,65513,91691,5440,73072
8600000US73073,346,183,163,56528,65052,13410,73073
8600000US73074,814,375,439,40789,52118,5380,73074
8600000US73075,7198,3569,3629,45281,57803,3540,73075
8600000US73077,5252,2519,2733,52451,64180,5339,73077
8600000US73078,7268,3408,3860,99506,107012,8546,73078
8600000US73079,370,188,182,54125,61772,8210,73079
8600000US73080,7001,3218,3783,57384,71226,6618,73080
8600000US73082,2300,1167,1133,50819,67472,9504,73082
8600000US73084,5315,2458,2857,35250,52987,7312,73084
8600000US73086,6744,3217,3527,51526,66576,7819,73086
8600000US73089,9557,4756,4801,78068,96982,7083,73089
8600000US73090,896,545,351,71250,94031,24575,73090
8600000US73092,711,319,392,41250,59188,7013,73092
8600000US73093,2222,1098,1124,74625,85912,9425,73093
8600000US73095,1537,780,757,44094,61635,7497,73095
8600000US73096,10952,5426,5526,47177,66358,6366,73096
8600000US73097,167,70,97,,84380,35175,73097
8600000US73098,3284,1652,1632,45066,57049,4705,73098
8600000US73099,50420,24623,25797,72249,88466,3200,73099
8600000US73102,4866,3579,1287,54183,89979,16076,73102
8600000US73103,4266,2264,2002,51416,81970,7016,73103
8600000US73104,1878,927,951,57266,86228,12739,73104
8600000US73105,4608,2165,2443,39885,59191,8582,73105
8600000US73106,10336,5324,5012,37213,58094,4810,73106
8600000US73107,19294,9583,9711,42488,54401,2691,73107
8600000US73108,10162,5310,4852,27899,36773,3044,73108
8600000US73109,14822,7577,7245,33636,41598,2311,73109
8600000US73110,24955,11420,13535,41307,49673,1477,73110
8600000US73111,8394,3541,4853,29398,40219,3647,73111
8600000US73112,26396,12690,13706,45952,65094,3627,73112
8600000US73114,12685,5549,7136,34943,49119,3474,73114
8600000US73115,15753,7386,8367,44279,51163,2824,73115
8600000US73116,7552,3613,3939,74926,141759,13637,73116
8600000US73117,4347,1892,2455,22860,38796,5236,73117
8600000US73118,11895,5795,6100,55049,82938,5133,73118
8600000US73119,20242,9893,10349,34031,42464,2805,73119
8600000US73120,29275,13223,16052,52112,79948,4038,73120
8600000US73121,3013,1421,1592,58590,73632,7782,73121
8600000US73122,9502,4262,5240,46193,60759,3906,73122
8600000US73127,18286,9162,9124,35627,46608,2281,73127
8600000US73128,3488,1944,1544,76469,84530,8881,73128
8600000US73129,12874,7051,5823,31343,44371,5630,73129
8600000US73130,15837,7667,8170,61271,71447,3050,73130
8600000US73131,3131,1710,1421,75266,118026,18238,73131
8600000US73132,20847,9366,11481,53720,70316,3135,73132
8600000US73134,4632,1901,2731,53995,70902,8694,73134
8600000US73135,16504,8151,8353,56340,67911,4841,73135
8600000US73139,13170,6449,6721,42509,53498,2940,73139
8600000US73141,2038,1015,1023,40293,47519,6147,73141
8600000US73142,10900,4778,6122,75516,107873,9708,73142
8600000US73145,2371,1652,719,56894,72566,15441,73145
8600000US73149,3677,1757,1920,36613,46477,6682,73149
8600000US73150,3758,1774,1984,81228,104605,8257,73150
8600000US73151,1414,691,723,166563,229666,54020,73151
8600000US73159,24294,11876,12418,48618,58985,2505,73159
8600000US73160,44271,21063,23208,64306,73767,2017,73160
8600000US73162,23532,10769,12763,70060,90166,4019,73162
8600000US73165,4963,2505,2458,83786,111246,13864,73165
8600000US73169,1572,756,816,63571,81338,11497,73169
8600000US73170,29080,14043,15037,84789,100358,5300,73170
8600000US73173,2043,1093,950,107153,122394,15149,73173
8600000US73179,3711,1772,1939,91094,108889,11363,73179
8600000US73401,26722,12738,13984,49822,65293,3343,73401
8600000US73425,40,25,15,8250,14916,10628,73425
8600000US73430,1075,576,499,61848,65312,7881,73430
8600000US73432,839,411,428,55568,60803,5515,73432
8600000US73433,2178,1096,1082,51386,72389,13198,73433
8600000US73434,495,235,260,42083,53317,14024,73434
8600000US73437,79,38,41,42321,50690,19797,73437
8600000US73438,2703,1217,1486,45995,62459,9719,73438
8600000US73439,6008,2876,3132,45331,60464,6081,73439
8600000US73440,244,99,145,35781,42925,12235,73440
8600000US73441,138,68,70,24688,31910,9767,73441
8600000US73442,335,166,169,57857,78315,22200,73442
8600000US73443,2842,1463,1379,43409,54943,6352,73443
8600000US73444,102,36,66,,29550,20257,73444
8600000US73446,6288,3197,3091,47148,60927,9234,73446
8600000US73447,946,462,484,51136,57485,4715,73447
8600000US73448,4601,2253,2348,49792,60213,3455,73448
8600000US73449,2324,1188,1136,49663,71239,11842,73449
8600000US73450,1022,533,489,45962,57885,6578,73450
8600000US73453,376,200,176,62083,67965,10336,73453
8600000US73455,506,252,254,34688,53580,9905,73455
8600000US73456,1561,818,743,39300,48391,4362,73456
8600000US73458,689,352,337,42279,60630,8060,73458
8600000US73459,832,420,412,42500,56331,9160,73459
8600000US73460,3631,1678,1953,31495,45101,5103,73460
8600000US73461,582,299,283,43194,54663,6826,73461
8600000US73463,2604,1302,1302,56364,72644,9411,73463
8600000US73481,765,340,425,42431,57916,8774,73481
8600000US73487,133,80,53,23125,30317,8602,73487
8600000US73491,517,242,275,48250,60163,7900,73491
8600000US73501,16270,9223,7047,36483,48417,2582,73501
8600000US73503,8068,5426,2642,51011,60228,4317,73503
8600000US73505,36700,17165,19535,52200,69583,3255,73505
8600000US73507,17139,8986,8153,52912,74203,8576,73507
8600000US73520,132,67,65,46250,62494,19785,73520
8600000US73521,15550,7711,7839,44010,58769,3011,73521
8600000US73526,1712,788,924,56675,64907,5874,73526
8600000US73527,4061,2256,1805,76694,95300,16195,73527
8600000US73528,435,233,202,44375,55684,10548,73528
8600000US73529,4258,2136,2122,42946,56472,4695,73529
8600000US73530,311,166,145,34500,63321,20270,73530
8600000US73531,362,193,169,53092,59520,9538,73531
8600000US73532,337,159,178,56417,59429,8502,73532
8600000US73533,20811,9899,10912,45467,62171,2720,73533
8600000US73537,425,212,213,34306,45309,6564,73537
8600000US73538,4279,2164,2115,81098,94871,10626,73538
8600000US73539,149,70,79,56250,76780,20424,73539
8600000US73540,526,303,223,63750,65682,14693,73540
8600000US73541,2064,1050,1014,57500,67271,7000,73541
8600000US73542,3424,1707,1717,41889,54686,6620,73542
8600000US73543,1193,588,605,52500,63906,7571,73543
8600000US73544,197,81,116,54844,83340,24935,73544
8600000US73546,797,383,414,40042,55297,11500,73546
8600000US73547,2049,1463,586,41196,56715,7728,73547
8600000US73548,279,159,120,24583,47253,19305,73548
8600000US73549,144,81,63,46667,56174,8969,73549
8600000US73550,1757,844,913,38468,52388,6287,73550
8600000US73551,62,29,33,36250,51133,24408,73551
8600000US73552,1158,602,556,64063,68454,7256,73552
8600000US73553,65,22,43,116250,99827,46616,73553
8600000US73554,2534,1270,1264,36636,44885,5328,73554
8600000US73555,93,52,41,37917,39809,9540,73555
8600000US73556,100,52,48,24688,36756,10625,73556
8600000US73557,373,164,209,81000,87625,18554,73557
8600000US73559,391,186,205,44107,52409,8107,73559
8600000US73560,543,273,270,48750,57405,9536,73560
8600000US73562,452,236,216,61250,73610,13447,73562
8600000US73564,372,173,199,45250,66682,21223,73564
8600000US73565,713,326,387,32188,43872,5833,73565
8600000US73566,1397,678,719,37411,45407,5300,73566
8600000US73567,514,281,233,45417,47963,7987,73567
8600000US73568,824,376,448,38958,46640,5341,73568
8600000US73569,421,211,210,40000,51097,5791,73569
8600000US73570,831,464,367,39688,56294,7699,73570
8600000US73571,75,34,41,98750,102108,36305,73571
8600000US73572,2825,1377,1448,53382,60295,5338,73572
8600000US73573,1916,914,1002,38000,48612,4716,73573
8600000US73601,7050,3428,3622,47692,65190,10663,73601
8600000US73620,982,524,458,60208,76184,13656,73620
8600000US73622,177,112,65,37105,43625,8709,73622
8600000US73624,1557,795,762,53373,62492,6726,73624
8600000US73625,537,280,257,62500,71812,16789,73625
8600000US73626,741,355,386,46827,59912,11301,73626
8600000US73627,359,209,150,47768,74422,29559,73627
8600000US73628,1130,541,589,58295,69238,8208,73628
8600000US73632,2534,1207,1327,53611,64917,8641,73632
8600000US73638,176,100,76,53152,88977,43531,73638
8600000US73639,460,236,224,43417,49114,7722,73639
8600000US73641,424,206,218,40000,56325,11318,73641
8600000US73642,129,67,62,48594,79775,26217,73642
8600000US73644,10531,5511,5020,53405,72295,8847,73644
8600000US73645,1146,575,571,42059,56955,9663,73645
8600000US73646,362,179,183,66406,94743,40863,73646
8600000US73647,465,259,206,70987,73488,15733,73647
8600000US73650,838,372,466,38974,56455,8477,73650
8600000US73651,3025,1557,1468,36157,46151,4012,73651
8600000US73654,575,272,303,73125,105738,38843,73654
8600000US73655,625,297,328,44833,56516,7382,73655
8600000US73658,221,131,90,53750,110742,45369,73658
8600000US73659,177,54,123,64375,79471,14509,73659
8600000US73660,288,146,142,32750,58373,11644,73660
8600000US73661,317,148,169,52917,59899,10068,73661
8600000US73662,5141,3193,1948,42684,58581,9110,73662
8600000US73663,889,394,495,44167,68020,12052,73663
8600000US73664,881,414,467,55855,63703,6346,73664
8600000US73666,145,76,69,52292,74563,18511,73666
8600000US73667,440,235,205,55705,64192,8845,73667
8600000US73669,1353,657,696,50000,78586,17108,73669
8600000US73673,170,85,85,42188,55162,16180,73673
8600000US73701,17250,8653,8597,39172,51932,2824,73701
8600000US73703,22602,10881,11721,59722,75376,3930,73703
8600000US73705,330,254,76,,,,73705
8600000US73716,383,181,202,53929,64933,12045,73716
8600000US73717,5708,3133,2575,58364,71624,6951,73717
8600000US73718,484,236,248,54286,72447,13510,73718
8600000US73719,48,25,23,71250,68608,15431,73719
8600000US73720,120,83,37,,62209,16649,73720
8600000US73722,348,182,166,78542,144728,54625,73722
8600000US73724,780,385,395,45313,63414,10045,73724
8600000US73726,388,222,166,54107,59418,6725,73726
8600000US73727,149,64,85,,68388,33631,73727
8600000US73728,1512,735,777,61667,89731,25105,73728
8600000US73729,392,194,198,54653,76006,13362,73729
8600000US73730,525,231,294,53125,76812,14604,73730
8600000US73731,101,59,42,51875,57557,16989,73731
8600000US73733,265,143,122,52969,72929,27988,73733
8600000US73734,639,302,337,59167,80141,15950,73734
8600000US73735,527,220,307,63393,79651,18225,73735
8600000US73736,334,168,166,62500,72210,16293,73736
8600000US73737,2613,1272,1341,50761,67266,6830,73737
8600000US73738,860,415,445,46932,52812,5313,73738
8600000US73739,262,124,138,55208,61858,13654,73739
8600000US73741,1524,1281,243,68438,68533,7656,73741
8600000US73742,3108,1528,1580,54398,83728,14872,73742
8600000US73743,91,55,36,72250,78874,21470,73743
8600000US73744,107,42,65,71563,62269,17688,73744
8600000US73746,13,5,8,,,,73746
8600000US73747,315,143,172,57120,96813,37483,73747
8600000US73749,350,183,167,58125,69571,11669,73749
8600000US73750,5439,2799,2640,65280,87040,13444,73750
8600000US73753,288,148,140,53594,92970,47247,73753
8600000US73754,814,426,388,53750,61864,6468,73754
8600000US73755,659,299,360,36494,63975,15270,73755
8600000US73756,260,123,137,84286,87787,15411,73756
8600000US73757,175,100,75,,95339,39720,73757
8600000US73758,69,32,37,,64580,27579,73758
8600000US73759,1251,634,617,50875,66867,7293,73759
8600000US73760,264,134,130,46458,48768,8959,73760
8600000US73761,308,163,145,71765,74355,13068,73761
8600000US73762,1654,778,876,60662,77746,10944,73762
8600000US73763,1231,538,693,47115,54387,5801,73763
8600000US73764,107,47,60,63000,85185,31156,73764
8600000US73766,881,440,441,57056,71220,10004,73766
8600000US73768,1199,594,605,56667,82003,13009,73768
8600000US73771,320,156,164,45417,55966,9330,73771
8600000US73772,3377,2164,1213,57648,73976,10186,73772
8600000US73773,1511,748,763,56875,68920,10818,73773
8600000US73801,11311,5601,5710,56663,73924,9197,73801
8600000US73832,851,396,455,62716,80700,12155,73832
8600000US73834,1123,511,612,45313,62129,13460,73834
8600000US73835,175,87,88,63250,86837,38400,73835
8600000US73838,293,151,142,61364,89242,23630,73838
8600000US73840,589,347,242,52917,68627,9942,73840
8600000US73841,1218,1034,184,46250,59222,13175,73841
8600000US73842,412,189,223,55938,69342,14537,73842
8600000US73843,676,308,368,52000,54125,5056,73843
8600000US73844,180,90,90,41058,73684,38312,73844
8600000US73848,1781,930,851,62361,66928,6758,73848
8600000US73851,108,63,45,79375,117461,51551,73851
8600000US73852,1750,973,777,62614,76045,8968,73852
8600000US73853,476,240,236,79861,85723,14357,73853
8600000US73855,70,42,28,68750,70403,39861,73855
8600000US73857,521,291,230,76250,97710,27312,73857
8600000US73858,1123,535,588,51250,59655,12059,73858
8600000US73859,1134,555,579,51750,68306,11496,73859
8600000US73860,1137,582,555,50375,63900,8840,73860
8600000US73901,107,49,58,,44971,17940,73901
8600000US73931,321,176,145,57143,66882,10614,73931
8600000US73932,1626,818,808,48750,61874,5189,73932
8600000US73933,1133,538,595,48333,66229,13270,73933
8600000US73937,161,86,75,48036,50778,11884,73937
8600000US73938,598,296,302,51667,51695,5690,73938
8600000US73939,1400,776,624,42011,57738,7090,73939
8600000US73942,9605,5393,4212,50639,60044,4760,73942
8600000US73944,368,188,180,44531,56272,8919,73944
8600000US73945,1950,988,962,53750,64967,6739,73945
8600000US73946,56,30,26,,25078,12941,73946
8600000US73947,285,154,131,40521,49368,8215,73947
8600000US73949,1231,561,670,46023,57662,7639,73949
8600000US73950,1114,573,541,56875,67932,10197,73950
8600000US73951,843,442,401,56042,70181,10067,73951
8600000US74001,245,121,124,37031,41786,6327,74001
8600000US74002,1503,740,763,48438,61052,6373,74002
8600000US74003,10836,5284,5552,36687,55057,3214,74003
8600000US74006,20875,9584,11291,62974,87918,4796,74006
8600000US74008,20550,9976,10574,80814,104034,5625,74008
8600000US74010,7795,3770,4025,40829,56567,3238,74010
8600000US74011,20943,10054,10889,78398,99015,4745,74011
8600000US74012,45743,21943,23800,69309,85711,2855,74012
8600000US74014,29586,14445,15141,78604,87943,2389,74014
8600000US74015,6881,3395,3486,57752,77885,7788,74015
8600000US74016,4397,2100,2297,50328,58182,4225,74016
8600000US74017,22112,10847,11265,53298,64454,2242,74017
8600000US74019,13688,6777,6911,65404,86371,5600,74019
8600000US74020,5758,2746,3012,49629,62993,4275,74020
8600000US74021,14112,6911,7201,72510,80436,3140,74021
8600000US74022,1424,724,700,54653,70055,7835,74022
8600000US74023,8625,4661,3964,44546,58471,3714,74023
8600000US74026,633,279,354,42679,54368,7348,74026
8600000US74027,796,397,399,40750,57422,6786,74027
8600000US74028,1294,605,689,45852,53563,4198,74028
8600000US74029,3737,1842,1895,44135,59844,9321,74029
8600000US74030,2883,1321,1562,36824,53638,6743,74030
8600000US74032,1701,818,883,49718,65995,12509,74032
8600000US74033,8402,4047,4355,68000,78443,4739,74033
8600000US74034,95,52,43,24250,36727,12787,74034
8600000US74035,3559,2349,1210,40489,49990,6023,74035
8600000US74036,5453,2590,2863,57433,70747,5388,74036
8600000US74037,12861,6187,6674,86757,105676,6534,74037
8600000US74038,1613,832,781,48500,57343,4630,74038
8600000US74039,2837,1442,1395,46397,58358,4959,74039
8600000US74041,1948,969,979,66905,76794,7695,74041
8600000US74042,308,169,139,35833,56196,12299,74042
8600000US74044,5470,2687,2783,49333,61351,3468,74044
8600000US74045,243,120,123,48750,60205,10619,74045
8600000US74046,78,37,41,53333,48948,10406,74046
8600000US74047,5327,2725,2602,53368,71419,6489,74047
8600000US74048,4789,2309,2480,38885,48936,3128,74048
8600000US74050,266,136,130,30481,32388,7513,74050
8600000US74051,1514,795,719,54155,73859,14094,74051
8600000US74052,729,348,381,33636,44476,4549,74052
8600000US74053,3283,1599,1684,69191,86831,8371,74053
8600000US74054,584,282,302,43393,49060,6904,74054
8600000US74055,33844,16262,17582,76751,93857,3672,74055
8600000US74056,4097,1980,2117,36224,46738,5557,74056
8600000US74058,2968,1454,1514,46542,62470,6764,74058
8600000US74059,4011,1923,2088,45422,58808,9022,74059
8600000US74060,339,177,162,34063,40815,4599,74060
8600000US74061,1633,842,791,47325,65848,10461,74061
8600000US74062,839,446,393,47500,69962,20707,74062
8600000US74063,24499,12028,12471,57641,72795,3116,74063
8600000US74066,25259,12204,13055,53956,69084,3125,74066
8600000US74068,12,6,6,,43350,41267,74068
8600000US74070,11100,5548,5552,54364,69890,4285,74070
8600000US74071,125,63,62,35000,45885,15180,74071
8600000US74072,1400,691,709,51208,63271,5247,74072
8600000US74073,4059,2028,2031,54528,71898,9790,74073
8600000US74074,26343,13013,13330,45745,69212,5154,74074
8600000US74075,21029,11038,9991,34369,52105,4498,74075
8600000US74078,2313,1333,980,,,,74078
8600000US74079,3147,1531,1616,50388,61373,4593,74079
8600000US74080,2046,1041,1005,67609,78782,10239,74080
8600000US74081,1417,771,646,45057,57159,6652,74081
8600000US74082,60,24,36,52500,63357,27909,74082
8600000US74083,761,383,378,45729,63044,6688,74083
8600000US74084,393,197,196,37500,46245,6328,74084
8600000US74085,1703,770,933,38241,53160,9533,74085
8600000US74103,2097,1585,512,75795,139418,56323,74103
8600000US74104,9838,5010,4828,41146,60653,4283,74104
8600000US74105,20354,9519,10835,52734,98317,5314,74105
8600000US74106,12608,5341,7267,26126,37535,2375,74106
8600000US74107,14439,6697,7742,41314,54577,3685,74107
8600000US74108,5486,2694,2792,42730,58785,8549,74108
8600000US74110,10117,4991,5126,27500,37165,2317,74110
8600000US74112,16602,8140,8462,43811,53277,1699,74112
8600000US74114,12877,6040,6837,68721,117456,7055,74114
8600000US74115,15680,7647,8033,34347,42439,2877,74115
8600000US74116,2806,1421,1385,38825,47961,4156,74116
8600000US74117,24,12,12,,,,74117
8600000US74119,2960,1556,1404,39219,55314,4957,74119
8600000US74120,4018,2119,1899,44362,77502,8327,74120
8600000US74126,7360,3211,4149,30185,44665,5957,74126
8600000US74127,12248,5749,6499,39236,47552,2211,74127
8600000US74128,9032,4586,4446,43419,52677,2572,74128
8600000US74129,13857,6943,6914,42348,53880,3046,74129
8600000US74130,1500,722,778,33857,44071,4472,74130
8600000US74131,2157,1129,1028,64833,82097,7455,74131
8600000US74132,6999,3316,3683,67040,96435,7970,74132
8600000US74133,35575,16269,19306,61408,83848,3341,74133
8600000US74134,11867,5940,5927,51712,69425,4524,74134
8600000US74135,16861,7859,9002,50434,70288,3684,74135
8600000US74136,25423,12233,13190,42615,73211,3646,74136
8600000US74137,21332,9982,11350,90089,139323,5999,74137
8600000US74145,14364,6854,7510,49367,62042,4042,74145
8600000US74146,10553,5114,5439,35889,45297,2566,74146
8600000US74301,9127,4852,4275,42464,56569,4473,74301
8600000US74330,2312,1087,1225,64196,71609,9548,74330
8600000US74331,5825,2893,2932,43365,58838,4612,74331
8600000US74332,1414,732,682,45750,65154,12212,74332
8600000US74333,864,443,421,39417,48160,4595,74333
8600000US74337,3724,1837,1887,46769,57711,4374,74337
8600000US74338,4235,2030,2205,43005,49820,4722,74338
8600000US74339,1751,878,873,32432,40551,3866,74339
8600000US74340,184,86,98,33750,42756,8714,74340
8600000US74342,2336,1150,1186,26898,42089,4469,74342
8600000US74343,2324,1111,1213,39353,50604,4124,74343
8600000US74344,12566,6073,6493,41741,63077,5382,74344
8600000US74346,5772,2911,2861,33597,46765,3698,74346
8600000US74347,2261,1063,1198,39878,52605,5568,74347
8600000US74349,252,117,135,31625,43274,7497,74349
8600000US74350,603,289,314,34125,43119,5163,74350
8600000US74352,5067,2502,2565,39256,57147,4920,74352
8600000US74354,13561,6398,7163,39970,52568,1753,74354
8600000US74358,186,96,90,36719,37900,6827,74358
8600000US74359,358,177,181,36500,40480,6110,74359
8600000US74360,29,14,15,63750,54344,15848,74360
8600000US74361,12445,6144,6301,52789,62723,3367,74361
8600000US74363,2093,1029,1064,43523,56385,5883,74363
8600000US74364,1333,650,683,38611,49510,4177,74364
8600000US74365,3494,1678,1816,45625,54699,3910,74365
8600000US74366,1215,582,633,38875,50314,6541,74366
8600000US74367,303,145,158,36875,51484,11591,74367
8600000US74368,58,24,34,34583,83182,60109,74368
8600000US74369,1519,731,788,47083,54031,3990,74369
8600000US74370,2792,1390,1402,40344,54476,4193,74370
8600000US74401,12092,5626,6466,35440,50939,3287,74401
8600000US74403,22954,11066,11888,45636,60167,3037,74403
8600000US74421,3489,1815,1674,53243,64341,4810,74421
8600000US74422,621,304,317,50625,63779,10263,74422
8600000US74423,709,344,365,47250,60261,8195,74423
8600000US74425,1220,562,658,53869,59972,9800,74425
8600000US74426,7711,3802,3909,38531,50845,3631,74426
8600000US74427,1069,583,486,41563,67098,12839,74427
8600000US74428,929,496,433,43333,64584,16406,74428
8600000US74429,11030,5229,5801,59758,73571,3341,74429
8600000US74430,386,194,192,49000,58049,9663,74430
8600000US74431,621,303,318,38487,50945,5417,74431
8600000US74432,7565,3616,3949,37659,54751,4028,74432
8600000US74434,6558,3112,3446,53639,71533,6173,74434
8600000US74435,2691,1334,1357,48988,63839,8035,74435
8600000US74436,3958,1945,2013,52549,76552,16165,74436
8600000US74437,7578,3591,3987,37315,52514,3485,74437
8600000US74438,97,39,58,62500,53298,13185,74438
8600000US74441,4546,2367,2179,43155,53549,4642,74441
8600000US74442,744,381,363,45288,56495,8074,74442
8600000US74445,2203,992,1211,47500,61353,6053,74445
8600000US74446,377,183,194,36417,43951,4957,74446
8600000US74447,12692,6170,6522,36478,53370,6084,74447
8600000US74450,1488,726,762,50650,59499,4732,74450
8600000US74451,3318,1466,1852,49932,56832,6710,74451
8600000US74452,288,105,183,33523,42462,12220,74452
8600000US74454,2597,1334,1263,56639,66476,5951,74454
8600000US74455,2337,1162,1175,33534,42991,3926,74455
8600000US74456,140,57,83,45625,65475,14807,74456
8600000US74457,343,171,172,53274,48247,11145,74457
8600000US74458,67,39,28,38750,51191,18592,74458
8600000US74459,80,40,40,46250,69824,29640,74459
8600000US74460,154,68,86,25714,34455,9137,74460
8600000US74462,5734,2715,3019,39161,52612,3278,74462
8600000US74463,2125,1135,990,35938,37745,8927,74463
8600000US74464,24305,11706,12599,38155,51928,2624,74464
8600000US74467,11790,5726,6064,42182,55922,2443,74467
8600000US74468,234,122,112,42500,48120,7454,74468
8600000US74469,1978,967,1011,33824,47040,5330,74469
8600000US74470,1113,572,541,37054,56922,11546,74470
8600000US74471,1248,675,573,39898,54022,7088,74471
8600000US74472,529,257,272,45000,62943,14362,74472
8600000US74477,0,0,0,,,,74477
8600000US74501,21639,11322,10317,47268,64291,3838,74501
8600000US74521,151,69,82,39375,60531,23274,74521
8600000US74522,211,106,105,42813,51435,11371,74522
8600000US74523,4581,2122,2459,36566,60418,7409,74523
8600000US74525,7334,3762,3572,38872,58095,5042,74525
8600000US74528,150,88,62,54583,71248,25521,74528
8600000US74530,139,75,64,38214,43982,7284,74530
8600000US74531,720,309,411,38611,64358,19215,74531
8600000US74533,582,263,319,37500,56784,11480,74533
8600000US74534,112,38,74,27083,40403,11609,74534
8600000US74535,82,41,41,19583,25307,7826,74535
8600000US74536,1213,626,587,36429,48580,4279,74536
8600000US74538,3074,1512,1562,40168,65119,10197,74538
8600000US74540,171,70,101,35729,43031,7202,74540
8600000US74543,323,180,143,46250,67903,22161,74543
8600000US74546,541,236,305,36071,43842,4745,74546
8600000US74547,2623,1259,1364,42045,56886,5022,74547
8600000US74549,58,29,29,29531,51728,33637,74549
8600000US74552,899,469,430,34583,51834,8019,74552
8600000US74553,920,444,476,42386,54666,4824,74553
8600000US74554,1340,636,704,41375,49832,4266,74554
8600000US74555,558,273,285,37250,50973,10558,74555
8600000US74556,296,148,148,47045,58158,9143,74556
8600000US74557,397,197,200,39732,48221,6760,74557
8600000US74558,343,160,183,33636,41628,4991,74558
8600000US74560,482,224,258,44063,49387,5147,74560
8600000US74561,1525,720,805,44583,58397,10010,74561
8600000US74562,747,363,384,43864,62401,10905,74562
8600000US74563,1542,803,739,50625,62473,7049,74563
8600000US74565,549,273,276,56667,63075,6290,74565
8600000US74567,96,45,51,35000,46305,21397,74567
8600000US74569,1138,873,265,39167,58573,8031,74569
8600000US74570,835,467,368,43333,52413,4940,74570
8600000US74571,2706,1358,1348,39505,53883,6763,74571
8600000US74572,472,222,250,31912,45285,6559,74572
8600000US74574,991,522,469,35673,51770,7257,74574
8600000US74576,65,32,33,,84300,39552,74576
8600000US74577,159,67,92,35893,39836,10251,74577
8600000US74578,4701,2244,2457,39575,59583,7539,74578
8600000US74601,14042,6943,7099,40847,53574,3172,74601
8600000US74604,9571,4520,5051,57867,76340,4017,74604
8600000US74630,595,295,300,33523,47219,9147,74630
8600000US74631,5794,2801,2993,44601,58990,5588,74631
8600000US74632,459,228,231,53229,63486,10105,74632
8600000US74633,254,133,121,34167,47205,6297,74633
8600000US74636,199,98,101,53750,73302,15438,74636
8600000US74637,1291,638,653,36458,56083,14697,74637
8600000US74640,234,127,107,56000,71760,13630,74640
8600000US74641,521,273,248,51071,60752,5462,74641
8600000US74643,336,181,155,64219,84202,17821,74643
8600000US74644,369,196,173,42125,70560,21726,74644
8600000US74646,150,75,75,41500,68905,22703,74646
8600000US74647,2700,1353,1347,44483,58049,2966,74647
8600000US74650,537,272,265,35893,55720,10593,74650
8600000US74651,586,282,304,51327,65296,14256,74651
8600000US74652,607,301,306,45855,58590,6230,74652
8600000US74653,2745,1403,1342,45257,58145,3411,74653
8600000US74701,19259,9211,10048,41816,61324,4798,74701
8600000US74720,379,174,205,32344,46295,6550,74720
8600000US74722,191,95,96,34688,59333,16274,74722
8600000US74723,1045,518,527,34310,59242,11569,74723
8600000US74724,269,137,132,37292,44872,9544,74724
8600000US74726,1815,876,939,45240,55476,7959,74726
8600000US74727,1359,648,711,26691,46234,8157,74727
8600000US74728,8474,4136,4338,37281,48503,2716,74728
8600000US74729,2236,1118,1118,46042,53103,4046,74729
8600000US74730,3591,1624,1967,49871,59678,4527,74730
8600000US74731,1209,739,470,33787,50002,13756,74731
8600000US74733,2442,1126,1316,44612,61931,6370,74733
8600000US74734,877,437,440,42941,51858,6937,74734
8600000US74735,1179,586,593,43594,52544,4484,74735
8600000US74736,769,356,413,36429,46461,5661,74736
8600000US74738,509,305,204,27986,40925,7567,74738
8600000US74740,1803,886,917,38724,49182,6041,74740
8600000US74741,817,402,415,68266,69846,10748,74741
8600000US74743,6267,2824,3443,30158,49744,6118,74743
8600000US74745,7163,3358,3805,31496,45776,3075,74745
8600000US74747,161,54,107,16875,27021,7324,74747
8600000US74748,484,247,237,45795,53509,6985,74748
8600000US74750,245,114,131,25938,36166,8647,74750
8600000US74753,31,16,15,,,,74753
8600000US74754,201,121,80,,39279,13871,74754
8600000US74755,91,55,36,43375,37809,10196,74755
8600000US74756,561,261,300,34063,63048,12746,74756
8600000US74759,1074,561,513,37292,48769,5002,74759
8600000US74760,278,138,140,,47062,12021,74760
8600000US74761,55,29,26,15000,34597,21046,74761
8600000US74764,2861,1428,1433,44000,65143,11002,74764
8600000US74766,1099,526,573,31310,46217,4620,74766
8600000US74801,16647,8104,8543,39334,52323,1771,74801
8600000US74804,16214,7327,8887,51083,68603,3203,74804
8600000US74820,24137,11677,12460,49095,63820,2560,74820
8600000US74824,1064,545,519,47500,63954,10236,74824
8600000US74825,1579,725,854,43984,66426,12628,74825
8600000US74826,847,397,450,38606,49819,5810,74826
8600000US74827,280,117,163,45000,47355,10451,74827
8600000US74829,1373,1122,251,28015,34784,7843,74829
8600000US74830,183,91,92,36250,45083,7785,74830
8600000US74831,544,275,269,39063,50258,7826,74831
8600000US74832,697,324,373,43750,48334,6622,74832
8600000US74833,596,306,290,41250,50119,5272,74833
8600000US74834,5761,2847,2914,52052,67995,6169,74834
8600000US74836,160,91,69,,45747,32807,74836
8600000US74837,183,82,101,32500,40061,14227,74837
8600000US74839,634,302,332,32500,49146,9617,74839
8600000US74840,1464,761,703,49333,65146,10820,74840
8600000US74842,97,48,49,38750,49696,16467,74842
8600000US74843,273,102,171,31875,53536,15117,74843
8600000US74844,279,136,143,52083,64247,17907,74844
8600000US74845,354,178,176,34375,51130,8500,74845
8600000US74848,6302,3647,2655,38096,56300,4985,74848
8600000US74849,2258,1092,1166,37485,51966,6966,74849
8600000US74850,278,139,139,51667,55570,6939,74850
8600000US74851,8219,3597,4622,55487,67484,6288,74851
8600000US74852,1083,529,554,39609,64690,23183,74852
8600000US74854,1460,736,724,46331,54701,4034,74854
8600000US74855,3724,1857,1867,48496,68930,9942,74855
8600000US74856,647,305,342,53750,88694,28035,74856
8600000US74857,6779,3359,3420,63831,76935,8753,74857
8600000US74859,4604,2259,2345,37156,48503,3396,74859
8600000US74860,1279,605,674,43063,51919,5732,74860
8600000US74864,4058,2024,2034,51116,67512,9716,74864
8600000US74865,1280,629,651,55125,63652,4791,74865
8600000US74867,598,278,320,32917,45098,4824,74867
8600000US74868,10039,4875,5164,42880,56556,3376,74868
8600000US74869,565,272,293,49318,57761,11430,74869
8600000US74871,1870,919,951,56339,65971,6149,74871
8600000US74872,2351,1207,1144,39617,50994,5159,74872
8600000US74873,8560,4031,4529,49563,61582,4375,74873
8600000US74875,933,437,496,49185,58812,7193,74875
8600000US74878,1110,588,522,48636,54613,4556,74878
8600000US74880,1497,789,708,33472,49789,4845,74880
8600000US74881,3808,1903,1905,44972,58693,3783,74881
8600000US74883,1819,913,906,43068,59191,14319,74883
8600000US74884,4314,1997,2317,31781,45013,2999,74884
8600000US74901,1388,666,722,27159,38619,6130,74901
8600000US74902,3049,1411,1638,42093,52901,4162,74902
8600000US74930,1620,782,838,39773,50689,5048,74930
8600000US74931,984,529,455,35125,51623,8773,74931
8600000US74932,1787,884,903,37542,54061,9951,74932
8600000US74935,148,84,64,38750,49652,10196,74935
8600000US74936,844,424,420,39219,51393,6566,74936
8600000US74937,4075,2041,2034,31512,46024,7243,74937
8600000US74939,1062,819,243,37941,40150,5096,74939
8600000US74940,2255,1158,1097,41500,58738,8804,74940
8600000US74941,2054,1003,1051,45063,58321,5928,74941
8600000US74942,99,46,53,36250,47314,15228,74942
8600000US74943,123,64,59,36875,42643,10721,74943
8600000US74944,886,453,433,33676,51872,7107,74944
8600000US74945,348,174,174,37750,47361,9725,74945
8600000US74946,116,54,62,25357,34231,14738,74946
8600000US74948,9368,4395,4973,40868,54576,3976,74948
8600000US74949,220,115,105,37083,45720,9137,74949
8600000US74951,965,416,549,31316,39338,4010,74951
8600000US74953,9259,4490,4769,43611,60302,5622,74953
8600000US74954,3875,1833,2042,39911,55114,6258,74954
8600000US74955,11206,5513,5693,34683,46231,2571,74955
8600000US74956,1266,588,678,40054,56288,7628,74956
8600000US74957,856,425,431,42250,49874,4256,74957
8600000US74959,5544,2790,2754,45411,55237,3611,74959
8600000US74960,9826,4849,4977,32353,43431,1713,74960
8600000US74962,3491,1795,1696,32160,46030,4921,74962
8600000US74963,361,172,189,32222,59731,10648,74963
8600000US74964,2103,1038,1065,35833,46426,3928,74964
8600000US74965,3632,1736,1896,32667,49294,8669,74965
8600000US74966,2826,1429,1397,47137,59470,5065,74966
8600000US75001,13114,6594,6520,73094,88172,4600,75001
8600000US75002,50328,24732,25596,101661,127734,5901,75002
8600000US75006,37973,17927,20046,61844,80865,3350,75006
8600000US75007,42812,20621,22191,84541,99922,2976,75007
8600000US75009,8478,4429,4049,94523,132491,25072,75009
8600000US75010,22568,10703,11865,81164,103288,5595,75010
8600000US75013,28601,14196,14405,129627,156481,11138,75013
8600000US75019,31295,14924,16371,121279,150370,4909,75019
8600000US75020,17617,8452,9165,50241,66745,5720,75020
8600000US75021,6764,3189,3575,51250,69538,7835,75021
8600000US75022,18032,8974,9058,160885,197188,10740,75022
8600000US75023,39249,18567,20682,86449,105089,4930,75023
8600000US75024,33055,16149,16906,96674,128938,5129,75024
8600000US75025,39996,19791,20205,117793,140417,6512,75025
8600000US75028,34326,16492,17834,122861,140672,3757,75028
8600000US75032,23274,11452,11822,106869,132815,7662,75032
8600000US75034,71440,34807,36633,121401,154286,4191,75034
8600000US75035,47093,22752,24341,130851,147500,3803,75035
8600000US75038,22388,11091,11297,56636,75928,5249,75038
8600000US75039,15917,8244,7673,90961,116830,6374,75039
8600000US75040,45944,22200,23744,61517,73323,3404,75040
8600000US75041,22007,11110,10897,49029,62877,4990,75041
8600000US75042,27620,13794,13826,46704,59364,3502,75042
8600000US75043,44815,20892,23923,61466,73656,3066,75043
8600000US75044,33077,15816,17261,67854,90345,5613,75044
8600000US75048,18827,8690,10137,101161,106569,4784,75048
8600000US75050,31351,15763,15588,55753,67929,2521,75050
8600000US75051,28984,14098,14886,41154,51264,2150,75051
8600000US75052,69495,33395,36100,77230,88034,2325,75052
8600000US75054,7217,3674,3543,123963,133545,9769,75054
8600000US75056,44630,21719,22911,87941,117988,6564,75056
8600000US75057,10502,5469,5033,55743,67049,3728,75057
8600000US75058,1942,997,945,82778,108689,15807,75058
8600000US75060,33768,16271,17497,55051,67369,3037,75060
8600000US75061,38328,19333,18995,45822,59717,2283,75061
8600000US75062,35440,17612,17828,52331,70182,3782,75062
8600000US75063,28971,13962,15009,91431,114108,4498,75063
8600000US75065,9448,4702,4746,78567,90196,6917,75065
8600000US75067,50390,24514,25876,62921,76381,2530,75067
8600000US75068,42017,20574,21443,99472,109091,3763,75068
8600000US75069,28836,13698,15138,55435,86350,6489,75069
8600000US75070,69543,32243,37300,101462,121726,4026,75070
8600000US75071,36908,18072,18836,97277,115852,4261,75071
8600000US75074,38761,19250,19511,69214,87191,3879,75074
8600000US75075,29932,14420,15512,76610,97766,4586,75075
8600000US75076,6079,2961,3118,49989,77985,8436,75076
8600000US75077,28410,13971,14439,106571,131106,5208,75077
8600000US75078,15207,7428,7779,143669,174418,6710,75078
8600000US75080,39664,19900,19764,72660,96336,4045,75080
8600000US75081,30627,14969,15658,74125,90127,4158,75081
8600000US75082,18269,9204,9065,115264,144153,9915,75082
8600000US75087,24817,12038,12779,96789,110964,5200,75087
8600000US75088,20351,9637,10714,89022,104304,5522,75088
8600000US75089,25134,12301,12833,102520,112471,6625,75089
8600000US75090,18084,8771,9313,40607,53053,3231,75090
8600000US75092,18828,8962,9866,57923,74074,4826,75092
8600000US75093,37332,17884,19448,108718,160475,7442,75093
8600000US75094,15908,7913,7995,133125,148500,9610,75094
8600000US75098,38943,19040,19903,93511,103461,3749,75098
8600000US75101,414,202,212,45625,51308,7871,75101
8600000US75102,894,461,433,54038,59483,8937,75102
8600000US75103,11136,5244,5892,51621,72755,8184,75103
8600000US75104,34929,15707,19222,70975,84927,3143,75104
8600000US75105,152,87,65,41944,43932,14505,75105
8600000US75109,3466,1733,1733,67195,82373,5369,75109
8600000US75110,21243,10138,11105,44598,62354,4656,75110
8600000US75114,4782,2356,2426,67566,84280,11850,75114
8600000US75115,38376,17070,21306,69512,81920,3638,75115
8600000US75116,14017,6909,7108,46472,61012,3989,75116
8600000US75117,2853,1356,1497,50705,68605,10905,75117
8600000US75119,20546,10108,10438,56333,71669,3643,75119
8600000US75124,3295,1653,1642,50061,63706,6323,75124
8600000US75125,4486,2309,2177,59920,63068,7907,75125
8600000US75126,30184,14657,15527,95309,100089,3516,75126
8600000US75127,1284,690,594,39333,52578,6988,75127
8600000US75132,1058,510,548,80556,92529,26669,75132
8600000US75134,15105,6524,8581,52628,61208,4963,75134
8600000US75135,5251,2477,2774,80029,84349,8438,75135
8600000US75137,14774,6684,8090,62308,75840,4483,75137
8600000US75140,5486,2580,2906,46942,57468,5059,75140
8600000US75141,4592,3264,1328,37969,58127,11926,75141
8600000US75142,13935,7123,6812,53931,71203,4607,75142
8600000US75143,11221,5318,5903,46288,60582,4936,75143
8600000US75144,2555,1281,1274,44233,59520,5435,75144
8600000US75146,13130,5693,7437,57346,69271,7900,75146
8600000US75147,5314,2528,2786,44559,73920,19980,75147
8600000US75148,4573,2160,2413,35267,44823,4601,75148
8600000US75149,38159,18143,20016,48441,58707,2292,75149
8600000US75150,44869,20514,24355,52439,65002,2822,75150
8600000US75152,3465,1541,1924,62753,74871,10209,75152
8600000US75153,303,131,172,44167,70869,22643,75153
8600000US75154,28787,14017,14770,75543,88096,3982,75154
8600000US75155,1899,959,940,49156,59586,6626,75155
8600000US75156,12776,6104,6672,47311,67015,5108,75156
8600000US75157,169,89,80,36750,49729,13278,75157
8600000US75158,2963,1439,1524,60202,75983,8911,75158
8600000US75159,14236,7952,6284,51382,68123,6506,75159
8600000US75160,19095,9069,10026,50819,69703,5119,75160
8600000US75161,5294,2566,2728,49670,64495,5904,75161
8600000US75163,2354,1088,1266,41442,56424,8425,75163
8600000US75164,475,269,206,49899,60123,10630,75164
8600000US75165,32289,15283,17006,65659,83226,4251,75165
8600000US75166,2952,1459,1493,94375,111468,10683,75166
8600000US75167,8452,4249,4203,98902,112069,8696,75167
8600000US75169,10851,5236,5615,46124,66043,6726,75169
8600000US75172,3058,1624,1434,41224,46516,4985,75172
8600000US75173,3213,1685,1528,72284,86138,9766,75173
8600000US75180,15321,7861,7460,46714,58075,3761,75180
8600000US75181,20198,9735,10463,86242,92777,4170,75181
8600000US75182,4505,2290,2215,140486,160888,17785,75182
8600000US75189,19573,9326,10247,85207,98084,6424,75189
8600000US75201,15074,8225,6849,93983,138086,17128,75201
8600000US75202,1916,1082,834,83500,106863,15060,75202
8600000US75203,12532,6749,5783,35266,50132,3376,75203
8600000US75204,27473,14417,13056,74540,105358,5166,75204
8600000US75205,19348,9005,10343,146902,272402,16693,75205
8600000US75206,33439,17207,16232,67500,98486,4907,75206
8600000US75207,7639,5903,1736,76552,112949,23077,75207
8600000US75208,22493,11752,10741,61051,88430,4793,75208
8600000US75209,11678,5445,6233,86813,157662,13004,75209
8600000US75210,5804,2846,2958,26727,33224,2654,75210
8600000US75211,55224,27517,27707,41154,53350,2089,75211
8600000US75212,17414,8038,9376,32696,43294,3705,75212
8600000US75214,26965,12705,14260,85211,138563,7293,75214
8600000US75215,12607,6129,6478,28089,41330,4257,75215
8600000US75216,38384,17900,20484,26326,36940,2133,75216
8600000US75217,57177,26676,30501,38225,46064,1894,75217
8600000US75218,18162,8604,9558,77669,115184,9898,75218
8600000US75219,21589,11628,9961,72967,119427,10546,75219
8600000US75220,30871,16951,13920,46417,86992,6067,75220
8600000US75223,10797,5689,5108,47790,67386,5416,75223
8600000US75224,25137,12135,13002,40306,54310,4029,75224
8600000US75225,15873,7168,8705,167656,289833,19307,75225
8600000US75226,4074,2317,1757,46891,57692,6028,75226
8600000US75227,39379,18711,20668,40975,50793,2150,75227
8600000US75228,52536,25669,26867,42470,56314,2080,75228
8600000US75229,24049,12583,11466,93416,155754,8755,75229
8600000US75230,23190,11015,12175,87904,185916,11660,75230
8600000US75231,30215,15624,14591,39322,63566,3221,75231
8600000US75232,23523,10508,13015,36507,49600,3769,75232
8600000US75233,11373,5396,5977,47399,58531,4476,75233
8600000US75234,26160,12454,13706,66332,89486,4472,75234
8600000US75235,15922,8424,7498,49294,58991,4507,75235
8600000US75236,13014,5972,7042,40672,54371,5496,75236
8600000US75237,13936,5252,8684,27296,34116,2184,75237
8600000US75238,23453,11165,12288,62868,98482,5436,75238
8600000US75240,20231,10648,9583,47437,71320,4246,75240
8600000US75241,22064,9163,12901,32419,42962,3489,75241
8600000US75243,50617,24957,25660,40954,61888,2324,75243
8600000US75244,10985,5169,5816,85914,129582,7795,75244
8600000US75246,2011,1042,969,26090,45668,7928,75246
8600000US75247,730,557,173,17798,29092,10636,75247
8600000US75248,29860,14837,15023,84236,127590,8305,75248
8600000US75249,11647,5084,6563,54856,68243,5562,75249
8600000US75251,2218,841,1377,63438,72973,13894,75251
8600000US75252,22191,11197,10994,61151,101568,5075,75252
8600000US75253,14905,7475,7430,43028,51829,4263,75253
8600000US75254,19716,9536,10180,51276,86360,6884,75254
8600000US75270,0,0,0,,,,75270
8600000US75287,43883,20074,23809,51045,77989,3126,75287
8600000US75390,0,0,0,,,,75390
8600000US75401,13716,6679,7037,35091,48732,3002,75401
8600000US75402,13485,6746,6739,65391,81543,8534,75402
8600000US75407,11662,5767,5895,60763,77728,5648,75407
8600000US75409,10279,4828,5451,86304,89430,7131,75409
8600000US75410,4552,2288,2264,64069,72070,13539,75410
8600000US75411,1068,601,467,59583,67943,15344,75411
8600000US75412,457,181,276,51250,50635,10737,75412
8600000US75413,174,73,101,,53379,18423,75413
8600000US75414,2118,979,1139,61000,77695,10691,75414
8600000US75415,154,89,65,85865,82858,10922,75415
8600000US75416,2342,1097,1245,44529,61668,10192,75416
8600000US75417,1976,879,1097,40263,56119,7057,75417
8600000US75418,11745,6866,4879,43466,62282,5321,75418
8600000US75420,779,430,349,72384,82323,15583,75420
8600000US75421,394,202,192,63750,66474,17553,75421
8600000US75422,2494,1254,1240,57245,74920,9851,75422
8600000US75423,2229,1130,1099,61678,75850,10827,75423
8600000US75424,2440,1195,1245,78359,92390,12902,75424
8600000US75426,3950,1938,2012,34988,42372,5127,75426
8600000US75428,9046,4203,4843,33196,51515,4413,75428
8600000US75431,1934,921,1013,49583,61250,10769,75431
8600000US75432,2595,1231,1364,43281,63329,7560,75432
8600000US75433,2084,1019,1065,52132,72212,8532,75433
8600000US75435,975,446,529,36750,43409,5283,75435
8600000US75436,1564,774,790,50551,54180,5657,75436
8600000US75437,1046,557,489,64135,74905,10861,75437
8600000US75438,665,334,331,68636,77130,9332,75438
8600000US75439,803,363,440,62109,70352,8877,75439
8600000US75440,5147,2520,2627,49963,71751,7241,75440
8600000US75441,101,61,40,50887,48353,3741,75441
8600000US75442,7384,3763,3621,69703,80702,9139,75442
8600000US75446,2480,1187,1293,37946,52728,5629,75446
8600000US75447,911,505,406,77464,98127,26219,75447
8600000US75448,542,288,254,,60578,10575,75448
8600000US75449,1062,554,508,36319,45918,6549,75449
8600000US75450,106,41,65,,59025,33266,75450
8600000US75451,961,499,462,38373,49003,9921,75451
8600000US75452,3113,1461,1652,56287,66289,5952,75452
8600000US75453,2328,1136,1192,52500,62113,7339,75453
8600000US75454,6607,2964,3643,96889,119544,15886,75454
8600000US75455,20100,9832,10268,47169,59296,2842,75455
8600000US75457,4904,2387,2517,51783,69432,9905,75457
8600000US75459,3972,1848,2124,64535,71910,7408,75459
8600000US75460,17750,8015,9735,33851,46809,3596,75460
8600000US75462,8651,4045,4606,59016,80036,7613,75462
8600000US75468,619,331,288,51198,50653,13228,75468
8600000US75469,261,125,136,39844,46056,7972,75469
8600000US75470,339,203,136,62946,49126,15631,75470
8600000US75471,1039,547,492,70469,103382,44360,75471
8600000US75472,2997,1484,1513,46414,56405,7054,75472
8600000US75473,2835,1501,1334,64094,75419,14598,75473
8600000US75474,11451,5470,5981,48072,59512,3818,75474
8600000US75475,132,63,69,30938,33380,6302,75475
8600000US75476,1052,527,525,56563,68068,13579,75476
8600000US75477,927,520,407,45313,62873,19794,75477
8600000US75478,738,377,361,46563,65631,12428,75478
8600000US75479,1447,731,716,52414,63108,6604,75479
8600000US75480,1492,713,779,59097,67650,14656,75480
8600000US75481,277,147,130,51250,54923,7952,75481
8600000US75482,18588,8799,9789,50154,68758,5133,75482
8600000US75486,1585,782,803,56176,61697,10146,75486
8600000US75487,1390,743,647,49583,63333,13552,75487
8600000US75488,467,235,232,49821,52708,10729,75488
8600000US75489,787,386,401,53688,60110,9118,75489
8600000US75490,1906,1007,899,72143,76933,6519,75490
8600000US75491,3733,1667,2066,72371,82425,9102,75491
8600000US75492,335,202,133,52500,64778,18081,75492
8600000US75493,306,156,150,42115,48904,7835,75493
8600000US75494,7290,3760,3530,40474,57472,5731,75494
8600000US75495,6659,3364,3295,78673,96967,13763,75495
8600000US75496,2905,1367,1538,64900,71892,8325,75496
8600000US75497,2932,1515,1417,63417,74278,18078,75497
8600000US75501,26976,13640,13336,36690,55199,4254,75501
8600000US75503,19095,8745,10350,60730,91552,8372,75503
8600000US75550,707,356,351,39453,50613,11103,75550
8600000US75551,8121,3665,4456,46642,58620,6002,75551
8600000US75554,1642,763,879,44327,59195,8921,75554
8600000US75555,1264,613,651,53008,74064,19737,75555
8600000US75556,920,428,492,43043,54658,7465,75556
8600000US75558,1247,526,721,44719,67774,20715,75558
8600000US75559,4027,1730,2297,40691,67569,17987,75559
8600000US75560,667,326,341,38125,52507,13865,75560
8600000US75561,3852,1805,2047,45497,56672,6774,75561
8600000US75562,177,125,52,44087,49620,11759,75562
8600000US75563,3806,1815,1991,41719,51182,6681,75563
8600000US75565,157,72,85,31328,48929,32197,75565
8600000US75566,658,302,356,43750,48198,11323,75566
8600000US75567,3874,1811,2063,65330,67995,6366,75567
8600000US75568,1813,916,897,40948,46322,6853,75568
8600000US75569,2323,1179,1144,40046,42669,4381,75569
8600000US75570,9493,6138,3355,50786,61740,5444,75570
8600000US75571,2146,980,1166,53077,64065,9737,75571
8600000US75572,3256,1688,1568,51161,59142,8742,75572
8600000US75573,83,37,46,85729,78678,13990,75573
8600000US75574,1389,614,775,56371,61158,9919,75574
8600000US75601,12282,5826,6456,41932,60053,5491,75601
8600000US75602,15910,8069,7841,39428,57690,8049,75602
8600000US75603,4473,2156,2317,50265,70791,9160,75603
8600000US75604,21999,10848,11151,51158,68479,4392,75604
8600000US75605,23580,10564,13016,60807,86975,5200,75605
8600000US75630,2004,1024,980,42029,59813,11343,75630
8600000US75631,2278,1091,1187,60660,69114,7541,75631
8600000US75633,10179,5079,5100,51795,69787,7447,75633
8600000US75638,4523,2155,2368,43206,58391,10472,75638
8600000US75639,2344,1101,1243,31744,54092,19386,75639
8600000US75640,3326,1674,1652,44625,60846,7881,75640
8600000US75641,102,35,67,40833,45787,21919,75641
8600000US75642,62,25,37,,,,75642
8600000US75643,1868,878,990,52344,71672,14012,75643
8600000US75644,9815,4834,4981,43710,62036,5660,75644
8600000US75645,7972,4018,3954,62992,75730,6278,75645
8600000US75647,9905,4442,5463,48079,64540,5087,75647
8600000US75650,6872,3397,3475,64264,80786,10716,75650
8600000US75651,1375,654,721,50833,66019,17581,75651
8600000US75652,13759,8514,5245,48526,67120,7533,75652
8600000US75654,8900,4035,4865,48925,65290,5921,75654
8600000US75656,3161,1498,1663,42470,55030,5962,75656
8600000US75657,6235,2938,3297,36131,61403,9461,75657
8600000US75661,2446,1267,1179,49950,83407,37380,75661
8600000US75662,19211,9237,9974,59326,65276,3980,75662
8600000US75667,876,488,388,40333,68819,21679,75667
8600000US75668,1739,760,979,37738,49291,6790,75668
8600000US75669,431,210,221,68237,72713,24171,75669
8600000US75670,12896,6155,6741,39626,51736,4807,75670
8600000US75672,12251,5850,6401,54705,69084,5257,75672
8600000US75681,1787,916,871,48958,69206,16646,75681
8600000US75682,375,176,199,54583,78705,16779,75682
8600000US75683,3016,1440,1576,40481,52869,9710,75683
8600000US75684,5641,2984,2657,53321,64469,5796,75684
8600000US75686,9733,4640,5093,43947,57957,4466,75686
8600000US75691,2610,1382,1228,55250,66346,10318,75691
8600000US75692,3709,1899,1810,54392,59685,5647,75692
8600000US75693,5136,2619,2517,61983,80341,13893,75693
8600000US75701,27580,12019,15561,47919,68680,4958,75701
8600000US75702,19611,9777,9834,33066,44692,3403,75702
8600000US75703,32240,15178,17062,57934,86337,4393,75703
8600000US75704,7650,3543,4107,38385,49032,4994,75704
8600000US75705,2807,1229,1578,41563,62267,17182,75705
8600000US75706,6725,3272,3453,55801,63294,7708,75706
8600000US75707,10769,5169,5600,65000,85549,7693,75707
8600000US75708,5902,2803,3099,41270,46536,6294,75708
8600000US75709,4096,1975,2121,54935,83621,20307,75709
8600000US75750,2826,1420,1406,55192,75449,15079,75750
8600000US75751,12546,5934,6612,43568,66096,6632,75751
8600000US75752,5777,2917,2860,51153,63087,6623,75752
8600000US75754,5088,2766,2322,53796,71037,8895,75754
8600000US75755,3971,1824,2147,49135,66243,15012,75755
8600000US75756,3331,1576,1755,57826,83893,17748,75756
8600000US75757,9403,4623,4780,65897,83786,8221,75757
8600000US75758,6663,3337,3326,51082,67522,6636,75758
8600000US75759,33,20,13,,23260,16303,75759
8600000US75760,1900,928,972,46887,61226,10500,75760
8600000US75762,9209,4399,4810,76903,101537,13293,75762
8600000US75763,5022,2425,2597,55122,67130,6544,75763
8600000US75764,126,64,62,63750,63413,14334,75764
8600000US75765,6206,2998,3208,46742,59668,5462,75765
8600000US75766,19730,9601,10129,45316,58540,3702,75766
8600000US75770,2601,1271,1330,60541,89651,17324,75770
8600000US75771,15896,7825,8071,64267,80387,6407,75771
8600000US75773,10658,4995,5663,47824,74356,15021,75773
8600000US75778,2460,1024,1436,50349,69920,22761,75778
8600000US75779,76,42,34,51250,59218,27729,75779
8600000US75780,180,96,84,62813,62653,20926,75780
8600000US75783,6332,3161,3171,51071,63887,6374,75783
8600000US75784,653,349,304,41208,48879,9334,75784
8600000US75785,8812,5322,3490,48787,59696,5926,75785
8600000US75788,109,71,38,,,,75788
8600000US75789,5790,2838,2952,50625,63584,5224,75789
8600000US75790,3035,1418,1617,61048,74611,8618,75790
8600000US75791,9795,4522,5273,73231,81910,6578,75791
8600000US75792,2215,1107,1108,44688,55340,9084,75792
8600000US75801,11986,5773,6213,38412,52302,4365,75801
8600000US75803,18249,12064,6185,44848,57577,4992,75803
8600000US75831,4162,1947,2215,43011,59831,6901,75831
8600000US75832,107,84,23,,,,75832
8600000US75833,2477,1376,1101,59375,110371,60590,75833
8600000US75835,8498,4051,4447,28907,44608,4549,75835
8600000US75838,402,220,182,60114,67133,26065,75838
8600000US75839,3947,1827,2120,39903,49067,4926,75839
8600000US75840,4931,2269,2662,56228,73678,9103,75840
8600000US75844,4787,2280,2507,40824,53526,6775,75844
8600000US75845,2513,1242,1271,45548,52373,6538,75845
8600000US75846,2098,1105,993,37325,66576,22458,75846
8600000US75847,1423,614,809,37202,46183,6347,75847
8600000US75848,89,33,56,48438,45809,14818,75848
8600000US75849,68,37,31,30750,27288,7986,75849
8600000US75850,523,282,241,54309,63764,16706,75850
8600000US75851,4487,3496,991,50642,54735,6380,75851
8600000US75852,4178,3769,409,41607,67324,16286,75852
8600000US75853,508,267,241,35556,55549,15285,75853
8600000US75855,2320,1154,1166,37386,52718,7123,75855
8600000US75856,67,39,28,,,,75856
8600000US75858,0,0,0,,,,75858
8600000US75859,1510,732,778,32038,65474,13807,75859
8600000US75860,5243,3169,2074,52280,69367,7177,75860
8600000US75861,8714,7996,718,59010,56926,7509,75861
8600000US75862,8006,3765,4241,39200,51478,4396,75862
8600000US75901,22891,11291,11600,49130,63360,4790,75901
8600000US75904,24744,11308,13436,49631,62774,3509,75904
8600000US75925,2884,1271,1613,36419,50541,5385,75925
8600000US75926,867,385,482,45667,53090,8432,75926
8600000US75928,1054,635,419,41110,54434,18741,75928
8600000US75929,1349,692,657,47417,78189,34702,75929
8600000US75930,1621,923,698,28398,45061,8937,75930
8600000US75931,1712,868,844,48837,58780,8575,75931
8600000US75932,1372,818,554,47560,67314,12651,75932
8600000US75933,1146,585,561,28833,49420,16424,75933
8600000US75934,164,97,67,85089,89219,27789,75934
8600000US75935,9819,4673,5146,40661,54855,5696,75935
8600000US75936,776,404,372,56333,61708,9621,75936
8600000US75937,724,361,363,40179,59145,11655,75937
8600000US75938,2281,1130,1151,43056,56696,5076,75938
8600000US75939,3679,1904,1775,41667,65235,10441,75939
8600000US75941,6634,3725,2909,45777,57838,8064,75941
8600000US75942,116,40,76,50451,38764,15088,75942
8600000US75943,1030,512,518,42228,85836,28959,75943
8600000US75944,1044,518,526,45530,57848,8290,75944
8600000US75946,2695,1386,1309,46542,58103,6869,75946
8600000US75948,5201,2563,2638,32750,56760,7063,75948
8600000US75949,5789,2695,3094,36775,52633,6058,75949
8600000US75951,11889,5665,6224,40630,70417,10068,75951
8600000US75954,2162,1161,1001,43315,54860,8960,75954
8600000US75956,6563,3241,3322,45371,54393,5109,75956
8600000US75959,587,294,293,47917,46307,10510,75959
8600000US75960,486,307,179,,39340,19005,75960
8600000US75961,12000,5604,6396,36023,54779,5578,75961
8600000US75962,3184,1236,1948,,,,75962
8600000US75964,13592,6497,7095,41571,55080,5202,75964
8600000US75965,14696,6823,7873,48579,70179,5243,75965
8600000US75966,3508,1811,1697,44470,56389,6868,75966
8600000US75968,1422,676,746,27569,48856,9028,75968
8600000US75969,3272,1487,1785,49848,58192,9052,75969
8600000US75972,4731,2145,2586,36265,50455,6579,75972
8600000US75973,2040,1105,935,44848,57065,11437,75973
8600000US75974,2661,1295,1366,38517,53471,7499,75974
8600000US75975,2785,1215,1570,40476,56560,9557,75975
8600000US75976,505,221,284,27589,46414,12693,75976
8600000US75977,387,216,171,22386,29552,6327,75977
8600000US75978,96,52,44,74236,80396,21472,75978
8600000US75979,9846,5594,4252,37268,51533,5894,75979
8600000US75980,1878,911,967,37696,55119,10504,75980
8600000US76001,23148,11222,11926,86682,104642,5766,76001
8600000US76002,25454,11538,13916,86033,96912,6835,76002
8600000US76006,19464,9392,10072,47741,71153,4713,76006
8600000US76008,12396,6277,6119,128632,154752,11071,76008
8600000US76009,15131,7265,7866,55493,66761,5426,76009
8600000US76010,39687,20337,19350,36461,46515,2577,76010
8600000US76011,17376,8831,8545,37159,51431,3135,76011
8600000US76012,20535,9455,11080,61214,85887,5024,76012
8600000US76013,26841,12772,14069,52352,71339,2946,76013
8600000US76014,25559,12170,13389,52071,58849,3111,76014
8600000US76015,12621,5940,6681,55644,70355,4288,76015
8600000US76016,24573,11525,13048,81411,107785,5696,76016
8600000US76017,36034,17718,18316,70871,88496,3630,76017
8600000US76018,23119,11145,11974,67081,78190,3459,76018
8600000US76020,22010,10636,11374,63560,83237,5421,76020
8600000US76021,28514,12911,15603,71376,87202,3126,76021
8600000US76022,10804,4799,6005,56476,69514,3657,76022
8600000US76023,5111,2484,2627,58651,70596,6845,76023
8600000US76028,50983,24280,26703,78175,97241,3932,76028
8600000US76031,12804,6393,6411,54052,68815,7265,76031
8600000US76033,19606,9744,9862,54961,71654,3900,76033
8600000US76034,19927,9914,10013,175096,227848,14810,76034
8600000US76035,1430,795,635,97426,142411,38983,76035
8600000US76036,18723,8812,9911,72671,86687,5272,76036
8600000US76039,27682,13437,14245,67200,83237,3161,76039
8600000US76040,23590,11232,12358,57560,73441,4253,76040
8600000US76041,426,176,250,,89583,25322,76041
8600000US76043,5689,2713,2976,54412,68244,8235,76043
8600000US76044,2917,1559,1358,67857,75313,7172,76044
8600000US76048,18798,8891,9907,49844,67709,4935,76048
8600000US76049,23472,11616,11856,68155,90917,6483,76049
8600000US76050,4775,2155,2620,69194,77520,8589,76050
8600000US76051,40160,20177,19983,85667,112163,4724,76051
8600000US76052,15781,7793,7988,109311,130122,14580,76052
8600000US76053,22878,11153,11725,55174,71801,4380,76053
8600000US76054,9275,4499,4776,96875,110121,6483,76054
8600000US76055,2103,1034,1069,46739,61599,7863,76055
8600000US76058,13165,6497,6668,56587,69775,5057,76058
8600000US76059,3839,1696,2143,43944,58624,6410,76059
8600000US76060,6092,3082,3010,75534,93439,10324,76060
8600000US76061,39,20,19,,,,76061
8600000US76063,50830,24537,26293,95407,115027,3460,76063
8600000US76064,1183,550,633,64375,94412,28111,76064
8600000US76065,25861,12624,13237,93071,114246,13287,76065
8600000US76066,2155,1015,1140,58810,73985,11942,76066
8600000US76067,15073,7432,7641,42034,55991,3738,76067
8600000US76070,672,331,341,89868,97692,24568,76070
8600000US76071,3249,1560,1689,55104,77500,18640,76071
8600000US76073,4216,2115,2101,71786,86482,9211,76073
8600000US76077,313,223,90,14821,31342,19073,76077
8600000US76078,7135,3626,3509,67113,84285,5535,76078
8600000US76082,14524,7051,7473,61732,71287,4508,76082
8600000US76084,6257,3759,2498,58708,73106,10120,76084
8600000US76085,8297,4153,4144,70648,94633,10487,76085
8600000US76086,17708,8337,9371,59253,69375,4733,76086
8600000US76087,20539,10389,10150,95876,109153,7018,76087
8600000US76088,8946,4467,4479,72773,85419,6263,76088
8600000US76092,20565,9887,10678,230750,283937,24427,76092
8600000US76093,1280,613,667,49500,63314,11422,76093
8600000US76102,8182,4372,3810,68824,99229,14933,76102
8600000US76103,11218,5331,5887,40712,53872,4368,76103
8600000US76104,12845,5882,6963,27471,41559,3160,76104
8600000US76105,14741,7283,7458,29423,38148,2197,76105
8600000US76106,26855,14442,12413,36980,45962,2504,76106
8600000US76107,24597,11534,13063,63817,108283,7062,76107
8600000US76108,31800,15372,16428,65864,86637,5980,76108
8600000US76109,18691,8947,9744,76856,141643,10808,76109
8600000US76110,23423,12166,11257,46313,68575,3609,76110
8600000US76111,15466,8237,7229,46840,56759,3767,76111
8600000US76112,30993,15082,15911,42269,58380,3195,76112
8600000US76114,18911,9814,9097,49713,59217,3314,76114
8600000US76115,14050,7117,6933,37607,45518,3541,76115
8600000US76116,38834,18136,20698,48575,72737,4146,76116
8600000US76117,22921,11274,11647,48280,56864,3107,76117
8600000US76118,11880,5415,6465,71439,89755,7788,76118
8600000US76119,34458,17540,16918,34985,45187,1946,76119
8600000US76120,13708,5733,7975,50663,61889,3814,76120
8600000US76123,23894,11493,12401,84460,95461,4578,76123
8600000US76126,17004,8198,8806,87878,120607,6759,76126
8600000US76127,1978,405,1573,69348,78266,11977,76127
8600000US76129,2920,1087,1833,,,,76129
8600000US76131,27190,13516,13674,83708,93974,6621,76131
8600000US76132,21031,9263,11768,53688,88772,6957,76132
8600000US76133,37724,17263,20461,53696,68539,3098,76133
8600000US76134,18475,8208,10267,47763,60996,5805,76134
8600000US76135,16935,8400,8535,62603,85050,6517,76135
8600000US76137,43281,20213,23068,72336,85381,3024,76137
8600000US76140,21285,9953,11332,54142,68386,5302,76140
8600000US76148,17563,8697,8866,71151,78541,3676,76148
8600000US76155,4610,2189,2421,57424,63616,4681,76155
8600000US76164,11378,5860,5518,36586,45819,3895,76164
8600000US76177,6941,3898,3043,93233,98317,8352,76177
8600000US76179,42434,19977,22457,86456,103283,4336,76179
8600000US76180,28376,13127,15249,57142,72874,3101,76180
8600000US76182,23604,11331,12273,88314,112630,6219,76182
8600000US76201,25735,12246,13489,29724,41895,2390,76201
8600000US76205,18582,9571,9011,47139,68090,4437,76205
8600000US76207,11442,5564,5878,61836,79639,9379,76207
8600000US76208,17749,8778,8971,81151,99203,5074,76208
8600000US76209,19068,8394,10674,53869,64229,3902,76209
8600000US76210,33304,15971,17333,90080,102438,4565,76210
8600000US76225,2329,1112,1217,68026,90491,14177,76225
8600000US76226,18108,8963,9145,132935,166004,10069,76226
8600000US76227,22194,10431,11763,91293,103136,5702,76227
8600000US76228,791,386,405,61172,75464,9733,76228
8600000US76230,7540,3575,3965,53158,71444,8461,76230
8600000US76233,2457,1299,1158,76435,85883,10453,76233
8600000US76234,11995,5655,6340,65470,89142,10779,76234
8600000US76238,301,153,148,64844,72239,18272,76238
8600000US76239,967,523,444,69444,85134,14776,76239
8600000US76240,20801,10232,10569,50527,68053,3795,76240
8600000US76244,51631,25142,26489,101866,112068,4085,76244
8600000US76245,1729,891,838,49611,64147,10768,76245
8600000US76247,10066,4742,5324,90848,104332,7014,76247
8600000US76248,28356,13671,14685,129550,159981,6130,76248
8600000US76249,6360,3470,2890,81207,84252,6342,76249
8600000US76250,765,352,413,80789,92913,18128,76250
8600000US76251,528,262,266,49750,68424,11207,76251
8600000US76252,2096,1028,1068,74000,92849,8397,76252
8600000US76253,218,94,124,54286,78155,30657,76253
8600000US76255,4237,2012,2225,44921,59566,6165,76255
8600000US76258,5372,2516,2856,65839,87750,13328,76258
8600000US76259,4365,2236,2129,75183,83119,8649,76259
8600000US76261,205,121,84,59643,66507,16255,76261
8600000US76262,26288,13062,13226,114633,148750,7717,76262
8600000US76263,119,57,62,,71879,33608,76263
8600000US76264,1289,637,652,58500,62526,10418,76264
8600000US76265,1186,628,558,51908,74941,15809,76265
8600000US76266,11966,5616,6350,71076,90150,8499,76266
8600000US76268,185,81,104,44000,51474,9413,76268
8600000US76270,1367,677,690,75781,83620,17254,76270
8600000US76271,1268,526,742,72768,86229,10942,76271
8600000US76272,3207,1529,1678,67500,84487,9945,76272
8600000US76273,7332,3476,3856,64841,67497,5513,76273
8600000US76301,11131,5196,5935,26505,37540,2451,76301
8600000US76302,9870,4642,5228,45978,61674,4966,76302
8600000US76305,3489,1758,1731,54583,64494,5282,76305
8600000US76306,10938,5111,5827,45470,52613,3679,76306
8600000US76308,15365,6671,8694,49864,71970,5120,76308
8600000US76309,9786,4552,5234,44898,70138,7500,76309
8600000US76310,13822,6619,7203,66368,82446,4978,76310
8600000US76311,7941,6433,1508,62011,67471,5294,76311
8600000US76351,1534,719,815,43542,62426,10513,76351
8600000US76354,9203,4146,5057,51236,62090,4906,76354
8600000US76357,460,210,250,47500,87433,27692,76357
8600000US76360,3059,1583,1476,38835,52939,9680,76360
8600000US76363,352,174,178,71875,63697,13948,76363
8600000US76364,105,54,51,66250,61022,13323,76364
8600000US76365,3470,1808,1662,47900,64536,7933,76365
8600000US76366,1474,669,805,52400,66375,10634,76366
8600000US76367,12485,8822,3663,57742,66973,5666,76367
8600000US76370,237,120,117,52750,77432,36535,76370
8600000US76371,1063,509,554,39881,57092,8536,76371
8600000US76372,832,412,420,37308,53054,9718,76372
8600000US76373,165,101,64,38315,49772,18534,76373
8600000US76374,3161,1547,1614,49702,58264,6993,76374
8600000US76377,621,306,315,35994,42351,6745,76377
8600000US76379,452,208,244,61250,65114,9251,76379
8600000US76380,2839,1348,1491,41313,60132,7222,76380
8600000US76384,9518,4705,4813,48640,59918,5541,76384
8600000US76388,236,126,110,48173,57690,10646,76388
8600000US76389,1110,553,557,72933,77296,8199,76389
8600000US76401,23872,11024,12848,48109,66577,4580,76401
8600000US76402,847,363,484,,,,76402
8600000US76424,6780,3483,3297,43726,57113,4865,76424
8600000US76426,9581,5039,4542,49205,67260,5509,76426
8600000US76427,559,305,254,44125,60469,11194,76427
8600000US76429,119,104,15,41860,59342,27983,76429
8600000US76430,1693,753,940,45187,58711,9800,76430
8600000US76431,2357,1190,1167,46795,64233,10721,76431
8600000US76432,913,463,450,39946,53555,8069,76432
8600000US76433,1248,569,679,68906,80549,9667,76433
8600000US76435,406,184,222,35263,45342,10592,76435
8600000US76436,162,93,69,60833,67717,31396,76436
8600000US76437,4576,2376,2200,38429,62015,11558,76437
8600000US76442,5930,2996,2934,49714,62791,7087,76442
8600000US76443,1590,787,803,35469,47283,7917,76443
8600000US76444,2861,1249,1612,41421,57050,7922,76444
8600000US76445,157,88,69,,18989,11788,76445
8600000US76446,5742,3055,2687,49014,69765,14320,76446
8600000US76448,4377,2228,2149,35000,80055,29481,76448
8600000US76449,2083,1068,1015,57738,87339,13784,76449
8600000US76450,9844,4807,5037,49327,71245,7853,76450
8600000US76452,60,47,13,71806,73346,4114,76452
8600000US76453,1133,557,576,63750,95474,17162,76453
8600000US76454,1190,559,631,39330,45317,8996,76454
8600000US76455,766,457,309,52386,65543,14790,76455
8600000US76457,2908,1437,1471,39973,55369,6767,76457
8600000US76458,4835,2853,1982,50169,68090,7573,76458
8600000US76459,165,113,52,107692,90469,25612,76459
8600000US76460,263,135,128,63750,73266,34972,76460
8600000US76462,2625,1497,1128,80644,99287,17947,76462
8600000US76463,343,179,164,40972,56860,14571,76463
8600000US76464,453,209,244,40982,49149,9364,76464
8600000US76466,244,95,149,,56577,38317,76466
8600000US76469,72,30,42,33875,39903,19156,76469
8600000US76470,2751,1378,1373,32898,47472,7367,76470
8600000US76471,1548,724,824,44306,57187,7499,76471
8600000US76472,1300,575,725,52452,88835,25673,76472
8600000US76474,182,89,93,59688,67000,17710,76474
8600000US76475,677,347,330,39583,66954,13868,76475
8600000US76476,2066,1054,1012,66902,75026,10102,76476
8600000US76481,110,54,56,,,,76481
8600000US76483,879,406,473,41806,63037,14613,76483
8600000US76484,773,378,395,44267,68193,19368,76484
8600000US76486,953,490,463,52679,67511,9879,76486
8600000US76487,2228,1068,1160,55833,80876,12513,76487
8600000US76490,74,42,32,31736,44464,31013,76490
8600000US76491,233,105,128,58036,58857,10129,76491
8600000US76501,12625,6424,6201,45623,57531,3789,76501
8600000US76502,29268,13699,15569,68735,88037,5322,76502
8600000US76504,17785,8520,9265,40368,51976,3703,76504
8600000US76508,8,8,0,,,,76508
8600000US76511,2194,1390,804,41532,58941,11616,76511
8600000US76513,28155,13547,14608,62734,86140,5205,76513
8600000US76518,1289,548,741,43896,63905,16243,76518
8600000US76519,209,104,105,37063,73064,40918,76519
8600000US76520,5931,2722,3209,44708,61524,9011,76520
8600000US76522,26553,12357,14196,53399,68497,4898,76522
8600000US76523,0,0,0,,,,76523
8600000US76524,2276,1103,1173,62986,74665,10992,76524
8600000US76525,851,425,426,52708,62125,9813,76525
8600000US76527,2735,1417,1318,57734,76510,11721,76527
8600000US76528,12790,5324,7466,49523,59583,3295,76528
8600000US76530,1712,938,774,47917,73674,11302,76530
8600000US76531,3873,1901,1972,47279,75113,15698,76531
8600000US76534,1957,904,1053,50972,62311,5112,76534
8600000US76537,4283,2069,2214,68790,80149,8371,76537
8600000US76538,606,274,332,78250,74370,10537,76538
8600000US76539,6700,3362,3338,67833,81339,7464,76539
8600000US76541,13712,6934,6778,30921,38323,2234,76541
8600000US76542,35126,16924,18202,62612,74721,3209,76542
8600000US76543,21814,10332,11482,41950,50004,2405,76543
8600000US76544,19810,14753,5057,43683,51677,2500,76544
8600000US76548,22035,11295,10740,72982,83399,7849,76548
8600000US76549,34774,16699,18075,54408,64721,3500,76549
8600000US76550,9753,4709,5044,50776,68101,4812,76550
8600000US76554,1500,787,713,53250,62580,6455,76554
8600000US76556,1086,566,520,47941,63870,6803,76556
8600000US76557,3984,2040,1944,60625,73528,11329,76557
8600000US76559,3951,1942,2009,56058,62117,6586,76559
8600000US76561,752,337,415,56250,63907,6343,76561
8600000US76565,86,52,34,,72161,48260,76565
8600000US76566,237,117,120,,43744,16973,76566
8600000US76567,7076,3663,3413,50092,55410,4766,76567
8600000US76569,1805,964,841,62333,77778,11895,76569
8600000US76570,2101,1132,969,40391,57121,9399,76570
8600000US76571,5708,2915,2793,85096,113025,10816,76571
8600000US76573,23,9,14,,,,76573
8600000US76574,15008,7464,7544,51613,67346,4339,76574
8600000US76577,2476,1257,1219,57803,69891,7288,76577
8600000US76578,1059,584,475,67976,73189,9187,76578
8600000US76579,3325,1534,1791,55975,68972,8025,76579
8600000US76596,1311,0,1311,,,,76596
8600000US76597,2817,2816,1,,,,76597
8600000US76598,503,0,503,,,,76598
8600000US76599,2076,0,2076,,,,76599
8600000US76621,615,307,308,69167,83529,12841,76621
8600000US76622,873,436,437,63409,67970,7108,76622
8600000US76623,124,62,62,58750,83059,40406,76623
8600000US76624,1495,755,740,63448,72519,10073,76624
8600000US76626,836,362,474,52212,64640,10243,76626
8600000US76627,1163,505,658,66083,68631,9360,76627
8600000US76628,31,21,10,,28074,12997,76628
8600000US76629,1411,712,699,38370,58921,10119,76629
8600000US76630,978,494,484,66023,66991,11587,76630
8600000US76631,412,186,226,68125,67628,6833,76631
8600000US76632,1267,639,628,39375,43472,8283,76632
8600000US76633,4031,2099,1932,85110,100422,11399,76633
8600000US76634,5951,2837,3114,55911,69604,5102,76634
8600000US76635,881,451,430,36118,47393,5969,76635
8600000US76636,1166,517,649,54844,78920,11630,76636
8600000US76637,428,207,221,50288,54676,8051,76637
8600000US76638,2222,1083,1139,78150,98778,17568,76638
8600000US76639,1122,574,548,46204,55946,7790,76639
8600000US76640,2388,1156,1232,38922,55362,9745,76640
8600000US76641,1371,673,698,43654,57489,8140,76641
8600000US76642,5211,2636,2575,46948,61430,7874,76642
8600000US76643,11096,5289,5807,73600,88362,7061,76643
8600000US76645,7771,3772,3999,43683,57651,4041,76645
8600000US76648,2166,1044,1122,53160,66975,8717,76648
8600000US76649,496,218,278,46458,83914,43650,76649
8600000US76650,106,57,49,53571,55050,12843,76650
8600000US76651,2504,1302,1202,53641,65733,6652,76651
8600000US76652,1056,538,518,46676,55980,7622,76652
8600000US76653,1010,591,419,54375,62883,10425,76653
8600000US76654,118,53,65,40250,54002,17445,76654
8600000US76655,6521,3239,3282,95795,98516,6588,76655
8600000US76656,1785,846,939,54792,67946,9862,76656
8600000US76657,7267,3641,3626,63457,101291,13056,76657
8600000US76660,422,197,225,50375,66653,15257,76660
8600000US76661,6509,2696,3813,27102,34859,3883,76661
8600000US76664,2588,1296,1292,46000,62686,5742,76664
8600000US76665,1915,960,955,48750,64873,8992,76665
8600000US76666,222,119,103,43750,61070,13138,76666
8600000US76667,8467,4322,4145,41968,56667,4896,76667
8600000US76670,1213,660,553,48578,65327,8551,76670
8600000US76671,1342,664,678,47674,63791,9253,76671
8600000US76673,1049,545,504,46042,60612,10498,76673
8600000US76676,218,94,124,59375,66732,9363,76676
8600000US76678,156,86,70,38393,55085,22508,76678
8600000US76679,1013,437,576,61071,73854,15513,76679
8600000US76680,230,120,110,,89783,38608,76680
8600000US76681,477,267,210,51500,62634,16150,76681
8600000US76682,2155,1073,1082,51916,61322,4687,76682
8600000US76685,20,20,0,,,,76685
8600000US76686,158,74,84,42500,54261,9812,76686
8600000US76687,1589,811,778,40846,56063,11039,76687
8600000US76689,2494,1197,1297,56028,64970,6100,76689
8600000US76690,771,409,362,32880,52101,8532,76690
8600000US76691,5036,2372,2664,62893,73832,5175,76691
8600000US76692,8414,4249,4165,44167,68707,8248,76692
8600000US76693,1213,588,625,40278,61273,10016,76693
8600000US76701,1722,909,813,31689,56749,12752,76701
8600000US76704,5434,2348,3086,20699,28907,4089,76704
8600000US76705,23455,11828,11627,42679,55320,3096,76705
8600000US76706,29857,14265,15592,31606,48953,4867,76706
8600000US76707,10654,5157,5497,27132,42107,3753,76707
8600000US76708,19596,9204,10392,49578,63600,3044,76708
8600000US76710,19461,9213,10248,46477,66776,5738,76710
8600000US76711,7209,3576,3633,40961,52109,4973,76711
8600000US76712,19169,8778,10391,69897,89904,5680,76712
8600000US76798,1559,424,1135,,,,76798
8600000US76801,19442,9671,9771,43773,64894,5050,76801
8600000US76802,3867,1917,1950,53984,70679,7255,76802
8600000US76820,136,60,76,95114,135673,72166,76820
8600000US76821,3640,1762,1878,42336,55591,5995,76821
8600000US76823,2297,1018,1279,48361,58710,5761,76823
8600000US76824,11,0,11,,,,76824
8600000US76825,5168,2541,2627,45402,56438,5746,76825
8600000US76827,306,154,152,41528,64048,13722,76827
8600000US76828,168,94,74,75156,72541,16058,76828
8600000US76831,36,19,17,,,,76831
8600000US76832,518,278,240,50156,89247,41127,76832
8600000US76834,4090,2035,2055,43624,59502,7810,76834
8600000US76836,16,12,4,,,,76836
8600000US76837,2878,2048,830,37125,52452,7359,76837
8600000US76841,25,7,18,,,,76841
8600000US76842,162,79,83,59063,59850,10628,76842
8600000US76844,2893,1280,1613,44250,62162,13808,76844
8600000US76845,206,112,94,64643,96086,44107,76845
8600000US76848,64,29,35,31042,29535,8234,76848
8600000US76849,3057,1445,1612,42390,62942,12074,76849
8600000US76852,183,92,91,54028,61270,12092,76852
8600000US76853,1073,530,543,54875,61921,8094,76853
8600000US76854,219,59,160,26438,37335,16923,76854
8600000US76856,2877,1479,1398,39111,56281,8712,76856
8600000US76857,1334,673,661,36919,54097,12374,76857
8600000US76858,189,88,101,28813,32017,6477,76858
8600000US76859,1674,896,778,41131,51476,8064,76859
8600000US76861,1377,747,630,58333,73764,7509,76861
8600000US76862,158,92,66,58250,64997,15990,76862
8600000US76864,626,365,261,37188,62335,14366,76864
8600000US76865,144,59,85,,64615,54582,76865
8600000US76866,618,281,337,50368,90117,40501,76866
8600000US76869,92,53,39,60000,57197,19557,76869
8600000US76870,149,70,79,42500,51889,9095,76870
8600000US76871,603,294,309,47232,77179,19783,76871
8600000US76872,700,367,333,58750,86164,17994,76872
8600000US76873,36,10,26,29167,37855,19984,76873
8600000US76874,0,0,0,,,,76874
8600000US76875,419,208,211,42019,65747,14467,76875
8600000US76877,3430,1784,1646,43399,56541,7893,76877
8600000US76878,1461,757,704,44313,82961,28603,76878
8600000US76882,209,119,90,33889,43438,10703,76882
8600000US76884,110,47,63,48333,61735,22306,76884
8600000US76885,216,66,150,91806,82610,37091,76885
8600000US76887,110,56,54,52679,40390,22615,76887
8600000US76888,105,62,43,44167,46274,13287,76888
8600000US76890,858,388,470,60956,76703,13951,76890
8600000US76901,23046,11111,11935,55480,73513,5658,76901
8600000US76903,24351,12053,12298,35854,51477,4882,76903
8600000US76904,27694,13610,14084,63362,86891,4805,76904
8600000US76905,8712,4142,4570,58505,77579,12505,76905
8600000US76908,2528,1909,619,,,,76908
8600000US76930,91,39,52,75714,63838,18065,76930
8600000US76932,2636,1357,1279,70441,75344,6606,76932
8600000US76933,967,455,512,45988,55551,6004,76933
8600000US76934,882,416,466,57917,66326,13869,76934
8600000US76935,1486,620,866,72240,86214,10324,76935
8600000US76936,2219,1110,1109,55677,61014,6459,76936
8600000US76937,30,16,14,,,,76937
8600000US76939,10,5,5,,,,76939
8600000US76940,113,84,29,,,,76940
8600000US76941,1009,558,451,47000,71190,12001,76941
8600000US76943,2582,1272,1310,50904,62375,9054,76943
8600000US76945,1351,644,707,45508,51200,4295,76945
8600000US76949,6,1,5,,,,76949
8600000US76950,2929,1531,1398,60272,70918,7839,76950
8600000US76951,814,409,405,59286,66108,8329,76951
8600000US76953,100,52,48,,71401,35098,76953
8600000US76955,129,61,68,191125,153132,52721,76955
8600000US76957,0,0,0,,,,76957
8600000US76958,126,56,70,51131,81801,41732,76958
8600000US77002,13392,11394,1998,67043,87186,8950,77002
8600000US77003,8026,4150,3876,64006,80252,5909,77003
8600000US77004,32355,16461,15894,50485,85551,10535,77004
8600000US77005,21519,10649,10870,189500,287083,15634,77005
8600000US77006,20653,11156,9497,85000,124328,7535,77006
8600000US77007,33507,17632,15875,124355,161830,9006,77007
8600000US77008,29093,14591,14502,104167,140968,7373,77008
8600000US77009,28004,14486,13518,53116,91468,6176,77009
8600000US77010,839,471,368,240417,310753,67847,77010
8600000US77011,13003,7038,5965,30682,42496,3560,77011
8600000US77012,13964,7615,6349,36532,45021,2666,77012
8600000US77013,14809,8006,6803,39766,48858,3237,77013
8600000US77014,25462,12049,13413,48790,62151,3508,77014
8600000US77015,38389,19328,19061,46300,58896,2665,77015
8600000US77016,22550,10840,11710,34885,46195,2835,77016
8600000US77017,24293,12338,11955,48345,58497,3109,77017
8600000US77018,21401,10747,10654,87827,125000,6073,77018
8600000US77019,18534,9068,9466,117367,195644,15053,77019
8600000US77020,18567,9316,9251,30187,43294,2662,77020
8600000US77021,20794,9509,11285,37318,53610,2757,77021
8600000US77022,20505,10572,9933,30900,42243,2313,77022
8600000US77023,21485,11069,10416,40261,55686,4440,77023
8600000US77024,28767,13894,14873,116920,226602,11264,77024
8600000US77025,23233,11283,11950,74792,137536,9138,77025
8600000US77026,17372,8467,8905,29393,39455,2569,77026
8600000US77027,14892,6961,7931,95835,162857,15010,77027
8600000US77028,12321,5826,6495,30108,40994,3745,77028
8600000US77029,13055,6202,6853,34967,47435,4565,77029
8600000US77030,8792,4291,4501,86034,148112,16284,77030
8600000US77031,13149,6623,6526,50155,63375,4245,77031
8600000US77032,8501,3509,4992,30855,42019,5634,77032
8600000US77033,21390,9749,11641,36438,46606,3285,77033
8600000US77034,27767,13299,14468,48764,59971,3105,77034
8600000US77035,27874,13501,14373,43503,70908,3646,77035
8600000US77036,54933,29428,25505,30632,43522,1854,77036
8600000US77037,14353,7356,6997,42906,49300,3918,77037
8600000US77038,20701,10276,10425,41523,53728,2759,77038
8600000US77039,19139,9619,9520,36347,47087,2877,77039
8600000US77040,36951,18272,18679,56974,79774,5040,77040
8600000US77041,26349,13386,12963,82986,112966,6500,77041
8600000US77042,32441,15547,16894,48269,74760,4390,77042
8600000US77043,19622,9607,10015,64298,87204,5021,77043
8600000US77044,30921,14872,16049,78483,102562,5798,77044
8600000US77045,26571,12352,14219,56826,59818,3326,77045
8600000US77046,961,326,635,81803,116382,31115,77046
8600000US77047,21517,10094,11423,64648,74471,5328,77047
8600000US77048,12365,5698,6667,42691,55975,5336,77048
8600000US77049,24136,11703,12433,58774,72979,4442,77049
8600000US77050,3581,1653,1928,56275,66129,7051,77050
8600000US77051,12786,5581,7205,27496,40920,3902,77051
8600000US77053,21703,10645,11058,50465,59760,4084,77053
8600000US77054,20407,10230,10177,50665,58674,3588,77054
8600000US77055,32357,17209,15148,53263,105982,6293,77055
8600000US77056,18877,9480,9397,109515,185499,14574,77056
8600000US77057,32986,16559,16427,59104,106077,6085,77057
8600000US77058,14002,7123,6879,57027,79362,7120,77058
8600000US77059,12863,6421,6442,134688,167747,12049,77059
8600000US77060,28940,14937,14003,30342,39641,2149,77060
8600000US77061,18227,8837,9390,38500,53103,3070,77061
8600000US77062,19753,9527,10226,92166,112796,6225,77062
8600000US77063,30890,15738,15152,45262,67446,3595,77063
8600000US77064,37282,18312,18970,70324,86212,4597,77064
8600000US77065,28779,13770,15009,56362,75851,3626,77065
8600000US77066,27088,13811,13277,60106,74756,3875,77066
8600000US77067,23577,11425,12152,41859,54539,2743,77067
8600000US77068,8921,4669,4252,81728,103284,8917,77068
8600000US77069,14257,6379,7878,67431,107984,16427,77069
8600000US77070,39761,18654,21107,66983,92090,6300,77070
8600000US77071,20814,9272,11542,46801,66922,4501,77071
8600000US77072,44577,22218,22359,41557,52134,2289,77072
8600000US77073,28527,13582,14945,52095,62242,3382,77073
8600000US77074,29530,15367,14163,40214,51445,2560,77074
8600000US77075,31059,15564,15495,53633,64593,3950,77075
8600000US77076,23471,11436,12035,37072,42971,1907,77076
8600000US77077,45523,21597,23926,65922,102975,5687,77077
8600000US77078,10527,4752,5775,37356,49315,5510,77078
8600000US77079,23501,11172,12329,100107,156245,9154,77079
8600000US77080,32900,16750,16150,44814,64779,3873,77080
8600000US77081,35381,19276,16105,31196,46376,2538,77081
8600000US77082,43104,19869,23235,53313,72838,4013,77082
8600000US77083,59344,28144,31200,54650,69923,3101,77083
8600000US77084,77628,38193,39435,65742,82428,3615,77084
8600000US77085,13240,6491,6749,56288,66390,3449,77085
8600000US77086,19830,9434,10396,47303,57791,3881,77086
8600000US77087,26158,13734,12424,37222,48018,2599,77087
8600000US77088,40202,19154,21048,44422,56029,2391,77088
8600000US77089,40403,19530,20873,68204,80668,3652,77089
8600000US77090,27727,11978,15749,39879,53686,3809,77090
8600000US77091,19485,9516,9969,35940,46925,2612,77091
8600000US77092,28710,15348,13362,40521,57354,4909,77092
8600000US77093,31722,15699,16023,31261,41758,2021,77093
8600000US77094,7080,3320,3760,175840,207154,20755,77094
8600000US77095,53200,25800,27400,94290,112084,5020,77095
8600000US77096,25742,12044,13698,64022,105171,5746,77096
8600000US77098,12215,5829,6386,87200,134770,14010,77098
8600000US77099,38170,18647,19523,39783,51150,4075,77099
8600000US77201,0,0,0,,,,77201
8600000US77301,24929,12887,12042,43178,59267,3479,77301
8600000US77302,13329,6754,6575,68864,90152,8067,77302
8600000US77303,14479,7631,6848,52171,65458,4752,77303
8600000US77304,23598,11477,12121,63489,100597,12410,77304
8600000US77306,9075,4355,4720,46071,62616,7729,77306
8600000US77316,17114,8449,8665,96455,123845,10341,77316
8600000US77318,12013,5650,6363,61777,80102,7140,77318
8600000US77320,30418,21290,9128,51078,65710,4808,77320
8600000US77326,46,30,16,,,,77326
8600000US77327,15791,7851,7940,41504,57127,5215,77327
8600000US77328,11374,5671,5703,58518,67617,5977,77328
8600000US77331,6316,3155,3161,49331,66782,7947,77331
8600000US77334,258,155,103,39364,,,77334
8600000US77335,2328,1121,1207,55183,69786,14994,77335
8600000US77336,9047,4353,4694,69512,93066,9794,77336
8600000US77338,29667,14615,15052,54489,63230,3478,77338
8600000US77339,30693,14646,16047,73710,98463,5909,77339
8600000US77340,26929,13172,13757,33643,46324,3241,77340
8600000US77342,0,0,0,,,,77342
8600000US77345,20769,10041,10728,132955,156032,8017,77345
8600000US77346,45475,21918,23557,103478,123479,7697,77346
8600000US77350,135,57,78,,50689,30024,77350
8600000US77351,27109,15135,11974,46897,64712,4003,77351
8600000US77354,26685,12587,14098,83951,121156,11878,77354
8600000US77355,21597,10882,10715,83668,110057,8818,77355
8600000US77356,21750,10546,11204,81498,116762,12793,77356
8600000US77357,18024,8979,9045,52962,83466,12038,77357
8600000US77358,3858,1887,1971,55625,70757,7862,77358
8600000US77359,475,333,142,83341,68382,21646,77359
8600000US77360,4011,1999,2012,43897,54892,7378,77360
8600000US77362,3955,1896,2059,74240,90086,18175,77362
8600000US77363,2378,1047,1331,41571,66481,13816,77363
8600000US77364,1379,712,667,33654,46643,9078,77364
8600000US77365,25850,12547,13303,73873,101886,12971,77365
8600000US77367,101,50,51,,44706,22005,77367
8600000US77368,166,74,92,38250,43869,15963,77368
8600000US77369,514,248,266,45357,46892,18926,77369
8600000US77371,6040,2807,3233,40459,50075,7717,77371
8600000US77372,9453,4566,4887,60324,66871,6296,77372
8600000US77373,42997,20352,22645,69046,79913,3338,77373
8600000US77374,274,104,170,19353,33729,16600,77374
8600000US77375,37157,17947,19210,72049,99091,5157,77375
8600000US77376,499,270,229,39044,43010,11549,77376
8600000US77377,26271,13151,13120,99276,119131,6244,77377
8600000US77378,11342,5355,5987,58249,68605,8373,77378
8600000US77379,58543,28463,30080,102008,134286,5856,77379
8600000US77380,21185,10661,10524,70444,122622,11272,77380
8600000US77381,28303,13502,14801,110774,157702,8865,77381
8600000US77382,26564,12721,13843,134383,187795,21829,77382
8600000US77384,14016,6459,7557,82708,111560,10050,77384
8600000US77385,18307,9288,9019,94226,111516,8679,77385
8600000US77386,37339,18522,18817,108029,126856,7159,77386
8600000US77388,36815,17611,19204,90483,111557,6314,77388
8600000US77389,23849,11794,12055,125781,152276,8114,77389
8600000US77396,41865,21266,20599,66455,88828,5937,77396
8600000US77401,14226,6848,7378,185795,267857,18828,77401
8600000US77406,34698,18145,16553,116758,130278,7089,77406
8600000US77407,35668,16997,18671,97747,104785,6095,77407
8600000US77412,49,26,23,,,,77412
8600000US77414,17615,8761,8854,48469,67730,4864,77414
8600000US77415,47,31,16,,,,77415
8600000US77417,2152,1062,1090,45988,61298,12155,77417
8600000US77418,8286,4106,4180,61420,80853,6846,77418
8600000US77419,889,434,455,55982,63903,19939,77419
8600000US77420,1707,742,965,50000,59693,10463,77420
8600000US77422,10870,5874,4996,52583,71725,5941,77422
8600000US77423,8631,4309,4322,62083,81621,8018,77423
8600000US77426,1553,713,840,69345,88201,23950,77426
8600000US77428,0,0,0,,,,77428
8600000US77429,60998,29037,31961,107072,134135,7217,77429
8600000US77430,1592,805,787,79000,99633,15347,77430
8600000US77432,77,43,34,,,,77432
8600000US77433,53982,26220,27762,109084,128188,4240,77433
8600000US77434,3499,1560,1939,38673,62798,14640,77434
8600000US77435,3013,1484,1529,65339,84240,14602,77435
8600000US77436,31,13,18,,,,77436
8600000US77437,12037,5820,6217,51465,81175,11276,77437
8600000US77440,23,23,0,,,,77440
8600000US77441,8209,4021,4188,166524,195276,20201,77441
8600000US77442,677,401,276,56406,69160,21585,77442
8600000US77443,112,53,59,,,,77443
8600000US77444,487,259,228,52292,60351,17888,77444
8600000US77445,9666,5072,4594,45028,61543,7531,77445
8600000US77446,5796,2405,3391,25688,29621,6581,77446
8600000US77447,11099,5226,5873,72656,92917,7335,77447
8600000US77448,144,114,30,,55087,51088,77448
8600000US77449,85256,39840,45416,76163,85982,3083,77449
8600000US77450,53570,25747,27823,97681,127947,3631,77450
8600000US77451,48,19,29,25179,22420,7055,77451
8600000US77453,157,97,60,25776,31269,14960,77453
8600000US77454,15,15,0,,,,77454
8600000US77455,1738,873,865,57692,72956,10502,77455
8600000US77456,1206,657,549,43241,55891,16622,77456
8600000US77457,337,171,166,32625,43048,11961,77457
8600000US77458,87,36,51,,38379,872834,77458
8600000US77459,51166,24308,26858,107692,145623,9203,77459
8600000US77460,40,21,19,,,,77460
8600000US77461,8400,4237,4163,70758,85863,7917,77461
8600000US77464,135,67,68,58571,118725,58020,77464
8600000US77465,5299,2500,2799,41976,53448,7618,77465
8600000US77466,363,242,121,63393,67948,10325,77466
8600000US77467,13,0,13,,,,77467
8600000US77468,42,22,20,,,,77468
8600000US77469,36658,18161,18497,75793,100306,6003,77469
8600000US77470,387,205,182,43274,39340,15017,77470
8600000US77471,28327,13893,14434,51841,65779,4501,77471
8600000US77473,54,19,35,20417,34065,24100,77473
8600000US77474,9314,4477,4837,70479,80213,6583,77474
8600000US77475,753,342,411,68309,81544,22506,77475
8600000US77476,136,86,50,37917,58534,33667,77476
8600000US77477,28780,13972,14808,60765,71558,3330,77477
8600000US77478,20839,10112,10727,92287,143241,14255,77478
8600000US77479,66666,32149,34517,139312,170045,5245,77479
8600000US77480,6047,2989,3058,61909,79699,8852,77480
8600000US77481,14,6,8,,,,77481
8600000US77482,1601,863,738,37750,50786,14149,77482
8600000US77483,147,68,79,,21256,13125,77483
8600000US77484,8033,4179,3854,66600,84449,11074,77484
8600000US77485,3252,1689,1563,53266,67746,6709,77485
8600000US77486,5607,2778,2829,71662,79941,9240,77486
8600000US77488,11266,5573,5693,43327,58227,4947,77488
8600000US77489,27409,12027,15382,66450,78063,3415,77489
8600000US77493,23097,11356,11741,86614,101430,4372,77493
8600000US77494,76575,36807,39768,139669,163631,7447,77494
8600000US77498,37844,18397,19447,79658,106123,6341,77498
8600000US77502,26315,12912,13403,50035,62752,4192,77502
8600000US77503,17645,8499,9146,50445,57885,3052,77503
8600000US77504,16944,7987,8957,42973,61748,4787,77504
8600000US77505,18237,9056,9181,78487,95393,5583,77505
8600000US77506,25444,13460,11984,38311,49326,2179,77506
8600000US77507,0,0,0,,,,77507
8600000US77510,11425,5520,5905,75383,88264,8690,77510
8600000US77511,34569,17187,17382,61446,76300,3838,77511
8600000US77514,3968,1960,2008,42500,59403,6766,77514
8600000US77515,24910,13366,11544,61794,77226,4424,77515
8600000US77517,4140,2036,2104,64238,82717,11544,77517
8600000US77518,7458,3556,3902,39820,67552,7845,77518
8600000US77519,865,328,537,63493,72321,16142,77519
8600000US77520,25660,12675,12985,47817,61984,2917,77520
8600000US77521,42355,21371,20984,68318,83216,4411,77521
8600000US77523,15145,7504,7641,102019,118884,8800,77523
8600000US77530,22594,11213,11381,57716,69874,5837,77530
8600000US77531,11644,5832,5812,61903,73681,4929,77531
8600000US77532,21944,11017,10927,65805,86715,5068,77532
8600000US77533,536,250,286,39688,71806,23312,77533
8600000US77534,1756,858,898,92063,93292,10095,77534
8600000US77535,26927,12466,14461,52825,70267,4687,77535
8600000US77536,24563,11875,12688,81177,98034,6686,77536
8600000US77538,831,462,369,57500,74275,14832,77538
8600000US77539,33437,17080,16357,74972,90773,5222,77539
8600000US77541,13078,6516,6562,47313,64262,5865,77541
8600000US77545,17306,8238,9068,79869,83362,4678,77545
8600000US77546,38867,18759,20108,100217,133383,5729,77546
8600000US77547,6989,3526,3463,42872,56662,5929,77547
8600000US77550,18128,8971,9157,38048,58189,3050,77550
8600000US77551,17685,9228,8457,48394,70261,4304,77551
8600000US77554,7908,4022,3886,73242,106901,9402,77554
8600000US77560,444,242,202,102583,150855,71107,77560
8600000US77561,71,34,37,,65928,22059,77561
8600000US77562,7820,3584,4236,60130,71179,6735,77562
8600000US77563,7829,3685,4144,60858,77774,5208,77563
8600000US77564,1213,629,584,60511,66894,13593,77564
8600000US77565,6325,3040,3285,63322,98712,10567,77565
8600000US77566,22060,10858,11202,83927,108637,5659,77566
8600000US77568,11949,5526,6423,45355,63298,5797,77568
8600000US77571,28593,14251,14342,73742,87229,3871,77571
8600000US77573,62084,30239,31845,106067,123763,5793,77573
8600000US77575,12089,6254,5835,57710,75932,9750,77575
8600000US77577,1193,588,605,66923,85667,18875,77577
8600000US77578,14046,6553,7493,100347,122078,12251,77578
8600000US77580,382,213,169,,125866,47010,77580
8600000US77581,36120,17177,18943,94494,108431,4427,77581
8600000US77583,27288,16240,11048,70658,81925,6317,77583
8600000US77584,63250,30367,32883,106415,128926,6526,77584
8600000US77585,807,337,470,40972,40470,9906,77585
8600000US77586,17594,8778,8816,93760,122925,7295,77586
8600000US77587,11363,5895,5468,45643,56131,3887,77587
8600000US77590,23122,10895,12227,44915,63759,4014,77590
8600000US77591,10940,4697,6243,47078,77737,10642,77591
8600000US77597,590,272,318,51083,64520,21243,77597
8600000US77598,20536,10747,9789,54181,63949,3536,77598
8600000US77611,6568,3343,3225,72574,81839,6462,77611
8600000US77612,7258,3685,3573,56970,63879,5371,77612
8600000US77613,837,422,415,51712,64737,12957,77613
8600000US77614,254,143,111,,50728,31408,77614
8600000US77615,646,370,276,65288,74642,12001,77615
8600000US77616,531,295,236,40750,60884,20424,77616
8600000US77617,34,27,7,,46184,32968,77617
8600000US77619,12008,5910,6098,54288,70219,4055,77619
8600000US77622,949,478,471,74018,80418,11377,77622
8600000US77623,361,167,194,63611,84556,22283,77623
8600000US77624,527,321,206,,65292,26500,77624
8600000US77625,7701,3900,3801,60865,85623,17250,77625
8600000US77627,16499,8029,8470,74129,90721,6922,77627
8600000US77629,521,235,286,49276,60447,11728,77629
8600000US77630,21581,10283,11298,48352,69863,5611,77630
8600000US77632,17689,8563,9126,64531,81036,5398,77632
8600000US77640,12016,5897,6119,35236,46654,2795,77640
8600000US77642,27944,13197,14747,34736,50459,2952,77642
8600000US77650,1612,657,955,41442,58117,12919,77650
8600000US77651,9891,4970,4921,65625,89160,8848,77651
8600000US77655,295,150,145,45000,116177,75569,77655
8600000US77656,12354,5919,6435,50768,63040,4870,77656
8600000US77657,15705,7717,7988,72367,84126,5116,77657
8600000US77659,3420,1582,1838,64583,114092,23124,77659
8600000US77660,927,560,367,72625,73050,16506,77660
8600000US77661,543,221,322,,67663,51723,77661
8600000US77662,19835,9788,10047,50765,68289,4132,77662
8600000US77663,1128,590,538,,49266,15555,77663
8600000US77664,2087,1014,1073,56833,64973,11608,77664
8600000US77665,4827,2417,2410,47234,71824,12393,77665
8600000US77701,9949,4691,5258,31080,43733,3563,77701
8600000US77702,2058,1069,989,43936,60737,13612,77702
8600000US77703,9738,4584,5154,27169,40822,4381,77703
8600000US77705,33673,22039,11634,39414,55606,3036,77705
8600000US77706,23264,11310,11954,64636,100127,7764,77706
8600000US77707,13486,6079,7407,50929,66517,5072,77707
8600000US77708,9380,4506,4874,48438,70260,5611,77708
8600000US77713,10830,5581,5249,62509,80738,6050,77713
8600000US77801,11868,6209,5659,31315,39060,3421,77801
8600000US77802,20651,9372,11279,56669,76161,5237,77802
8600000US77803,22738,11131,11607,40907,51766,3596,77803
8600000US77807,8294,5010,3284,62664,85239,12297,77807
8600000US77808,9004,4540,4464,64961,87841,8959,77808
8600000US77830,2118,1119,999,74688,108327,42940,77830
8600000US77831,2442,1275,1167,50183,79384,27675,77831
8600000US77833,22855,10772,12083,56799,76741,5722,77833
8600000US77835,1966,1004,962,49821,61473,10313,77835
8600000US77836,9026,4498,4528,58608,73034,5749,77836
8600000US77837,1395,662,733,34970,50573,7087,77837
8600000US77840,53779,28567,25212,25359,41810,2965,77840
8600000US77845,47837,23290,24547,78706,103366,3606,77845
8600000US77853,998,475,523,50313,68036,11221,77853
8600000US77855,72,30,42,,,,77855
8600000US77856,4075,2011,2064,48694,73194,9465,77856
8600000US77857,560,259,301,58750,86532,15438,77857
8600000US77859,5007,2374,2633,62031,69188,10282,77859
8600000US77861,1943,893,1050,58558,86384,11883,77861
8600000US77864,5152,2023,3129,49467,63098,5652,77864
8600000US77865,1792,798,994,69000,125769,51737,77865
8600000US77867,101,50,51,45714,52919,14062,77867
8600000US77868,13243,7937,5306,50462,63775,4752,77868
8600000US77871,2408,1197,1211,49866,72851,13145,77871
8600000US77872,1319,617,702,52019,71383,11280,77872
8600000US77873,962,464,498,41708,64597,12318,77873
8600000US77876,58,22,36,,,,77876
8600000US77878,266,197,69,31891,51398,20833,77878
8600000US77879,4498,2044,2454,55239,73346,13652,77879
8600000US77880,950,563,387,55735,137817,111145,77880
8600000US77901,31852,15045,16807,42996,58323,3792,77901
8600000US77904,21003,10198,10805,77123,100688,7362,77904
8600000US77905,11032,5638,5394,72237,86097,6596,77905
8600000US77950,144,78,66,49375,59288,15312,77950
8600000US77951,1513,696,817,31145,37083,6831,77951
8600000US77954,9394,5202,4192,55606,78033,8863,77954
8600000US77957,6494,3195,3299,54438,68578,6448,77957
8600000US77960,56,56,0,,,,77960
8600000US77961,234,127,107,97712,96466,30589,77961
8600000US77962,2656,1328,1328,59812,75990,9905,77962
8600000US77963,4439,2101,2338,54223,70251,7671,77963
8600000US77964,6367,3044,3323,51769,74888,7640,77964
8600000US77968,2394,1112,1282,68814,89911,15574,77968
8600000US77969,127,52,75,,74529,43489,77969
8600000US77970,264,149,115,63750,65372,17112,77970
8600000US77971,738,407,331,81968,78934,17227,77971
8600000US77973,0,0,0,,,,77973
8600000US77974,267,131,136,105625,92202,14067,77974
8600000US77975,1336,598,738,62353,87662,23053,77975
8600000US77976,85,51,34,,94037,53485,77976
8600000US77977,499,242,257,32434,44839,12600,77977
8600000US77978,553,318,235,67250,74001,11774,77978
8600000US77979,13214,6683,6531,57500,72941,5812,77979
8600000US77982,737,404,333,53173,53604,12913,77982
8600000US77983,1727,830,897,42727,59735,8606,77983
8600000US77984,3133,1614,1519,60901,95942,14453,77984
8600000US77987,198,118,80,54773,74561,19432,77987
8600000US77988,305,174,131,47500,61062,28672,77988
8600000US77990,637,329,308,43292,53516,9438,77990
8600000US77991,153,62,91,70060,74041,17276,77991
8600000US77993,165,110,55,,65165,55401,77993
8600000US77994,352,148,204,39545,84384,41445,77994
8600000US77995,7618,3687,3931,50959,69526,5618,77995
8600000US78001,0,0,0,,,,78001
8600000US78002,5269,2793,2476,45509,59273,8648,78002
8600000US78003,8056,3667,4389,54932,68540,7570,78003
8600000US78004,862,440,422,96484,97550,22016,78004
8600000US78005,572,276,296,,51654,25983,78005
8600000US78006,25240,11884,13356,80339,122713,9077,78006
8600000US78007,119,58,61,68333,75500,18952,78007
8600000US78008,220,88,132,,112966,73484,78008
8600000US78009,6418,3240,3178,54824,75462,8250,78009
8600000US78010,2697,1199,1498,48804,68463,14921,78010
8600000US78011,1430,608,822,40833,51850,6958,78011
8600000US78012,252,122,130,61786,63594,13557,78012
8600000US78013,5062,2707,2355,71328,108119,26874,78013
8600000US78014,4300,2670,1630,50500,84525,30372,78014
8600000US78015,11344,5473,5871,122002,148676,10777,78015
8600000US78016,7531,3457,4074,52435,65376,6556,78016
8600000US78017,4113,2805,1308,48235,56687,8887,78017
8600000US78019,1225,720,505,52802,54392,11262,78019
8600000US78021,251,170,81,,87971,92204,78021
8600000US78022,3127,1522,1605,55862,68461,7746,78022
8600000US78023,22476,11000,11476,124860,141554,9003,78023
8600000US78024,1004,508,496,49593,83223,24031,78024
8600000US78025,3805,1760,2045,51393,62825,5746,78025
8600000US78026,4162,2100,2062,52484,66617,8203,78026
8600000US78027,336,110,226,,194741,81462,78027
8600000US78028,32551,15463,17088,52472,72983,6440,78028
8600000US78029,0,0,0,,,,78029
8600000US78039,1472,672,800,64688,92223,38244,78039
8600000US78040,28391,13409,14982,23446,33238,1555,78040
8600000US78041,33983,16453,17530,47655,68476,3668,78041
8600000US78043,30309,14804,15505,35474,50818,2978,78043
8600000US78044,370,224,146,41750,54006,20335,78044
8600000US78045,43815,20503,23312,68957,87688,5902,78045
8600000US78046,43008,20666,22342,35910,46504,2698,78046
8600000US78050,316,182,134,40644,38326,12090,78050
8600000US78052,5459,2673,2786,59519,72482,8118,78052
8600000US78055,1343,703,640,41068,55048,8972,78055
8600000US78056,1539,674,865,109653,131889,27151,78056
8600000US78057,534,344,190,33875,64248,28523,78057
8600000US78058,1014,640,374,86806,81817,18642,78058
8600000US78059,4646,2299,2347,69113,79557,10144,78059
8600000US78060,115,115,0,,,,78060
8600000US78061,9866,5849,4017,43153,66245,11966,78061
8600000US78063,7894,4081,3813,54103,74506,7382,78063
8600000US78064,11594,5528,6066,68136,90644,11417,78064
8600000US78065,7968,4235,3733,50562,63923,10354,78065
8600000US78066,423,233,190,63494,72545,30967,78066
8600000US78067,485,284,201,,213268,197152,78067
8600000US78069,4471,2246,2225,48702,58214,6539,78069
8600000US78070,12947,6749,6198,81712,108915,7948,78070
8600000US78071,3536,2360,1176,42885,64003,13256,78071
8600000US78072,362,226,136,70833,93129,31517,78072
8600000US78073,6172,3029,3143,46919,60774,5208,78073
8600000US78075,176,43,133,,107117,54570,78075
8600000US78076,8761,4107,4654,30259,44848,4999,78076
8600000US78101,5262,2657,2605,79000,87945,9478,78101
8600000US78102,22609,14781,7828,41072,57634,5325,78102
8600000US78104,62,42,20,65278,60111,16378,78104
8600000US78107,272,129,143,,86410,57502,78107
8600000US78108,26370,12680,13690,94670,104663,3836,78108
8600000US78109,27560,12921,14639,68613,76966,4037,78109
8600000US78112,5879,2907,2972,51910,60289,4711,78112
8600000US78113,2224,1170,1054,70000,114233,15171,78113
8600000US78114,17402,8664,8738,68044,83144,6095,78114
8600000US78116,222,111,111,,246415,175147,78116
8600000US78117,399,176,223,71719,114138,39661,78117
8600000US78118,3029,1570,1459,45655,75596,20569,78118
8600000US78119,6298,4435,1863,47838,68700,10782,78119
8600000US78121,9788,4744,5044,90196,108417,8437,78121
8600000US78122,348,178,170,51620,57502,13721,78122
8600000US78123,1924,919,1005,53656,74605,15435,78123
8600000US78124,5025,2481,2544,71250,81226,5481,78124
8600000US78125,75,35,40,57500,69918,21757,78125
8600000US78130,55743,27235,28508,62813,80679,3291,78130
8600000US78132,21702,10622,11080,101443,124462,6517,78132
8600000US78133,15025,7253,7772,62637,80847,6073,78133
8600000US78140,2751,1446,1305,54447,69455,9922,78140
8600000US78141,405,202,203,55278,70424,13168,78141
8600000US78142,119,45,74,117031,96673,32528,78142
8600000US78143,97,42,55,29427,33110,7725,78143
8600000US78144,43,31,12,25521,24102,4263,78144
8600000US78145,98,40,58,65313,75238,29231,78145
8600000US78146,390,206,184,44583,121044,106522,78146
8600000US78147,1573,787,786,70556,76981,9007,78147
8600000US78148,16347,7800,8547,63043,75753,3808,78148
8600000US78150,27,27,0,,,,78150
8600000US78151,1177,614,563,56607,70444,9898,78151
8600000US78152,1680,832,848,85375,98324,12219,78152
8600000US78154,29199,13988,15211,77985,94809,3667,78154
8600000US78155,37694,18075,19619,55679,72471,3547,78155
8600000US78159,809,412,397,62828,71929,17307,78159
8600000US78160,3575,1796,1779,58813,72847,7948,78160
8600000US78161,545,225,320,40230,67955,32331,78161
8600000US78162,304,186,118,34779,66614,24054,78162
8600000US78163,8232,3998,4234,121528,135492,13341,78163
8600000US78164,2659,1288,1371,44487,96130,17727,78164
8600000US78201,35653,17404,18249,35285,48966,2716,78201
8600000US78202,8205,3932,4273,25300,40057,4650,78202
8600000US78203,4634,2241,2393,30744,41129,4727,78203
8600000US78204,9764,4702,5062,38784,70286,10048,78204
8600000US78205,1163,691,472,31434,45217,9241,78205
8600000US78207,38869,20181,18688,25415,35245,1985,78207
8600000US78208,3611,1683,1928,28049,36513,4308,78208
8600000US78209,33275,15651,17624,72266,134521,10230,78209
8600000US78210,27537,13305,14232,36316,50146,3260,78210
8600000US78211,23865,11983,11882,36983,43631,2376,78211
8600000US78212,24433,12455,11978,45903,84605,6612,78212
8600000US78213,33784,16346,17438,44347,59010,3262,78213
8600000US78214,19263,9126,10137,35715,43771,2804,78214
8600000US78215,2760,1772,988,64836,90401,13439,78215
8600000US78216,32726,16026,16700,47944,67455,3251,78216
8600000US78217,25903,12837,13066,46028,58620,3129,78217
8600000US78218,26915,12667,14248,40921,54119,2966,78218
8600000US78219,12103,4982,7121,35847,46690,3426,78219
8600000US78220,11936,5450,6486,29524,42023,4618,78220
8600000US78221,28919,14611,14308,40029,51587,2524,78221
8600000US78222,17781,8470,9311,51544,62728,4614,78222
8600000US78223,39957,19686,20271,40434,50887,1944,78223
8600000US78224,14776,7569,7207,45145,56502,3988,78224
8600000US78225,10128,4876,5252,32405,42503,3779,78225
8600000US78226,5420,2433,2987,30228,39635,4447,78226
8600000US78227,34785,16904,17881,40294,51535,6031,78227
8600000US78228,46568,22220,24348,40779,52833,2409,78228
8600000US78229,25748,13505,12243,38332,50184,2702,78229
8600000US78230,35770,17047,18723,61030,87916,3659,78230
8600000US78231,6819,3189,3630,89683,117513,9248,78231
8600000US78232,30291,15018,15273,73043,96855,4527,78232
8600000US78233,36297,18182,18115,56155,67835,3478,78233
8600000US78234,3256,1644,1612,66767,76600,7027,78234
8600000US78235,973,542,431,44896,72931,27230,78235
8600000US78236,5945,4287,1658,76771,77037,10987,78236
8600000US78237,28579,14375,14204,30003,40269,2972,78237
8600000US78238,18589,8961,9628,48967,59761,4410,78238
8600000US78239,22233,10609,11624,60313,71443,3836,78239
8600000US78240,46275,22532,23743,54430,67635,2978,78240
8600000US78242,23317,11294,12023,42298,48342,2268,78242
8600000US78243,424,358,66,,,,78243
8600000US78244,23224,10848,12376,61457,74991,6515,78244
8600000US78245,52459,25059,27400,67013,75087,2889,78245
8600000US78247,39860,19076,20784,77811,88326,3090,78247
8600000US78248,11118,5048,6070,112072,145989,11238,78248
8600000US78249,49089,24252,24837,64657,79022,3615,78249
8600000US78250,45662,22270,23392,68658,80129,3167,78250
8600000US78251,44409,20573,23836,65233,78309,3144,78251
8600000US78252,8664,5576,3088,58474,64928,4527,78252
8600000US78253,30220,14196,16024,99500,109048,4501,78253
8600000US78254,40081,18907,21174,84447,92964,3002,78254
8600000US78255,10248,5156,5092,125550,149497,14570,78255
8600000US78256,9072,4448,4624,101368,135262,12666,78256
8600000US78257,4970,2499,2471,118190,188381,32328,78257
8600000US78258,33355,15936,17419,102425,130571,5516,78258
8600000US78259,19408,9554,9854,96233,114041,4868,78259
8600000US78260,19047,9299,9748,115069,135252,6838,78260
8600000US78261,11948,6356,5592,92442,117162,7728,78261
8600000US78263,4333,2088,2245,70985,82620,11900,78263
8600000US78264,7884,3978,3906,49571,60403,5927,78264
8600000US78266,4901,2414,2487,119529,143004,16535,78266
8600000US78330,633,279,354,43077,57200,11309,78330
8600000US78332,20927,9747,11180,40827,62116,7161,78332
8600000US78335,0,0,0,,,,78335
8600000US78336,8684,4386,4298,45574,63546,6676,78336
8600000US78338,27,9,18,53125,58419,23776,78338
8600000US78339,301,197,104,51776,56310,17389,78339
8600000US78340,369,218,151,52500,61255,9017,78340
8600000US78341,1603,792,811,32614,45771,8558,78341
8600000US78342,320,178,142,40446,50504,15443,78342
8600000US78343,3191,1616,1575,45417,63492,5798,78343
8600000US78344,272,120,152,57596,113326,78179,78344
8600000US78349,475,239,236,47578,49408,14747,78349
8600000US78351,247,97,150,30156,41450,10894,78351
8600000US78352,287,130,157,32216,36796,12768,78352
8600000US78353,265,139,126,31029,39376,12990,78353
8600000US78355,5261,2843,2418,27813,42628,5530,78355
8600000US78357,1963,894,1069,46518,53475,8492,78357
8600000US78358,493,228,265,32031,40147,10472,78358
8600000US78359,1516,790,726,49911,62130,7060,78359
8600000US78361,3727,1687,2040,32483,53276,6124,78361
8600000US78362,7557,4120,3437,62978,77135,8331,78362
8600000US78363,22518,11371,11147,41333,57607,4927,78363
8600000US78368,7261,3828,3433,42443,57852,4559,78368
8600000US78369,235,143,92,21932,37113,12590,78369
8600000US78370,3459,1683,1776,54903,67550,7150,78370
8600000US78371,219,123,96,63487,50964,16876,78371
8600000US78372,3687,1651,2036,39496,54225,7446,78372
8600000US78373,3588,1554,2034,54115,83503,15114,78373
8600000US78374,12749,6138,6611,70893,91656,6403,78374
8600000US78375,2450,1463,987,46920,54583,8825,78375
8600000US78376,521,313,208,44375,49638,12173,78376
8600000US78377,2787,1335,1452,51803,63421,8595,78377
8600000US78379,1182,624,558,55714,76110,12721,78379
8600000US78380,17536,8714,8822,47398,65132,5647,78380
8600000US78382,17515,8544,8971,46406,77277,8297,78382
8600000US78383,3370,1590,1780,62692,83789,13725,78383
8600000US78384,4168,2276,1892,26167,47526,8594,78384
8600000US78385,386,171,215,36458,40337,8908,78385
8600000US78387,6831,3166,3665,42500,59498,7175,78387
8600000US78389,1294,647,647,35000,55215,11563,78389
8600000US78390,4057,1995,2062,41915,63907,10902,78390
8600000US78391,164,56,108,49750,80262,40326,78391
8600000US78393,1720,796,924,45573,54781,7072,78393
8600000US78401,4663,2687,1976,27153,55253,15034,78401
8600000US78402,220,99,121,64338,62196,30664,78402
8600000US78404,14099,6612,7487,42101,64079,6879,78404
8600000US78405,11678,5960,5718,27566,40729,4995,78405
8600000US78406,1497,990,507,55396,59230,12085,78406
8600000US78407,2270,1151,1119,50433,59317,8939,78407
8600000US78408,8481,3916,4565,36250,46975,4195,78408
8600000US78409,1925,1028,897,55754,63116,5877,78409
8600000US78410,20112,9690,10422,71939,92355,10478,78410
8600000US78411,20596,9789,10807,59083,74683,5141,78411
8600000US78412,31101,15146,15955,47196,62950,3603,78412
8600000US78413,30938,14853,16085,73478,94712,4801,78413
8600000US78414,28629,13304,15325,84199,103516,4395,78414
8600000US78415,29980,14686,15294,44975,57415,2766,78415
8600000US78416,10996,5289,5707,39035,48146,3501,78416
8600000US78417,3252,1667,1585,47661,58106,5727,78417
8600000US78418,23773,12244,11529,66590,92790,7365,78418
8600000US78419,563,368,195,56563,71727,14029,78419
8600000US78501,46649,21869,24780,36618,55236,3100,78501
8600000US78503,14967,6931,8036,31915,58707,6723,78503
8600000US78504,39411,18845,20566,65211,84286,4265,78504
8600000US78516,22626,10852,11774,34701,47761,3003,78516
8600000US78520,43327,20446,22881,32355,48995,3279,78520
8600000US78521,62161,29061,33100,30099,41431,1716,78521
8600000US78526,32106,15482,16624,54587,64840,4084,78526
8600000US78535,539,332,207,48029,51860,17246,78535
8600000US78536,219,135,84,,48901,13723,78536
8600000US78537,30082,14782,15300,28803,41074,2921,78537
8600000US78538,7510,3563,3947,32731,41576,4643,78538
8600000US78539,24498,11623,12875,57784,76000,5536,78539
8600000US78541,29983,14285,15698,34985,50111,3108,78541
8600000US78542,48081,25775,22306,38609,54761,4219,78542
8600000US78543,6321,2839,3482,31424,43120,6464,78543
8600000US78545,371,223,148,,19483,9662,78545
8600000US78548,509,262,247,,45672,14354,78548
8600000US78549,527,231,296,15541,26140,9814,78549
8600000US78550,35349,16977,18372,36948,53276,2990,78550
8600000US78552,27278,12982,14296,48990,64067,4373,78552
8600000US78557,9659,4975,4684,35191,49884,6741,78557
8600000US78558,749,380,369,49375,74829,31668,78558
8600000US78559,9120,4402,4718,38179,56137,7249,78559
8600000US78560,3324,1550,1774,38500,49019,10047,78560
8600000US78561,510,263,247,36250,43748,10446,78561
8600000US78562,3134,1850,1284,31301,39299,6367,78562
8600000US78563,190,68,122,42833,66095,32979,78563
8600000US78564,90,47,43,,28493,13045,78564
8600000US78565,112,61,51,,,,78565
8600000US78566,12077,5747,6330,41132,62435,6591,78566
8600000US78567,376,127,249,30278,39847,12253,78567
8600000US78569,3146,1606,1540,41250,57636,8752,78569
8600000US78570,22274,10670,11604,33390,47877,4271,78570
8600000US78572,54871,25917,28954,41906,62003,4925,78572
8600000US78573,25144,11854,13290,34061,54237,5318,78573
8600000US78574,39447,18302,21145,34949,54404,4539,78574
8600000US78575,8256,4067,4189,58239,81364,8965,78575
8600000US78576,5959,2654,3305,20954,37126,8783,78576
8600000US78577,51110,23734,27376,39372,48824,2220,78577
8600000US78578,8839,4186,4653,33982,51791,4851,78578
8600000US78579,4152,1982,2170,44427,56169,10043,78579
8600000US78580,11162,6398,4764,28040,42511,4861,78580
8600000US78582,28110,14083,14027,31880,52610,5825,78582
8600000US78583,5418,2411,3007,35641,52574,8443,78583
8600000US78584,13100,5625,7475,23396,36618,3710,78584
8600000US78585,206,146,60,,22465,17893,78585
8600000US78586,38572,17998,20574,31506,47098,2794,78586
8600000US78588,159,86,73,39219,37756,16631,78588
8600000US78589,27953,13298,14655,36213,54143,5097,78589
8600000US78590,249,102,147,39583,49561,17160,78590
8600000US78591,239,99,140,51250,67435,26939,78591
8600000US78592,547,306,241,30391,38854,8489,78592
8600000US78593,4189,2070,2119,30909,42851,6986,78593
8600000US78594,1305,514,791,27629,37093,8005,78594
8600000US78595,3721,1676,2045,26795,36099,4654,78595
8600000US78596,44515,21289,23226,40039,56091,4512,78596
8600000US78597,2529,1356,1173,41894,96688,33189,78597
8600000US78598,88,32,56,,79387,59651,78598
8600000US78602,21672,11528,10144,63160,79728,6503,78602
8600000US78605,4734,2498,2236,62650,75316,8802,78605
8600000US78606,4351,2041,2310,51676,87476,12950,78606
8600000US78607,41,14,27,,26559,16728,78607
8600000US78608,392,167,225,110536,91039,23345,78608
8600000US78609,1785,899,886,47708,64724,9480,78609
8600000US78610,25679,12558,13121,79318,95095,5669,78610
8600000US78611,10639,5238,5401,57390,77596,9659,78611
8600000US78612,9235,4671,4564,70795,83115,7926,78612
8600000US78613,56444,27229,29215,101832,116495,3727,78613
8600000US78614,470,235,235,59485,83790,22431,78614
8600000US78615,886,459,427,47500,81844,20190,78615
8600000US78616,5680,3201,2479,53220,70732,10694,78616
8600000US78617,19797,11001,8796,54940,73313,5959,78617
8600000US78618,295,140,155,60625,83411,20406,78618
8600000US78619,3220,1587,1633,131613,154655,16567,78619
8600000US78620,12366,6177,6189,101236,138266,13333,78620
8600000US78621,16821,8197,8624,62862,74419,5212,78621
8600000US78622,167,63,104,39844,63523,28206,78622
8600000US78623,773,315,458,82375,91825,29840,78623
8600000US78624,17517,8471,9046,60020,81675,7753,78624
8600000US78626,25773,12172,13601,66823,83618,3856,78626
8600000US78628,25433,12162,13271,88564,117493,6406,78628
8600000US78629,8765,4279,4486,52115,75890,7776,78629
8600000US78631,2133,910,1223,51667,71453,14118,78631
8600000US78632,782,427,355,49919,71132,13454,78632
8600000US78633,22606,10391,12215,78207,99671,4997,78633
8600000US78634,21573,10007,11566,76468,88925,7976,78634
8600000US78635,355,208,147,100769,96338,37042,78635
8600000US78636,3159,1689,1470,64036,84018,11246,78636
8600000US78638,1675,816,859,54886,59400,9931,78638
8600000US78639,7083,3380,3703,47756,75570,14981,78639
8600000US78640,39547,19801,19746,72474,84422,4081,78640
8600000US78641,46090,22411,23679,94685,110929,5024,78641
8600000US78642,8530,4113,4417,97316,112924,10778,78642
8600000US78643,5133,2612,2521,55066,74739,6602,78643
8600000US78644,14065,6551,7514,57135,74035,5814,78644
8600000US78645,9096,4374,4722,76396,101860,10354,78645
8600000US78648,6153,2937,3216,47279,63729,9229,78648
8600000US78650,1231,574,657,63750,72434,8891,78650
8600000US78652,4656,2367,2289,82328,93375,12508,78652
8600000US78653,15232,7533,7699,69107,76903,5887,78653
8600000US78654,14276,6689,7587,56992,75683,6075,78654
8600000US78655,2524,1225,1299,63407,73750,9689,78655
8600000US78656,1608,878,730,41152,51432,11244,78656
8600000US78657,5117,2353,2764,69139,115634,20250,78657
8600000US78659,2307,1222,1085,66196,77706,16579,78659
8600000US78660,65044,30652,34392,83499,96741,4943,78660
8600000US78661,256,149,107,38750,61154,29363,78661
8600000US78662,1977,845,1132,79406,79638,15397,78662
8600000US78663,682,336,346,78194,95759,27241,78663
8600000US78664,45551,22725,22826,72467,89470,3751,78664
8600000US78665,34013,16447,17566,96049,109135,3365,78665
8600000US78666,66750,33263,33487,40652,55257,2802,78666
8600000US78669,9199,4389,4810,109963,137577,13245,78669
8600000US78670,111,56,55,65625,78418,24338,78670
8600000US78671,649,273,376,57500,66657,18704,78671
8600000US78672,1037,555,482,41449,57192,16392,78672
8600000US78675,324,197,127,56250,116335,86448,78675
8600000US78676,10618,5084,5534,71014,94798,9645,78676
8600000US78677,15,8,7,,,,78677
8600000US78681,40047,19525,20522,103681,122037,4480,78681
8600000US78701,9251,5634,3617,107190,165912,23580,78701
8600000US78702,19220,10003,9217,59705,82322,4693,78702
8600000US78703,16753,8652,8101,105207,183797,15196,78703
8600000US78704,41888,21673,20215,70511,103098,4695,78704
8600000US78705,33134,15969,17165,19188,45709,4801,78705
8600000US78712,851,395,456,,,,78712
8600000US78717,20920,10188,10732,110085,129804,7477,78717
8600000US78719,1420,737,683,58917,62849,9542,78719
8600000US78721,10096,4747,5349,44076,58157,5270,78721
8600000US78722,6115,2906,3209,71340,94110,8359,78722
8600000US78723,26509,13088,13421,54707,79408,4477,78723
8600000US78724,16173,8269,7904,45887,57392,4459,78724
8600000US78725,5791,3098,2693,65345,77365,8213,78725
8600000US78726,10561,5348,5213,77935,117660,11969,78726
8600000US78727,24280,12146,12134,78542,94423,3470,78727
8600000US78728,16793,8321,8472,55099,71811,4896,78728
8600000US78729,23792,12112,11680,76832,90839,6137,78729
8600000US78730,7085,3612,3473,112333,195493,24104,78730
8600000US78731,21916,10303,11613,94048,148749,9508,78731
8600000US78732,11783,5708,6075,156599,202610,24553,78732
8600000US78733,5955,2866,3089,154543,217296,22675,78733
8600000US78734,14469,6942,7527,115458,149013,9414,78734
8600000US78735,13419,6198,7221,97636,161828,13768,78735
8600000US78736,7151,3443,3708,109012,142135,17214,78736
8600000US78737,11392,5756,5636,132245,158431,10155,78737
8600000US78738,11396,5405,5991,130699,170683,11096,78738
8600000US78739,13681,6695,6986,150000,178703,11623,78739
8600000US78741,43090,24199,18891,41852,54860,2419,78741
8600000US78742,648,354,294,38958,51211,9437,78742
8600000US78744,34381,17400,16981,49633,58128,2230,78744
8600000US78745,52314,26383,25931,62265,77202,3050,78745
8600000US78746,21321,10377,10944,139951,220858,9144,78746
8600000US78747,15331,7813,7518,81184,86264,5050,78747
8600000US78748,39653,19562,20091,77700,89770,3337,78748
8600000US78749,29561,14216,15345,98953,114425,4882,78749
8600000US78750,23636,11288,12348,91585,128331,7782,78750
8600000US78751,14221,7493,6728,59926,90519,8529,78751
8600000US78752,16383,9389,6994,45644,62560,3971,78752
8600000US78753,43981,23304,20677,49065,64985,3709,78753
8600000US78754,17956,8341,9615,67224,87876,9988,78754
8600000US78756,7308,3634,3674,82705,110417,8190,78756
8600000US78757,19687,9598,10089,70489,100449,6777,78757
8600000US78758,37387,19817,17570,53547,67450,2904,78758
8600000US78759,34976,17532,17444,81066,109811,3573,78759
8600000US78801,16464,8035,8429,42266,53434,4181,78801
8600000US78802,195,79,116,,,,78802
8600000US78827,799,372,427,24257,40680,9282,78827
8600000US78828,81,30,51,55156,45147,12902,78828
8600000US78829,882,467,415,14077,26395,9683,78829
8600000US78830,734,364,370,23958,38592,10615,78830
8600000US78832,3020,1878,1142,31468,49372,8994,78832
8600000US78833,1332,517,815,30789,44925,11629,78833
8600000US78834,5760,2765,2995,29778,54436,9174,78834
8600000US78836,162,50,112,18462,25571,14219,78836
8600000US78837,189,104,85,,50904,21841,78837
8600000US78838,156,91,65,38897,62336,31406,78838
8600000US78839,6534,3299,3235,32810,41444,5105,78839
8600000US78840,34090,17244,16846,45732,62415,3938,78840
8600000US78843,577,423,154,,,,78843
8600000US78850,948,471,477,56964,83899,14716,78850
8600000US78851,33,28,5,85882,71727,27788,78851
8600000US78852,38820,19214,19606,38169,54113,3999,78852
8600000US78860,23,0,23,,,,78860
8600000US78861,10868,6652,4216,57060,77475,7493,78861
8600000US78870,635,322,313,34432,52635,11408,78870
8600000US78871,56,4,52,,,,78871
8600000US78872,1145,593,552,25208,37302,7326,78872
8600000US78873,1425,659,766,35714,46298,7967,78873
8600000US78877,522,237,285,16940,48886,24821,78877
8600000US78879,137,33,104,,54862,32785,78879
8600000US78880,1465,765,700,38333,66441,15847,78880
8600000US78881,1408,630,778,33421,41843,9851,78881
8600000US78883,253,91,162,51196,52360,14921,78883
8600000US78884,953,355,598,56466,71584,12797,78884
8600000US78885,80,47,33,78438,85497,29173,78885
8600000US78886,329,182,147,42039,86418,46200,78886
8600000US78931,194,87,107,98889,98211,34490,78931
8600000US78932,478,213,265,61583,83033,15875,78932
8600000US78933,1032,552,480,77607,96174,32161,78933
8600000US78934,4685,2281,2404,48549,66828,9945,78934
8600000US78935,1206,558,648,67143,91860,18251,78935
8600000US78938,283,141,142,51429,70887,19849,78938
8600000US78940,1902,948,954,52909,69799,8479,78940
8600000US78941,2579,1304,1275,55956,79414,14899,78941
8600000US78942,6476,3213,3263,56081,63938,7787,78942
8600000US78943,257,100,157,,80376,49641,78943
8600000US78944,494,263,231,66488,82022,17401,78944
8600000US78945,8073,4029,4044,58956,70627,7041,78945
8600000US78946,1190,776,414,47692,71110,21708,78946
8600000US78947,3588,1709,1879,55804,71837,8477,78947
8600000US78948,659,315,344,44471,91345,51283,78948
8600000US78949,464,237,227,64318,82109,25206,78949
8600000US78950,1514,812,702,50217,75812,19222,78950
8600000US78951,0,0,0,,,,78951
8600000US78953,700,387,313,73214,78529,17426,78953
8600000US78954,1006,474,532,55000,97273,18169,78954
8600000US78956,4195,1922,2273,51364,67406,7923,78956
8600000US78957,7571,3591,3980,54152,73650,10118,78957
8600000US78959,1476,810,666,42181,69004,17137,78959
8600000US78962,4133,2241,1892,61618,89981,11379,78962
8600000US78963,856,399,457,50735,69553,20998,78963
8600000US79001,177,86,91,73750,110642,42744,79001
8600000US79003,138,65,73,71667,74070,20150,79003
8600000US79005,1269,699,570,56786,69433,8214,79005
8600000US79007,10654,5486,5168,49307,65417,4079,79007
8600000US79009,1277,664,613,44196,57895,7521,79009
8600000US79010,400,200,200,,54573,32590,79010
8600000US79011,157,78,79,81250,108683,35578,79011
8600000US79012,908,471,437,116250,144879,44988,79012
8600000US79013,2410,1394,1016,37382,42561,5568,79013
8600000US79014,2749,1391,1358,63333,78688,9899,79014
8600000US79015,17060,8124,8936,68704,82761,5552,79015
8600000US79016,138,49,89,,,,79016
8600000US79018,255,98,157,48125,53792,8698,79018
8600000US79019,1394,667,727,68214,81410,7948,79019
8600000US79021,103,64,39,44375,45596,9192,79021
8600000US79022,8285,4804,3481,57547,79772,11473,79022
8600000US79024,318,155,163,63333,76441,16742,79024
8600000US79025,49,31,18,29091,30583,4819,79025
8600000US79027,3519,1782,1737,42203,60472,10541,79027
8600000US79029,11046,5547,5499,54513,67988,4616,79029
8600000US79031,1024,473,551,54306,69907,11689,79031
8600000US79032,49,25,24,,55677,21679,79032
8600000US79033,61,24,37,,56973,48263,79033
8600000US79034,401,208,193,60694,74523,11563,79034
8600000US79035,3596,1948,1648,55089,67978,6172,79035
8600000US79036,3833,1814,2019,54683,68106,8525,79036
8600000US79039,661,303,358,57727,74603,16628,79039
8600000US79040,1364,790,574,47450,63976,8739,79040
8600000US79041,2139,1116,1023,42878,58445,9638,79041
8600000US79042,768,409,359,40673,59564,14258,79042
8600000US79043,1005,487,518,42105,48876,7978,79043
8600000US79044,468,222,246,46017,49882,7588,79044
8600000US79045,13091,6446,6645,52146,63127,3086,79045
8600000US79046,472,195,277,51607,75898,15091,79046
8600000US79051,0,0,0,,,,79051
8600000US79052,951,499,452,44896,62539,12566,79052
8600000US79053,119,55,64,64063,66934,14060,79053
8600000US79054,489,237,252,35982,54098,10888,79054
8600000US79056,64,37,27,75000,105514,57287,79056
8600000US79057,1006,495,511,45313,63442,8731,79057
8600000US79058,0,0,0,,,,79058
8600000US79059,473,225,248,66731,78801,11113,79059
8600000US79061,280,126,154,70833,73666,11812,79061
8600000US79062,154,89,65,68125,98180,39461,79062
8600000US79063,453,233,220,54167,65468,9640,79063
8600000US79064,1774,868,906,41827,54438,7137,79064
8600000US79065,15616,8424,7192,48735,68131,5142,79065
8600000US79068,2624,1228,1396,73311,87587,10568,79068
8600000US79070,6844,3460,3384,49682,70732,7876,79070
8600000US79072,19624,10391,9233,47129,55178,2894,79072
8600000US79078,213,103,110,84219,93022,36624,79078
8600000US79079,1976,1011,965,39213,56156,7339,79079
8600000US79080,386,193,193,49231,61961,9187,79080
8600000US79081,2735,1278,1457,34604,52383,7164,79081
8600000US79082,164,73,91,48125,52259,15324,79082
8600000US79083,1439,716,723,41538,59549,8151,79083
8600000US79084,1695,901,794,56250,70889,6934,79084
8600000US79085,21,9,12,43500,39000,16453,79085
8600000US79086,1464,792,672,46083,66613,6770,79086
8600000US79087,475,250,225,58906,78244,12995,79087
8600000US79088,4201,2303,1898,37306,52796,7655,79088
8600000US79091,86,45,41,34904,47653,13388,79091
8600000US79092,815,409,406,61563,77844,13938,79092
8600000US79093,82,28,54,,49169,38170,79093
8600000US79094,51,34,17,58646,65582,23807,79094
8600000US79095,2042,988,1054,44000,60931,10806,79095
8600000US79096,1541,742,799,55417,73750,7422,79096
8600000US79097,637,293,344,74115,100219,19985,79097
8600000US79098,326,164,162,74875,116080,40773,79098
8600000US79101,1854,826,1028,26473,45918,9784,79101
8600000US79102,7317,3630,3687,44931,53960,4337,79102
8600000US79103,7706,3597,4109,45747,51722,2763,79103
8600000US79104,4921,2497,2424,41548,51847,9317,79104
8600000US79105,0,0,0,,,,79105
8600000US79106,20088,9678,10410,42149,58975,2872,79106
8600000US79107,23215,11360,11855,36247,46754,2776,79107
8600000US79108,13555,9407,4148,52469,64257,4505,79108
8600000US79109,33821,15986,17835,57252,77244,3719,79109
8600000US79110,13704,6709,6995,59583,68563,3421,79110
8600000US79111,1648,840,808,64275,68643,9917,79111
8600000US79118,17262,8833,8429,74022,88586,5538,79118
8600000US79119,12530,6010,6520,87785,122059,8932,79119
8600000US79121,5288,2672,2616,83210,108819,10662,79121
8600000US79124,6526,3122,3404,81505,125487,14238,79124
8600000US79201,5899,3833,2066,41319,59609,7623,79201
8600000US79220,150,72,78,32917,52911,17770,79220
8600000US79225,812,414,398,52222,63935,13198,79225
8600000US79226,2266,1136,1130,44714,58615,5838,79226
8600000US79227,1169,599,570,46354,60171,10552,79227
8600000US79229,313,153,160,56250,66456,17936,79229
8600000US79230,131,65,66,42143,51210,13474,79230
8600000US79231,49,26,23,,,,79231
8600000US79233,86,45,41,35000,47484,16102,79233
8600000US79234,24,11,13,42500,44950,14995,79234
8600000US79235,2496,1195,1301,46250,51482,6378,79235
8600000US79236,156,84,72,65625,76989,15177,79236
8600000US79237,364,176,188,30556,44860,12579,79237
8600000US79239,173,84,89,23438,59557,51551,79239
8600000US79240,54,11,43,,,,79240
8600000US79241,1671,817,854,51979,67419,12835,79241
8600000US79243,69,26,43,40000,50950,20086,79243
8600000US79244,570,271,299,44583,64778,12223,79244
8600000US79245,1812,876,936,33046,51877,8568,79245
8600000US79247,47,25,22,68750,58824,19091,79247
8600000US79248,1043,475,568,33438,46150,7091,79248
8600000US79250,1005,510,495,49821,65046,9816,79250
8600000US79251,15,5,10,,32370,25644,79251
8600000US79252,2271,1106,1165,40455,55357,7118,79252
8600000US79255,472,266,206,39667,63719,11281,79255
8600000US79256,205,139,66,42679,46685,8427,79256
8600000US79257,775,423,352,43583,58037,7168,79257
8600000US79258,47,27,20,,46210,20486,79258
8600000US79259,52,26,26,,132646,98419,79259
8600000US79261,294,144,150,38194,63225,26382,79261
8600000US79311,2555,1292,1263,49561,65032,8196,79311
8600000US79312,810,382,428,49125,59346,9411,79312
8600000US79313,1123,576,547,48409,59172,7533,79313
8600000US79314,46,23,23,,34324,17315,79314
8600000US79316,8198,4458,3740,43724,61594,5039,79316
8600000US79322,1518,769,749,35500,49374,6936,79322
8600000US79323,4855,2396,2459,71160,85859,10829,79323
8600000US79324,28,8,20,,98573,56959,79324
8600000US79325,1709,824,885,54318,71707,10021,79325
8600000US79326,68,32,36,,135915,100423,79326
8600000US79329,2395,1276,1119,67617,79859,7632,79329
8600000US79330,106,55,51,,120529,58848,79330
8600000US79331,9487,5503,3984,43971,63046,6004,79331
8600000US79336,12862,6232,6630,47458,65082,3861,79336
8600000US79339,4695,2428,2267,39808,50803,5222,79339
8600000US79342,281,151,130,96250,93816,18951,79342
8600000US79343,1187,576,611,40078,55957,7638,79343
8600000US79344,40,13,27,,47227,23960,79344
8600000US79345,719,322,397,55000,67858,10354,79345
8600000US79346,1572,774,798,41042,54412,5629,79346
8600000US79347,5122,2664,2458,46897,63906,10651,79347
8600000US79350,286,146,140,47396,55822,10865,79350
8600000US79351,978,501,477,53125,66197,7446,79351
8600000US79353,43,19,24,51250,,,79353
8600000US79355,1282,662,620,64038,79285,11437,79355
8600000US79356,5101,3432,1669,48472,70096,16820,79356
8600000US79357,1554,755,799,37917,49032,7600,79357
8600000US79358,820,410,410,55625,71308,10692,79358
8600000US79359,1871,956,915,46536,56597,6453,79359
8600000US79360,10500,5360,5140,58649,76162,11169,79360
8600000US79363,3875,1818,2057,59708,82638,7619,79363
8600000US79364,5586,2616,2970,48631,61310,7321,79364
8600000US79366,859,383,476,106875,153663,39188,79366
8600000US79367,513,257,256,40625,57181,9713,79367
8600000US79369,108,52,56,34000,44070,18553,79369
8600000US79370,1266,668,598,41089,55592,10015,79370
8600000US79371,1079,523,556,53750,68019,10956,79371
8600000US79372,902,440,462,51563,74537,13283,79372
8600000US79373,2126,1088,1038,37713,63617,10955,79373
8600000US79376,24,13,11,,77589,87658,79376
8600000US79377,157,71,86,55625,62492,13416,79377
8600000US79378,207,89,118,61667,63675,13796,79378
8600000US79379,465,236,229,54375,76260,20208,79379
8600000US79380,101,57,44,39063,50532,14745,79380
8600000US79381,1168,596,572,50990,76436,9673,79381
8600000US79382,4872,2418,2454,73548,91145,9998,79382
8600000US79401,7454,4323,3131,18798,28744,3395,79401
8600000US79403,12765,6063,6702,38891,51336,4005,79403
8600000US79404,7637,3967,3670,32254,44514,4172,79404
8600000US79406,6880,3595,3285,,,,79406
8600000US79407,17155,8148,9007,42281,64681,5662,79407
8600000US79410,8619,4740,3879,40468,58523,5721,79410
8600000US79411,6260,3438,2822,34773,45860,6743,79411
8600000US79412,11586,5369,6217,35852,48919,6078,79412
8600000US79413,16591,7643,8948,52521,73729,5598,79413
8600000US79414,14126,6743,7383,42823,51517,2894,79414
8600000US79415,13185,6654,6531,30968,44791,4131,79415
8600000US79416,26274,12633,13641,53355,71252,4747,79416
8600000US79423,27992,13316,14676,68297,88870,4896,79423
8600000US79424,34625,16637,17988,78303,103486,4907,79424
8600000US79501,2004,803,1201,45563,57561,5997,79501
8600000US79502,989,508,481,46136,64578,8478,79502
8600000US79503,80,36,44,,96038,49497,79503
8600000US79504,2548,1109,1439,47202,63045,6846,79504
8600000US79505,216,117,99,38333,47935,12927,79505
8600000US79506,632,338,294,48750,66097,9395,79506
8600000US79508,1059,493,566,76172,90030,15218,79508
8600000US79510,5563,2862,2701,47819,61233,7888,79510
8600000US79511,862,391,471,53594,79543,21819,79511
8600000US79512,6272,4087,2185,49010,67705,8699,79512
8600000US79517,149,70,79,95263,75864,23338,79517
8600000US79518,30,17,13,81250,75971,20132,79518
8600000US79519,40,24,16,57656,107748,82843,79519
8600000US79520,1435,633,802,53333,71683,14131,79520
8600000US79521,3068,1706,1362,47399,52942,5536,79521
8600000US79525,1705,630,1075,52215,63766,7897,79525
8600000US79526,776,375,401,58158,74134,12702,79526
8600000US79527,143,78,65,52857,67003,19435,79527
8600000US79528,552,230,322,44643,67194,18641,79528
8600000US79529,1010,483,527,46319,57868,8669,79529
8600000US79530,399,204,195,59148,63725,10788,79530
8600000US79532,511,264,247,52014,105417,38261,79532
8600000US79533,347,177,170,46042,57431,11731,79533
8600000US79534,75,45,30,,58550,31509,79534
8600000US79535,145,68,77,65417,84211,44979,79535
8600000US79536,3748,1757,1991,45250,68572,7953,79536
8600000US79537,30,16,14,,120374,76852,79537
8600000US79538,209,100,109,54531,66469,19456,79538
8600000US79539,159,91,68,67639,87101,34959,79539
8600000US79540,63,31,32,88000,74016,14733,79540
8600000US79541,748,437,311,,160287,77520,79541
8600000US79543,873,478,395,46696,61659,8118,79543
8600000US79544,435,227,208,36458,57581,10336,79544
8600000US79545,1399,750,649,52000,80411,11659,79545
8600000US79546,1332,529,803,37500,56471,10479,79546
8600000US79547,584,273,311,26641,43731,9427,79547
8600000US79548,124,65,59,50833,62675,18780,79548
8600000US79549,11997,6692,5305,55819,69614,4893,79549
8600000US79553,2496,986,1510,37819,55098,10667,79553
8600000US79556,9501,4721,4780,44048,64493,6740,79556
8600000US79560,168,86,82,48500,126731,109127,79560
8600000US79561,529,281,248,48906,60430,12356,79561
8600000US79562,2796,1407,1389,84872,109682,21099,79562
8600000US79563,799,345,454,40536,46309,5228,79563
8600000US79565,155,79,76,63000,71194,22950,79565
8600000US79566,327,199,128,,65956,16336,79566
8600000US79567,2402,1189,1213,37151,54975,6789,79567
8600000US79601,23973,14976,8997,39364,54727,3534,79601
8600000US79602,17589,8235,9354,62652,85999,5261,79602
8600000US79603,16635,7655,8980,39586,53840,4653,79603
8600000US79605,22762,11188,11574,46859,64996,4398,79605
8600000US79606,18970,9182,9788,62774,78954,4897,79606
8600000US79607,2300,1541,759,50455,57568,7397,79607
8600000US79699,101,58,43,,,,79699
8600000US79701,21677,10809,10868,59602,76272,5571,79701
8600000US79703,16656,8476,8180,74688,86504,5997,79703
8600000US79705,30772,15211,15561,86860,120556,7785,79705
8600000US79706,16646,7996,8650,76940,97926,8531,79706
8600000US79707,28896,14656,14240,96667,138697,10596,79707
8600000US79713,294,155,139,37411,76598,27841,79713
8600000US79714,12299,6267,6032,74233,94962,11317,79714
8600000US79718,715,368,347,40521,54063,9583,79718
8600000US79719,369,171,198,49375,54276,12229,79719
8600000US79720,27696,16114,11582,51873,70996,5188,79720
8600000US79730,216,131,85,44491,55997,15323,79730
8600000US79731,3313,1664,1649,70710,80369,7557,79731
8600000US79733,160,96,64,51875,80022,22351,79733
8600000US79734,1724,808,916,54097,57112,6040,79734
8600000US79735,10369,6165,4204,47458,65535,9111,79735
8600000US79738,211,96,115,77500,85623,12683,79738
8600000US79739,946,509,437,66696,94370,20054,79739
8600000US79741,195,125,70,35625,52613,25515,79741
8600000US79742,370,180,190,45000,56174,13885,79742
8600000US79743,237,143,94,89063,83872,16837,79743
8600000US79744,974,522,452,65885,76861,9352,79744
8600000US79745,4896,2527,2369,56781,68251,7470,79745
8600000US79748,170,95,75,49167,64253,18517,79748
8600000US79749,275,117,158,79583,96247,23176,79749
8600000US79752,1678,864,814,45938,60367,8072,79752
8600000US79754,78,47,31,81875,75148,19822,79754
8600000US79755,103,67,36,45833,70321,18973,79755
8600000US79756,7056,3578,3478,68891,78376,5505,79756
8600000US79758,1500,821,679,100298,105092,18817,79758
8600000US79759,16,8,8,,,,79759
8600000US79761,24184,12387,11797,54791,82693,7076,79761
8600000US79762,31737,15967,15770,64889,86447,6600,79762
8600000US79763,26374,12944,13430,53772,68465,5154,79763
8600000US79764,15133,7832,7301,53234,74762,8469,79764
8600000US79765,10515,5109,5406,96739,125850,11440,79765
8600000US79766,4406,2388,2018,53793,75331,12511,79766
8600000US79770,38,19,19,,,,79770
8600000US79772,10798,6509,4289,59420,69367,6904,79772
8600000US79777,144,69,75,54219,78954,22905,79777
8600000US79778,789,426,363,69375,80022,12674,79778
8600000US79780,173,62,111,47500,50227,21798,79780
8600000US79781,201,118,83,43375,60837,17895,79781
8600000US79782,3152,1639,1513,67188,91156,13829,79782
8600000US79783,203,101,102,118333,134827,41191,79783
8600000US79785,71,33,38,95625,87033,29262,79785
8600000US79788,409,222,187,54375,60088,11882,79788
8600000US79789,493,239,254,71094,81702,14174,79789
8600000US79821,5603,3254,2349,36513,48994,4907,79821
8600000US79830,6290,3150,3140,44395,63079,6844,79830
8600000US79831,4,4,0,,,,79831
8600000US79834,184,106,78,46094,52889,8129,79834
8600000US79835,7324,3638,3686,29827,43812,4921,79835
8600000US79836,3944,1904,2040,38668,46888,4455,79836
8600000US79837,206,89,117,21563,44229,37229,79837
8600000US79838,4359,2204,2155,27458,35598,4056,79838
8600000US79839,1447,634,813,27241,39759,11885,79839
8600000US79842,377,193,184,47353,55335,9122,79842
8600000US79843,1606,788,818,39627,52876,7902,79843
8600000US79845,3529,1689,1840,25236,32957,6602,79845
8600000US79846,39,12,27,,,,79846
8600000US79847,104,77,27,47431,58523,22880,79847
8600000US79848,701,334,367,30313,44932,11601,79848
8600000US79849,8622,4360,4262,32279,43050,7221,79849
8600000US79851,1182,725,457,43500,60568,17161,79851
8600000US79852,579,289,290,26382,41494,8768,79852
8600000US79853,1694,791,903,33600,41856,5605,79853
8600000US79854,79,51,28,23693,41384,18857,79854
8600000US79855,1671,872,799,28750,41026,5437,79855
8600000US79901,7869,4046,3823,13893,21264,2243,79901
8600000US79902,16973,8205,8768,32868,61508,5225,79902
8600000US79903,13220,6651,6569,31201,41339,2885,79903
8600000US79904,22885,11027,11858,35589,46628,2860,79904
8600000US79905,16930,7578,9352,22739,32489,2059,79905
8600000US79906,3095,1819,1276,52342,60906,7175,79906
8600000US79907,39678,18261,21417,31271,40896,1635,79907
8600000US79908,3856,2909,947,64096,74604,8568,79908
8600000US79911,3739,1940,1799,101516,121816,13418,79911
8600000US79912,59338,28073,31265,58979,84354,3764,79912
8600000US79915,27554,12404,15150,30536,41732,3478,79915
8600000US79916,3014,2595,419,,,,79916
8600000US79920,6,4,2,,,,79920
8600000US79922,6311,3226,3085,72060,114628,15354,79922
8600000US79924,43421,20272,23149,41476,51140,2294,79924
8600000US79925,30205,14235,15970,47840,61843,3664,79925
8600000US79927,29234,13643,15591,34371,43448,2250,79927
8600000US79928,37675,18416,19259,51601,65519,4375,79928
8600000US79930,21805,10919,10886,36584,51978,6170,79930
8600000US79932,20186,9626,10560,63203,82659,3980,79932
8600000US79934,17745,8469,9276,68442,78797,4320,79934
8600000US79935,13858,6476,7382,51331,63058,5188,79935
8600000US79936,82422,40119,42303,54692,68815,3108,79936
8600000US79938,52885,26690,26195,57128,68034,4089,79938
8600000US79942,22,12,10,,,,79942
8600000US80002,14755,6962,7793,59099,73147,4651,80002
8600000US80003,29100,13812,15288,65957,81476,5513,80003
8600000US80004,29990,14659,15331,75794,93520,4124,80004
8600000US80005,22639,10888,11751,101313,118789,4295,80005
8600000US80007,8756,4250,4506,140610,164034,9653,80007
8600000US80010,30802,15962,14840,41076,52899,2540,80010
8600000US80011,36690,18671,18019,48086,59313,2499,80011
8600000US80012,39091,18852,20239,53236,64343,1980,80012
8600000US80013,54630,26081,28549,79219,90462,2660,80013
8600000US80014,32716,15241,17475,56578,69761,2312,80014
8600000US80015,49762,24238,25524,100229,112776,2808,80015
8600000US80016,39236,19459,19777,117068,141539,4313,80016
8600000US80017,26997,13422,13575,62531,73388,2853,80017
8600000US80018,8725,4413,4312,103968,109003,5916,80018
8600000US80019,1880,751,1129,82808,88905,14518,80019
8600000US80020,38132,19059,19073,87786,108237,4379,80020
8600000US80021,27610,13917,13693,77155,92190,3622,80021
8600000US80022,33473,16413,17060,64251,77028,2687,80022
8600000US80023,15387,7423,7964,121907,154234,8551,80023
8600000US80024,247,118,129,33594,48889,28139,80024
8600000US80025,333,143,190,180042,153300,43020,80025
8600000US80026,22957,11265,11692,79595,108644,5033,80026
8600000US80027,25456,12327,13129,109718,131780,4340,80027
8600000US80030,12832,6479,6353,51400,63774,3523,80030
8600000US80031,27400,13720,13680,77826,98708,4228,80031
8600000US80033,20866,10224,10642,54785,74888,4865,80033
8600000US80045,841,329,512,47898,63653,12340,80045
8600000US80101,363,214,149,66316,80268,23855,80101
8600000US80102,4405,2355,2050,75343,97495,9216,80102
8600000US80103,2068,1047,1021,72632,95257,15505,80103
8600000US80104,22360,10921,11439,97336,115302,5945,80104
8600000US80105,924,477,447,63125,70662,9221,80105
8600000US80106,4081,1982,2099,105595,111446,10573,80106
8600000US80107,9870,4780,5090,97214,125167,10186,80107
8600000US80108,19169,9449,9720,136937,185358,10809,80108
8600000US80109,15812,7881,7931,123798,142644,8836,80109
8600000US80110,18308,9722,8586,56789,70497,4528,80110
8600000US80111,24520,11953,12567,106766,165457,8257,80111
8600000US80112,25629,13265,12364,91687,120432,6005,80112
8600000US80113,18504,8689,9815,63826,131040,10143,80113
8600000US80116,3291,1626,1665,106042,140565,16475,80116
8600000US80117,2372,1207,1165,90313,106005,13118,80117
8600000US80118,5323,2622,2701,128548,150965,11980,80118
8600000US80120,25924,12524,13400,68954,96632,5688,80120
8600000US80121,15187,7216,7971,95484,161667,10124,80121
8600000US80122,25821,12400,13421,101070,120454,5279,80122
8600000US80123,37391,18355,19036,78272,105059,3126,80123
8600000US80124,16602,8336,8266,107244,148492,8298,80124
8600000US80125,8078,4227,3851,127588,153954,11526,80125
8600000US80126,31657,15425,16232,122851,150573,6045,80126
8600000US80127,34275,16627,17648,108190,134254,5019,80127
8600000US80128,28034,13896,14138,88511,108317,4549,80128
8600000US80129,22125,10682,11443,111636,132781,4892,80129
8600000US80130,20390,10041,10349,121165,148415,7996,80130
8600000US80131,226,116,110,59737,68860,14920,80131
8600000US80132,15495,7866,7629,126270,143950,7698,80132
8600000US80133,1939,987,952,44712,70087,11113,80133
8600000US80134,47426,23418,24008,112370,134083,4456,80134
8600000US80135,2919,1469,1450,95801,145290,24383,80135
8600000US80136,3621,1727,1894,82331,96570,17262,80136
8600000US80137,1046,635,411,92772,134445,54399,80137
8600000US80138,24658,12166,12492,122983,134248,4947,80138
8600000US80202,13420,7541,5879,85697,122727,10950,80202
8600000US80203,20244,10775,9469,52147,70215,4246,80203
8600000US80204,26475,13508,12967,41473,66219,4342,80204
8600000US80205,28161,14386,13775,66775,88847,5539,80205
8600000US80206,21982,10989,10993,73076,123434,8576,80206
8600000US80207,20172,9411,10761,77282,104326,5362,80207
8600000US80209,22362,11387,10975,87333,130699,7854,80209
8600000US80210,30265,14838,15427,86970,137464,7598,80210
8600000US80211,28751,14179,14572,78192,105468,4918,80211
8600000US80212,16318,7532,8786,75713,102644,8173,80212
8600000US80214,21667,11705,9962,44314,62339,5274,80214
8600000US80215,15666,7789,7877,70483,92313,4837,80215
8600000US80216,10062,5734,4328,57348,67768,7273,80216
8600000US80218,17594,9027,8567,62923,96150,6371,80218
8600000US80219,48870,24199,24671,45693,57159,2319,80219
8600000US80220,28831,13915,14916,78773,124158,9834,80220
8600000US80221,32539,16716,15823,57826,70067,3333,80221
8600000US80222,19537,9828,9709,60896,87438,5028,80222
8600000US80223,15768,8391,7377,51431,68960,4547,80223
8600000US80224,15578,7494,8084,64254,87955,5310,80224
8600000US80226,26377,12677,13700,61014,77338,4201,80226
8600000US80227,28681,13806,14875,67111,84816,3581,80227
8600000US80228,27101,13054,14047,79203,99943,3578,80228
8600000US80229,39383,19859,19524,57674,66782,2650,80229
8600000US80230,7369,3187,4182,89594,139124,15316,80230
8600000US80231,29294,14104,15190,55645,81611,7536,80231
8600000US80232,18704,9197,9507,65596,82163,4867,80232
8600000US80233,37262,18413,18849,73882,83088,3476,80233
8600000US80234,21691,10570,11121,70727,93188,4585,80234
8600000US80235,7055,3530,3525,63505,80269,5830,80235
8600000US80236,14125,7077,7048,59938,76230,7974,80236
8600000US80237,18041,9318,8723,70770,95281,4942,80237
8600000US80238,12961,6074,6887,138580,157308,8635,80238
8600000US80239,32786,15996,16790,58047,70593,3709,80239
8600000US80241,24661,11979,12682,87418,101989,5093,80241
8600000US80246,12190,6883,5307,52516,72536,6166,80246
8600000US80247,23719,10679,13040,45785,59532,3029,80247
8600000US80249,21291,10290,11001,74117,81661,4312,80249
8600000US80260,24479,11814,12665,46846,64033,4901,80260
8600000US80264,0,0,0,,,,80264
8600000US80290,0,0,0,,,,80290
8600000US80293,0,0,0,,,,80293
8600000US80294,0,0,0,,,,80294
8600000US80301,21682,11042,10640,82522,116291,7068,80301
8600000US80302,27183,14126,13057,50044,91294,6337,80302
8600000US80303,21809,11578,10231,61156,93658,5633,80303
8600000US80304,21577,10679,10898,89846,132023,7319,80304
8600000US80305,14435,7580,6855,90610,123432,7973,80305
8600000US80310,7260,4025,3235,,14418,8352,80310
8600000US80401,34989,18468,16521,85833,117547,5656,80401
8600000US80403,15789,7875,7914,110417,136830,12407,80403
8600000US80419,0,0,0,,,,80419
8600000US80420,749,409,340,42344,61310,20014,80420
8600000US80421,7634,3837,3797,69746,80346,6303,80421
8600000US80422,3827,2055,1772,75849,108875,22405,80422
8600000US80423,225,134,91,,81846,36076,80423
8600000US80424,9025,4453,4572,88243,100091,11537,80424
8600000US80425,177,64,113,137159,193655,99564,80425
8600000US80426,78,53,25,36618,36690,9248,80426
8600000US80427,657,350,307,51250,60744,14278,80427
8600000US80428,610,295,315,77969,96593,21959,80428
8600000US80432,135,96,39,64052,64019,23533,80432
8600000US80433,7028,3656,3372,103173,128093,11414,80433
8600000US80434,41,20,21,,31557,11088,80434
8600000US80435,5837,3330,2507,88194,111945,17151,80435
8600000US80436,423,236,187,46607,58640,15781,80436
8600000US80438,434,261,173,37628,52379,12640,80438
8600000US80439,19381,9709,9672,107262,138030,7365,80439
8600000US80440,1994,1150,844,66813,95501,42202,80440
8600000US80442,1907,1071,836,49861,58652,10410,80442
8600000US80443,3586,1857,1729,65806,70971,8694,80443
8600000US80444,1083,615,468,68333,86266,11056,80444
8600000US80446,3716,1978,1738,72031,85437,11606,80446
8600000US80447,1709,838,871,89212,97865,16129,80447
8600000US80448,55,55,0,,,,80448
8600000US80449,732,417,315,57404,69977,17191,80449
8600000US80451,746,343,403,73011,85544,17642,80451
8600000US80452,2594,1260,1334,58639,68501,7206,80452
8600000US80453,188,110,78,91771,90771,17646,80453
8600000US80454,1089,531,558,105972,115419,29683,80454
8600000US80455,383,239,144,44226,72979,34375,80455
8600000US80456,715,335,380,59917,92004,23110,80456
8600000US80457,294,144,150,95820,84955,17544,80457
8600000US80459,1818,929,889,53971,65043,8455,80459
8600000US80461,6159,3360,2799,46765,61631,7841,80461
8600000US80463,163,90,73,79318,65687,23539,80463
8600000US80465,12930,6514,6416,101094,139908,9019,80465
8600000US80466,2950,1484,1466,73504,87956,16018,80466
8600000US80467,1731,874,857,60714,68232,6952,80467
8600000US80468,390,194,196,,95051,46103,80468
8600000US80469,308,142,166,54130,64887,16299,80469
8600000US80470,2596,1268,1328,101667,109146,10812,80470
8600000US80471,0,0,0,,,,80471
8600000US80473,4,2,2,,,,80473
8600000US80475,30,30,0,,,,80475
8600000US80476,152,84,68,65000,82024,19713,80476
8600000US80477,106,59,47,,128140,62728,80477
8600000US80478,1067,629,438,74727,64479,19467,80478
8600000US80479,5,5,0,,,,80479
8600000US80480,1003,503,500,50250,58036,5927,80480
8600000US80481,494,275,219,112083,99077,36680,80481
8600000US80482,972,635,337,66442,91018,29571,80482
8600000US80483,539,302,237,64821,73142,14330,80483
8600000US80487,14838,7802,7036,78907,107667,9105,80487
8600000US80488,205,164,41,,89520,40977,80488
8600000US80497,403,199,204,74559,75627,11975,80497
8600000US80498,6547,4182,2365,72743,94078,13946,80498
8600000US80501,32078,15781,16297,56480,70464,2992,80501
8600000US80503,26522,12637,13885,92176,125502,7755,80503
8600000US80504,39287,19269,20018,91095,108395,4222,80504
8600000US80510,302,149,153,91667,134891,61723,80510
8600000US80511,122,62,60,,,,80511
8600000US80512,1470,765,705,61053,84674,13839,80512
8600000US80513,10023,5021,5002,85399,106340,10576,80513
8600000US80514,3829,2021,1808,65673,72908,5745,80514
8600000US80515,884,514,370,72159,78351,21379,80515
8600000US80516,18648,9247,9401,116632,133635,4820,80516
8600000US80517,8813,3973,4840,62540,83269,9388,80517
8600000US80520,1169,565,604,70844,72993,15668,80520
8600000US80521,33379,17093,16286,45281,66873,4669,80521
8600000US80524,28510,14552,13958,58580,83752,3772,80524
8600000US80525,42937,21274,21663,70527,90820,4674,80525
8600000US80526,37002,18396,18606,63078,82991,3329,80526
8600000US80528,14653,7289,7364,101104,128219,6777,80528
8600000US80530,3406,1759,1647,77500,87655,6027,80530
8600000US80532,223,106,117,,70178,50960,80532
8600000US80534,12283,6368,5915,92284,109474,9910,80534
8600000US80535,2120,1062,1058,68333,79719,13351,80535
8600000US80536,1892,941,951,71172,97896,27026,80536
8600000US80537,34698,16970,17728,67452,86812,5422,80537
8600000US80538,38345,18266,20079,68031,84051,4623,80538
8600000US80540,3517,1787,1730,96818,111246,11217,80540
8600000US80542,3313,1664,1649,94863,117090,16148,80542
8600000US80543,5048,2614,2434,80011,83265,12160,80543
8600000US80544,119,74,45,,,,80544
8600000US80545,789,423,366,61250,88048,23798,80545
8600000US80546,256,152,104,105909,96834,19550,80546
8600000US80547,1421,668,753,106250,121132,24013,80547
8600000US80549,8042,4110,3932,87246,99602,13250,80549
8600000US80550,20286,9785,10501,94227,112431,6120,80550
8600000US80601,29113,15229,13884,72541,88260,6217,80601
8600000US80602,24725,12211,12514,113405,130503,4923,80602
8600000US80603,10038,5279,4759,85234,99624,7081,80603
8600000US80610,2343,1163,1180,57325,72306,8269,80610
8600000US80611,742,369,373,77031,126859,40601,80611
8600000US80612,305,122,183,,75531,33582,80612
8600000US80615,6006,3092,2914,77567,84726,7840,80615
8600000US80620,13664,6781,6883,54701,67790,5182,80620
8600000US80621,9242,4851,4391,65567,84537,6774,80621
8600000US80622,109,52,57,,60654,24460,80622
8600000US80623,697,317,380,55455,63783,8657,80623
8600000US80624,934,523,411,72148,79956,14538,80624
8600000US80631,41376,20508,20868,43243,56487,2920,80631
8600000US80634,43925,21260,22665,70290,83749,2636,80634
8600000US80640,8697,4564,4133,82056,92984,6864,80640
8600000US80642,2965,1658,1307,74688,89767,11927,80642
8600000US80643,2965,1566,1399,87078,106972,15208,80643
8600000US80644,2290,1097,1193,71974,97651,16689,80644
8600000US80645,3280,1689,1591,62794,82141,11099,80645
8600000US80648,1057,554,503,71607,86494,18495,80648
8600000US80649,304,180,124,67500,69075,17593,80649
8600000US80650,1258,630,628,59143,76642,13370,80650
8600000US80651,3308,1620,1688,62120,88755,13975,80651
8600000US80652,269,175,94,25531,40755,22494,80652
8600000US80653,622,304,318,56779,67712,8882,80653
8600000US80654,1944,971,973,55065,68676,6670,80654
8600000US80701,11642,5906,5736,52655,65117,3948,80701
8600000US80705,958,526,432,42054,49256,7539,80705
8600000US80720,2163,1110,1053,47475,59108,4569,80720
8600000US80721,245,129,116,55000,86207,50918,80721
8600000US80722,212,130,82,45833,53724,13300,80722
8600000US80723,5049,2271,2778,49896,58651,7868,80723
8600000US80726,389,225,164,57566,68385,26145,80726
8600000US80727,346,225,121,42744,54844,10071,80727
8600000US80728,882,485,397,57188,64060,8835,80728
8600000US80729,513,274,239,51667,68795,15710,80729
8600000US80731,993,490,503,46061,54196,5584,80731
8600000US80733,380,191,189,66875,74577,9260,80733
8600000US80734,2158,1219,939,52257,78590,13436,80734
8600000US80735,221,116,105,68021,90744,29647,80735
8600000US80736,518,315,203,48750,60507,8903,80736
8600000US80737,1257,608,649,51250,57717,7171,80737
8600000US80740,102,51,51,64063,66831,9988,80740
8600000US80741,739,432,307,49125,75782,15502,80741
8600000US80742,180,104,76,43750,59071,17042,80742
8600000US80743,768,389,379,51750,66880,10383,80743
8600000US80744,328,159,169,27500,46355,7758,80744
8600000US80745,238,152,86,51625,57975,13898,80745
8600000US80746,64,41,23,,72741,46882,80746
8600000US80747,293,149,144,56250,72492,10917,80747
8600000US80749,226,132,94,43750,59102,10113,80749
8600000US80750,202,111,91,48906,55631,14639,80750
8600000US80751,13762,7505,6257,47477,61039,4407,80751
8600000US80754,133,72,61,65208,87990,25764,80754
8600000US80755,78,39,39,,61529,32952,80755
8600000US80757,155,75,80,38125,49393,11582,80757
8600000US80758,2551,1284,1267,50361,70709,11387,80758
8600000US80759,3697,1770,1927,48256,58845,6367,80759
8600000US80801,99,51,48,48750,69446,24377,80801
8600000US80802,161,80,81,54583,82234,33909,80802
8600000US80804,185,91,94,37500,48196,8380,80804
8600000US80805,294,145,149,46250,52758,9211,80805
8600000US80807,3873,2194,1679,53542,77645,22128,80807
8600000US80808,4228,2073,2155,59934,77992,6904,80808
8600000US80809,1070,595,475,58813,92836,20858,80809
8600000US80810,870,411,459,54022,62390,9110,80810
8600000US80812,202,102,100,58929,98924,38915,80812
8600000US80813,1379,799,580,44277,47917,5165,80813
8600000US80814,2774,1433,1341,72924,75475,9269,80814
8600000US80815,594,279,315,52500,66411,9548,80815
8600000US80816,5276,2736,2540,54039,69831,7548,80816
8600000US80817,21038,10751,10287,64103,74311,3748,80817
8600000US80818,243,102,141,72375,86476,33112,80818
8600000US80819,616,307,309,39135,55216,8748,80819
8600000US80820,637,344,293,71375,132922,61764,80820
8600000US80821,742,322,420,50500,60712,8318,80821
8600000US80822,158,75,83,55417,70722,21592,80822
8600000US80823,116,49,67,46250,51454,13838,80823
8600000US80824,173,79,94,49250,63712,21745,80824
8600000US80825,271,133,138,59375,67313,12165,80825
8600000US80827,606,291,315,87375,71525,13450,80827
8600000US80828,3065,2279,786,48125,68070,9913,80828
8600000US80829,4820,2547,2273,67850,101816,17950,80829
8600000US80830,168,74,94,55865,62899,12708,80830
8600000US80831,17940,9082,8858,90992,98798,5444,80831
8600000US80832,580,283,297,52727,63631,13000,80832
8600000US80833,542,284,258,51838,60640,9867,80833
8600000US80834,203,113,90,35000,46334,12445,80834
8600000US80835,657,305,352,46167,75516,24450,80835
8600000US80836,787,391,396,50313,59734,5366,80836
8600000US80840,5812,3950,1862,67083,76625,7996,80840
8600000US80860,558,313,245,53125,62774,9548,80860
8600000US80861,181,103,78,56250,75611,16744,80861
8600000US80862,37,21,16,69583,74124,19455,80862
8600000US80863,10235,5068,5167,73705,92857,8118,80863
8600000US80864,1094,601,493,51676,70208,9726,80864
8600000US80902,8095,4832,3263,47015,51345,3940,80902
8600000US80903,13621,6931,6690,41195,60158,3538,80903
8600000US80904,17711,8564,9147,49607,71999,4462,80904
8600000US80905,12824,6359,6465,42659,61730,5699,80905
8600000US80906,28357,13968,14389,65973,104929,6004,80906
8600000US80907,23984,12110,11874,49270,69122,5246,80907
8600000US80908,13166,6276,6890,108463,132283,8349,80908
8600000US80909,30392,15268,15124,43532,55931,2424,80909
8600000US80910,22103,10189,11914,38772,52400,5760,80910
8600000US80911,25894,12541,13353,65824,74744,2855,80911
8600000US80913,3714,3323,391,,,,80913
8600000US80914,428,320,108,153750,160118,24906,80914
8600000US80915,16159,8384,7775,59461,69071,4808,80915
8600000US80916,28646,14235,14411,47475,55331,2414,80916
8600000US80917,24613,12306,12307,55528,66643,2990,80917
8600000US80918,39009,19522,19487,64840,82361,3294,80918
8600000US80919,22350,10762,11588,92635,110759,5335,80919
8600000US80920,29213,14395,14818,92983,111657,3266,80920
8600000US80921,16912,8395,8517,122294,137174,8291,80921
8600000US80922,21037,10641,10396,83034,93065,4738,80922
8600000US80923,21120,10294,10826,88121,95378,3578,80923
8600000US80924,5458,2640,2818,133983,137173,8320,80924
8600000US80925,7255,3643,3612,75969,89398,8946,80925
8600000US80926,1496,754,742,64632,85592,14187,80926
8600000US80927,2401,1117,1284,106440,120639,12182,80927
8600000US80928,986,475,511,54375,68764,12242,80928
8600000US80929,122,37,85,,50618,22970,80929
8600000US80930,1328,725,603,61311,64831,9551,80930
8600000US80938,55,28,27,,,,80938
8600000US80939,0,0,0,,,,80939
8600000US80951,3116,1756,1360,85703,103963,19437,80951
8600000US81001,23331,11726,11605,36534,51544,3104,81001
8600000US81003,12220,6437,5783,31303,43641,2953,81003
8600000US81004,20170,9689,10481,34792,47460,2982,81004
8600000US81005,24781,11438,13343,47623,63828,2886,81005
8600000US81006,9071,4256,4815,53628,69605,3625,81006
8600000US81007,23589,11356,12233,67737,78129,2937,81007
8600000US81008,8549,4146,4403,51948,73596,10494,81008
8600000US81019,1158,564,594,44757,65620,24570,81019
8600000US81020,733,341,392,45000,67761,17887,81020
8600000US81021,16,9,7,84063,73656,24182,81021
8600000US81022,1388,753,635,53929,63617,12207,81022
8600000US81023,1036,500,536,67824,75281,10056,81023
8600000US81024,190,100,90,16389,45905,31617,81024
8600000US81025,570,310,260,43611,50098,10311,81025
8600000US81027,132,68,64,46563,51574,9186,81027
8600000US81029,208,121,87,34286,48972,12030,81029
8600000US81030,138,74,64,51667,82580,40986,81030
8600000US81033,229,125,104,33281,32937,6280,81033
8600000US81036,752,338,414,38287,54466,9927,81036
8600000US81038,0,0,0,,,,81038
8600000US81039,1319,593,726,41452,48988,5651,81039
8600000US81040,298,184,114,32885,35706,9093,81040
8600000US81041,624,304,320,33125,64709,23819,81041
8600000US81043,44,26,18,30625,33584,14769,81043
8600000US81044,181,80,101,29375,43416,12176,81044
8600000US81045,50,25,25,44375,50103,16139,81045
8600000US81047,1133,586,547,44875,54817,6224,81047
8600000US81049,224,120,104,51319,67601,18068,81049
8600000US81050,6946,3209,3737,32081,44291,5093,81050
8600000US81052,6790,3313,3477,39609,51050,4057,81052
8600000US81054,4167,2962,1205,30708,45091,4575,81054
8600000US81055,1283,604,679,51806,61147,9986,81055
8600000US81057,392,216,176,54886,66600,12626,81057
8600000US81058,855,440,415,38500,45728,6174,81058
8600000US81059,522,485,37,43125,69004,43856,81059
8600000US81062,1708,1163,545,41842,52673,11903,81062
8600000US81063,2383,1626,757,36250,48359,6813,81063
8600000US81064,210,101,109,45556,54891,8225,81064
8600000US81067,4386,2192,2194,34518,48878,4994,81067
8600000US81069,1636,864,772,69536,79755,11557,81069
8600000US81071,214,113,101,41328,66497,15639,81071
8600000US81073,1441,684,757,35000,50790,6048,81073
8600000US81076,549,206,343,48750,51950,10328,81076
8600000US81077,513,237,276,55156,51611,10521,81077
8600000US81081,71,39,32,58533,66860,19277,81081
8600000US81082,9317,4775,4542,41028,53576,3710,81082
8600000US81084,74,45,29,31875,40394,14019,81084
8600000US81087,80,35,45,33750,53968,18450,81087
8600000US81089,3631,1794,1837,33418,45279,4703,81089
8600000US81090,821,404,417,43125,53387,6030,81090
8600000US81091,447,216,231,51641,75622,18156,81091
8600000US81092,609,320,289,46406,56837,9291,81092
8600000US81101,11869,5868,6001,38245,53337,4967,81101
8600000US81120,1626,865,761,27989,38358,4301,81120
8600000US81121,266,142,124,42639,56642,11804,81121
8600000US81122,6608,3453,3155,62066,84600,9711,81122
8600000US81123,711,364,347,30588,54902,10232,81123
8600000US81124,189,74,115,11354,17279,11486,81124
8600000US81125,2600,1173,1427,41895,60477,12790,81125
8600000US81126,194,97,97,20735,37649,13422,81126
8600000US81128,89,44,45,,97064,28324,81128
8600000US81129,67,28,39,14556,21259,6168,81129
8600000US81130,729,360,369,61641,74429,7583,81130
8600000US81131,933,518,415,24071,41067,10565,81131
8600000US81132,2386,1248,1138,34800,57007,11647,81132
8600000US81133,955,469,486,36923,51575,10960,81133
8600000US81136,146,87,59,27222,44312,12723,81136
8600000US81137,4484,2220,2264,53250,64422,3265,81137
8600000US81138,58,38,20,,21855,13265,81138
8600000US81140,1715,857,858,44130,62843,12861,81140
8600000US81141,1003,503,500,36500,51088,7010,81141
8600000US81143,648,354,294,30417,48293,17983,81143
8600000US81144,5234,2550,2684,39127,55152,5898,81144
8600000US81146,489,263,226,50938,61292,8782,81146
8600000US81147,10165,5024,5141,50239,69526,6348,81147
8600000US81148,248,114,134,23125,37983,8154,81148
8600000US81149,736,418,318,31573,43558,7925,81149
8600000US81151,1161,598,563,44813,52447,5442,81151
8600000US81152,1000,537,463,28824,36839,6955,81152
8600000US81154,993,440,553,50250,61813,10107,81154
8600000US81155,246,110,136,58000,60988,18147,81155
8600000US81201,7699,3904,3795,55057,71543,6559,81201
8600000US81210,213,120,93,,122869,66933,81210
8600000US81211,6781,3958,2823,53731,66903,8091,81211
8600000US81212,25384,14820,10564,46946,60913,2669,81212
8600000US81220,129,74,55,66875,74232,18506,81220
8600000US81221,256,124,132,46389,54386,14039,81221
8600000US81222,314,107,207,,145176,157466,81222
8600000US81223,1297,677,620,31905,41704,6643,81223
8600000US81224,2552,1508,1044,69714,91068,11325,81224
8600000US81225,1223,588,635,63616,97071,18463,81225
8600000US81226,7930,5724,2206,42684,53377,4964,81226
8600000US81227,6,0,6,,,,81227
8600000US81230,8016,4277,3739,52707,60834,4254,81230
8600000US81231,680,424,256,,,,81231
8600000US81232,27,17,10,,,,81232
8600000US81233,740,384,356,51058,72734,14900,81233
8600000US81235,665,301,364,51563,78330,12902,81235
8600000US81236,1219,613,606,59484,60784,10787,81236
8600000US81237,38,7,31,76607,73578,8001,81237
8600000US81239,64,45,19,,125200,85218,81239
8600000US81240,2796,1295,1501,62500,78944,16463,81240
8600000US81241,83,40,43,,51802,37272,81241
8600000US81242,477,214,263,46750,55025,8360,81242
8600000US81243,101,62,39,52917,56533,26089,81243
8600000US81244,340,171,169,53281,56061,8892,81244
8600000US81248,102,52,50,55990,53847,4372,81248
8600000US81251,159,87,72,55781,60734,19917,81251
8600000US81252,3339,1625,1714,43059,54643,7954,81252
8600000US81253,421,207,214,86250,95902,20969,81253
8600000US81301,25493,12758,12735,70516,99455,9206,81301
8600000US81303,6604,3208,3396,62515,81734,6615,81303
8600000US81320,148,54,94,41382,46393,10682,81320
8600000US81321,11429,5720,5709,43859,55902,4030,81321
8600000US81323,3472,1750,1722,63056,72080,8435,81323
8600000US81324,1003,519,484,42361,55439,7859,81324
8600000US81325,192,107,85,44886,54195,14236,81325
8600000US81326,1644,853,791,53871,67813,6677,81326
8600000US81327,365,178,187,36818,43489,11353,81327
8600000US81328,3728,1715,2013,54798,68460,8021,81328
8600000US81330,94,47,47,,,,81330
8600000US81331,258,139,119,44886,50448,9959,81331
8600000US81332,154,78,76,41071,71626,30109,81332
8600000US81334,957,351,606,27391,32414,5088,81334
8600000US81335,24,13,11,,,,81335
8600000US81401,17795,8465,9330,43396,56676,3734,81401
8600000US81403,8399,4154,4245,60411,76389,5681,81403
8600000US81410,1192,531,661,51146,59565,12787,81410
8600000US81411,43,21,22,,40030,28107,81411
8600000US81413,4094,1911,2183,48119,61725,10503,81413
8600000US81415,1135,539,596,69375,87756,22263,81415
8600000US81416,11237,5969,5268,42176,54592,4047,81416
8600000US81418,1396,612,784,41838,69560,21795,81418
8600000US81419,3116,1575,1541,42043,60023,9154,81419
8600000US81422,566,318,248,42000,47876,7966,81422
8600000US81423,1350,707,643,58864,75575,10731,81423
8600000US81424,796,421,375,50676,61116,8820,81424
8600000US81425,4028,2013,2015,43819,52375,4832,81425
8600000US81426,94,53,41,92000,96709,21441,81426
8600000US81427,941,487,454,61413,70579,12012,81427
8600000US81428,2638,1262,1376,46250,77501,17144,81428
8600000US81429,41,20,21,,66215,35315,81429
8600000US81430,595,335,260,61346,116168,61562,81430
8600000US81431,329,198,131,48875,67004,17845,81431
8600000US81432,2512,1221,1291,62232,79136,8476,81432
8600000US81433,447,239,208,45000,65134,12963,81433
8600000US81434,219,146,73,29598,43248,12339,81434
8600000US81435,4366,2312,2054,66815,106063,16223,81435
8600000US81501,19320,9606,9714,36677,47646,2907,81501
8600000US81503,12166,5579,6587,55365,64398,4167,81503
8600000US81504,21804,10623,11181,54447,67044,3824,81504
8600000US81505,8019,3908,4111,59914,79694,5688,81505
8600000US81506,9678,4367,5311,53707,83444,9578,81506
8600000US81507,12076,5916,6160,79550,92888,6266,81507
8600000US81520,10512,5159,5353,38343,49344,5350,81520
8600000US81521,11860,5873,5987,58844,66861,5843,81521
8600000US81522,131,66,65,,,,81522
8600000US81523,957,511,446,90336,129099,53759,81523
8600000US81524,1366,719,647,70688,87376,22845,81524
8600000US81525,884,523,361,45552,65833,25344,81525
8600000US81526,4354,2153,2201,59256,76882,7845,81526
8600000US81527,1521,822,699,63734,73341,17389,81527
8600000US81601,12062,6112,5950,76732,91403,5385,81601
8600000US81610,259,155,104,51000,55302,11497,81610
8600000US81611,9022,4664,4358,76027,147215,24538,81611
8600000US81612,0,0,0,,,,81612
8600000US81615,2564,1391,1173,61273,77229,17501,81615
8600000US81620,8166,4355,3811,77540,108857,25217,81620
8600000US81621,4691,2451,2240,78281,108478,13165,81621
8600000US81623,12802,7156,5646,86978,111885,9611,81623
8600000US81624,1097,622,475,60208,76026,9148,81624
8600000US81625,9229,4570,4659,53575,70013,5155,81625
8600000US81630,647,336,311,62847,69497,7114,81630
8600000US81631,6042,3211,2831,109946,120995,15701,81631
8600000US81632,7789,3864,3925,81851,123978,17713,81632
8600000US81633,0,0,0,,,,81633
8600000US81635,4786,2331,2455,66783,82853,13006,81635
8600000US81637,6256,3421,2835,82222,91212,10007,81637
8600000US81638,91,50,41,,76426,37427,81638
8600000US81639,1840,913,927,65170,73832,9049,81639
8600000US81640,92,65,27,,42856,17669,81640
8600000US81641,2731,1429,1302,46250,64939,7502,81641
8600000US81642,0,0,0,,,,81642
8600000US81643,508,277,231,73409,82133,15592,81643
8600000US81645,1020,620,400,88542,95912,14741,81645
8600000US81646,142,78,64,98625,73260,27348,81646
8600000US81647,5377,2605,2772,88017,92382,8338,81647
8600000US81648,2022,993,1029,72083,77797,8598,81648
8600000US81649,310,143,167,63750,71938,9710,81649
8600000US81650,9602,5018,4584,63857,70910,5460,81650
8600000US81652,3621,1769,1852,63750,77699,7146,81652
8600000US81653,16,16,0,,,,81653
8600000US81654,1256,545,711,60833,80183,19692,81654
8600000US81655,63,15,48,,,,81655
8600000US81656,136,95,41,,64985,52611,81656
8600000US81657,5208,2715,2493,76466,123482,18970,81657
8600000US82001,27958,14038,13920,59232,71462,4041,82001
8600000US82005,574,499,75,,,,82005
8600000US82007,16045,8143,7902,49447,64448,5859,82007
8600000US82009,26261,13080,13181,82840,99895,4762,82009
8600000US82050,169,83,86,45952,48157,10985,82050
8600000US82051,40,19,21,26000,31605,15177,82051
8600000US82052,12,6,6,,,,82052
8600000US82053,738,325,413,64500,66961,15774,82053
8600000US82054,1109,567,542,79953,105359,33906,82054
8600000US82055,251,151,100,58906,69497,14613,82055
8600000US82058,41,27,14,,78573,33917,82058
8600000US82059,198,121,77,47898,47417,20832,82059
8600000US82060,460,271,189,104936,121826,41455,82060
8600000US82061,0,0,0,,,,82061
8600000US82063,177,100,77,,85998,61916,82063
8600000US82070,17053,8824,8229,50800,65848,4738,82070
8600000US82072,13960,7185,6775,41475,58605,3655,82072
8600000US82073,2,2,0,,,,82073
8600000US82081,84,43,41,,110390,44057,82081
8600000US82082,1361,694,667,51818,73053,17062,82082
8600000US82083,200,111,89,25000,39933,11917,82083
8600000US82084,7,7,0,,,,82084
8600000US82190,1075,533,542,62835,55619,13664,82190
8600000US82201,5168,2615,2553,48261,73653,13908,82201
8600000US82210,366,183,183,42981,60343,21344,82210
8600000US82212,436,248,188,48309,72592,20728,82212
8600000US82213,415,200,215,39500,53081,15588,82213
8600000US82214,970,472,498,47132,63704,9997,82214
8600000US82215,90,50,40,46250,69665,33146,82215
8600000US82217,42,19,23,,,,82217
8600000US82219,5,0,5,,,,82219
8600000US82221,381,189,192,28056,43158,10002,82221
8600000US82222,29,14,15,,78672,51550,82222
8600000US82223,958,501,457,54722,69010,8060,82223
8600000US82224,12,6,6,,,,82224
8600000US82225,1567,625,942,40167,54563,7810,82225
8600000US82227,237,147,90,,71933,29445,82227
8600000US82229,1,0,1,,,,82229
8600000US82240,8285,4345,3940,49627,68007,6928,82240
8600000US82242,32,14,18,1e+05,95728,25824,82242
8600000US82243,92,31,61,,57784,46176,82243
8600000US82244,403,263,140,75357,71217,16266,82244
8600000US82301,6897,3851,3046,64792,74893,5107,82301
8600000US82321,442,219,223,78359,69228,8610,82321
8600000US82322,158,83,75,67083,70293,15680,82322
8600000US82323,94,56,38,24792,45020,16186,82323
8600000US82324,192,110,82,46000,55391,22053,82324
8600000US82325,836,432,404,38889,85187,28117,82325
8600000US82327,629,345,284,46406,55183,11080,82327
8600000US82329,302,156,146,34583,48627,13083,82329
8600000US82331,1835,945,890,62381,75322,10008,82331
8600000US82332,107,39,68,,36928,31328,82332
8600000US82334,384,204,180,86094,92880,16050,82334
8600000US82335,49,29,20,41375,40045,5397,82335
8600000US82336,140,87,53,65875,70675,16904,82336
8600000US82401,5693,2867,2826,52988,65473,5241,82401
8600000US82410,1875,968,907,51316,59423,6696,82410
8600000US82411,329,169,160,63750,68292,11577,82411
8600000US82412,387,161,226,59583,65261,10522,82412
8600000US82414,12362,6099,6263,68611,83888,6891,82414
8600000US82420,629,282,347,60694,72792,15369,82420
8600000US82421,244,113,131,52250,68671,18585,82421
8600000US82422,14,6,8,,,,82422
8600000US82423,120,57,63,40833,44349,11727,82423
8600000US82426,2011,1027,984,53393,58712,4910,82426
8600000US82428,180,87,93,73438,79162,24110,82428
8600000US82430,62,29,33,46563,50567,13924,82430
8600000US82431,2524,1309,1215,52837,62841,6663,82431
8600000US82432,193,105,88,39167,45885,9690,82432
8600000US82433,734,377,357,55114,65536,8576,82433
8600000US82434,80,49,31,,44168,22409,82434
8600000US82435,9512,4550,4962,59645,84928,16871,82435
8600000US82440,157,15,142,,,,82440
8600000US82441,189,120,69,,54901,24309,82441
8600000US82442,586,313,273,55733,63983,7918,82442
8600000US82443,3683,1804,1879,51467,68094,5791,82443
8600000US82450,128,67,61,53722,52600,11021,82450
8600000US82501,14529,7485,7044,52604,73189,5501,82501
8600000US82510,282,131,151,40139,55575,12714,82510
8600000US82512,151,85,66,26964,78942,41360,82512
8600000US82513,1437,721,716,43821,61756,7043,82513
8600000US82514,1075,500,575,47955,56855,5365,82514
8600000US82515,354,160,194,53438,58687,10318,82515
8600000US82516,369,182,187,47708,49267,6940,82516
8600000US82520,10229,4890,5339,58869,74797,4673,82520
8600000US82523,638,324,314,62557,69319,10128,82523
8600000US82601,22427,11946,10481,56428,73870,3315,82601
8600000US82604,20208,9961,10247,64682,81091,3706,82604
8600000US82609,13182,6003,7179,65615,86794,6941,82609
8600000US82620,181,98,83,,104268,56625,82620
8600000US82630,0,0,0,,,,82630
8600000US82633,7489,3821,3668,65121,79952,7546,82633
8600000US82635,146,84,62,36429,46292,11709,82635
8600000US82636,3462,1854,1608,57791,77664,14553,82636
8600000US82637,3064,1554,1510,62854,74911,6272,82637
8600000US82638,0,0,0,,,,82638
8600000US82639,593,335,258,45000,76939,24818,82639
8600000US82640,46,22,24,,,,82640
8600000US82642,50,19,31,33750,39241,13070,82642
8600000US82643,290,144,146,50833,60241,10572,82643
8600000US82644,1286,683,603,43750,58235,11897,82644
8600000US82646,0,0,0,,,,82646
8600000US82648,19,9,10,,,,82648
8600000US82649,753,371,382,44306,63661,10493,82649
8600000US82701,4315,2251,2064,55192,70776,7583,82701
8600000US82710,230,94,136,,61375,17600,82710
8600000US82711,76,36,40,152727,128445,28067,82711
8600000US82712,251,135,116,50682,45403,12318,82712
8600000US82714,56,30,26,,,,82714
8600000US82715,0,0,0,,,,82715
8600000US82716,13302,6968,6334,71047,79910,7329,82716
8600000US82718,18417,9578,8839,84755,96492,5923,82718
8600000US82720,717,408,309,49531,79698,31711,82720
8600000US82721,2094,1053,1041,78721,80102,6356,82721
8600000US82723,246,136,110,,77178,45551,82723
8600000US82725,491,222,269,69392,70721,20129,82725
8600000US82727,802,362,440,77431,89290,26380,82727
8600000US82729,2063,1039,1024,56458,80886,13991,82729
8600000US82730,1194,631,563,41667,65178,11303,82730
8600000US82731,89,63,26,,64563,31197,82731
8600000US82732,1430,797,633,80250,87682,15039,82732
8600000US82801,20043,9802,10241,57875,76939,4619,82801
8600000US82831,163,89,74,,55145,24434,82831
8600000US82832,653,328,325,121071,130614,36350,82832
8600000US82833,94,51,43,,,,82833
8600000US82834,5889,3040,2849,55391,78118,11351,82834
8600000US82835,210,91,119,51250,58774,13811,82835
8600000US82836,713,408,305,60086,71720,13143,82836
8600000US82837,44,21,23,43125,55208,25904,82837
8600000US82838,248,134,114,95000,88106,27746,82838
8600000US82839,883,439,444,60799,69062,11180,82839
8600000US82842,532,255,277,48045,51894,15421,82842
8600000US82844,18,9,9,,,,82844
8600000US82845,29,14,15,,,,82845
8600000US82901,21181,11066,10115,75466,86086,4209,82901
8600000US82922,229,165,64,61888,70108,19761,82922
8600000US82923,257,130,127,,145859,102055,82923
8600000US82925,275,190,85,,98636,32279,82925
8600000US82929,109,101,8,,50724,40169,82929
8600000US82930,10109,4921,5188,55006,66217,4569,82930
8600000US82932,222,112,110,35568,56937,21037,82932
8600000US82933,336,171,165,83844,78004,18791,82933
8600000US82934,50,22,28,,88693,42634,82934
8600000US82935,9604,4918,4686,69989,87113,7067,82935
8600000US82936,0,0,0,,,,82936
8600000US82937,3035,1638,1397,79149,88731,9093,82937
8600000US82938,237,144,93,,40689,46360,82938
8600000US82939,1007,547,460,57667,64874,8123,82939
8600000US82941,3737,1864,1873,77778,80131,8532,82941
8600000US82942,90,42,48,,63891,25941,82942
8600000US82943,261,102,159,36441,46313,21711,82943
8600000US82944,72,20,52,,83168,74411,82944
8600000US82945,256,123,133,56250,73976,16994,82945
8600000US83001,13536,7066,6470,83657,131981,16926,83001
8600000US83011,39,4,35,,,,83011
8600000US83012,192,55,137,,47604,46566,83012
8600000US83013,422,198,224,,70857,28077,83013
8600000US83014,2757,1440,1317,119188,154638,31687,83014
8600000US83025,447,244,203,,96544,41319,83025
8600000US83101,2263,1255,1008,65120,76084,8818,83101
8600000US83110,3214,1566,1648,62500,74290,6544,83110
8600000US83111,404,202,202,82526,60126,17047,83111
8600000US83112,257,176,81,68438,94061,32090,83112
8600000US83113,1643,920,723,73846,86519,12777,83113
8600000US83114,675,314,361,59507,70921,9980,83114
8600000US83115,1314,769,545,117931,98876,26611,83115
8600000US83116,525,234,291,50385,69985,12188,83116
8600000US83118,794,468,326,59348,116990,58004,83118
8600000US83119,299,148,151,130354,104001,36495,83119
8600000US83120,644,295,349,86384,105943,44653,83120
8600000US83121,0,0,0,,,,83121
8600000US83122,440,159,281,55446,56289,16862,83122
8600000US83123,373,181,192,48214,60001,9539,83123
8600000US83124,113,62,51,85500,106936,54541,83124
8600000US83126,312,131,181,98068,90289,38065,83126
8600000US83127,2777,1400,1377,60000,78325,9484,83127
8600000US83128,841,457,384,91369,97394,18724,83128
8600000US83201,27932,13669,14263,47765,64459,4355,83201
8600000US83202,15878,8129,7749,55429,65650,3574,83202
8600000US83203,289,171,118,30288,31646,6642,83203
8600000US83204,13987,6653,7334,44428,64605,7363,83204
8600000US83209,1116,502,614,,14867,8105,83209
8600000US83210,2436,1273,1163,42879,51478,7693,83210
8600000US83211,4258,2225,2033,52530,60676,8778,83211
8600000US83212,98,55,43,51250,65877,17587,83212
8600000US83213,1050,557,493,32614,48078,6983,83213
8600000US83214,429,219,210,63333,66919,11491,83214
8600000US83215,50,22,28,38750,31924,8708,83215
8600000US83217,568,304,264,57500,76114,12839,83217
8600000US83218,232,115,117,41719,47275,13622,83218
8600000US83220,122,67,55,56250,58788,10998,83220
8600000US83221,18858,9366,9492,51955,63984,3328,83221
8600000US83223,75,41,34,73125,74359,18237,83223
8600000US83226,1687,829,858,30147,43549,6871,83226
8600000US83227,119,100,19,,37624,28589,83227
8600000US83228,379,190,189,43203,44207,8216,83228
8600000US83232,336,163,173,59583,66644,10464,83232
8600000US83233,0,0,0,,,,83233
8600000US83234,1096,541,555,46696,68110,13694,83234
8600000US83235,59,35,24,,,,83235
8600000US83236,1597,774,823,63750,64708,6279,83236
8600000US83237,699,348,351,68077,80359,20689,83237
8600000US83238,63,39,24,,59836,25227,83238
8600000US83239,425,193,232,65000,63441,7119,83239
8600000US83241,1661,847,814,53068,76572,10620,83241
8600000US83243,22,12,10,,,,83243
8600000US83244,234,128,106,58000,79674,18127,83244
8600000US83245,1622,850,772,55743,74121,11019,83245
8600000US83246,734,368,366,69375,89279,24568,83246
8600000US83250,1147,539,608,61818,80406,15122,83250
8600000US83251,1040,518,522,44853,66755,18568,83251
8600000US83252,3035,1516,1519,50673,57030,5041,83252
8600000US83253,61,33,28,,32982,20770,83253
8600000US83254,2660,1285,1375,48065,60314,5686,83254
8600000US83255,987,511,476,51082,70123,10395,83255
8600000US83261,475,225,250,61000,61593,8774,83261
8600000US83262,901,445,456,68629,75523,16053,83262
8600000US83263,6426,3168,3258,55913,68155,5287,83263
8600000US83271,333,161,172,58625,78176,24634,83271
8600000US83272,178,73,105,64643,72494,14223,83272
8600000US83274,5860,2856,3004,55550,64174,5340,83274
8600000US83276,2638,1346,1292,60766,68810,6902,83276
8600000US83277,184,84,100,97857,81460,19865,83277
8600000US83278,315,172,143,95735,77321,24560,83278
8600000US83281,65,28,37,47625,72054,47191,83281
8600000US83283,157,110,47,102115,107880,24566,83283
8600000US83285,110,47,63,44766,57000,17854,83285
8600000US83286,874,454,420,62708,70230,6323,83286
8600000US83287,221,121,100,57222,92963,34323,83287
8600000US83301,41108,19825,21283,50185,64867,3743,83301
8600000US83302,145,91,54,30000,32787,9174,83302
8600000US83311,556,255,301,51853,64803,16993,83311
8600000US83312,135,73,62,31786,45207,16585,83312
8600000US83313,3042,1604,1438,57576,75223,13271,83313
8600000US83314,748,351,397,44750,73397,25003,83314
8600000US83316,7710,3831,3879,45425,58378,4730,83316
8600000US83318,11969,6005,5964,49116,61678,3636,83318
8600000US83320,643,341,302,62045,64482,10145,83320
8600000US83321,359,155,204,48438,58147,11727,83321
8600000US83322,23,9,14,,,,83322
8600000US83323,1114,631,483,61118,66521,9008,83323
8600000US83324,487,207,280,49792,57173,8915,83324
8600000US83325,538,271,267,55208,68257,18773,83325
8600000US83327,548,257,291,40703,70234,17230,83327
8600000US83328,3840,1906,1934,52368,65535,7287,83328
8600000US83330,4845,2573,2272,50410,62797,8746,83330
8600000US83332,2081,1084,997,39063,53338,5053,83332
8600000US83333,7532,3662,3870,50465,82963,11990,83333
8600000US83334,1421,687,734,50833,61514,12664,83334
8600000US83335,1333,666,667,46189,64100,10525,83335
8600000US83336,3659,1777,1882,56221,68890,14544,83336
8600000US83337,30,22,8,,,,83337
8600000US83338,14388,7362,7026,50083,61178,3944,83338
8600000US83340,3805,1866,1939,57647,70630,8899,83340
8600000US83341,5210,2615,2595,61224,75375,7407,83341
8600000US83342,847,390,457,50777,63576,12084,83342
8600000US83344,802,424,378,53043,73939,14976,83344
8600000US83346,1197,635,562,54426,82697,20043,83346
8600000US83347,2211,1161,1050,54783,61910,6237,83347
8600000US83348,298,130,168,,60570,30226,83348
8600000US83349,880,486,394,51250,61665,7260,83349
8600000US83350,9316,4751,4565,47055,65224,7666,83350
8600000US83352,2386,1257,1129,44779,53253,5473,83352
8600000US83353,1309,803,506,50625,91541,33069,83353
8600000US83354,25,14,11,,,,83354
8600000US83355,3122,1642,1480,51619,56043,4912,83355
8600000US83401,28921,14278,14643,51956,65601,3153,83401
8600000US83402,17793,9270,8523,51017,72575,7468,83402
8600000US83404,16470,7784,8686,62626,90700,7264,83404
8600000US83406,11843,5675,6168,68601,92043,8916,83406
8600000US83414,369,210,159,57037,60074,26881,83414
8600000US83420,1601,816,785,47143,54244,5878,83420
8600000US83421,208,122,86,80536,66060,18793,83421
8600000US83422,2448,1299,1149,72794,91766,18018,83422
8600000US83423,691,347,344,35227,49292,7341,83423
8600000US83424,303,239,64,,57227,70392,83424
8600000US83425,335,167,168,45500,76221,23437,83425
8600000US83427,1158,606,552,73233,78884,10295,83427
8600000US83428,347,175,172,56964,68660,10876,83428
8600000US83429,604,293,311,51058,77369,15492,83429
8600000US83431,604,299,305,54226,62564,10763,83431
8600000US83433,4,2,2,,,,83433
8600000US83434,1125,527,598,67396,72498,11026,83434
8600000US83435,380,206,174,52670,60330,9460,83435
8600000US83436,342,174,168,50588,61879,14731,83436
8600000US83440,26567,13260,13307,34980,52160,3681,83440
8600000US83442,14041,7127,6914,61650,76708,5637,83442
8600000US83443,828,432,396,49662,66372,11459,83443
8600000US83444,814,447,367,35815,40866,7527,83444
8600000US83445,5673,3077,2596,60152,64124,4228,83445
8600000US83446,23,12,11,30000,32529,11405,83446
8600000US83448,1552,846,706,45946,74544,16745,83448
8600000US83449,145,71,74,50208,51861,9533,83449
8600000US83450,597,318,279,52308,61624,9321,83450
8600000US83451,651,304,347,41563,51609,10626,83451
8600000US83452,1542,840,702,71500,74266,7116,83452
8600000US83454,378,195,183,68375,71794,14033,83454
8600000US83455,3866,1922,1944,64607,81790,17943,83455
8600000US83460,221,68,153,,,,83460
8600000US83462,540,248,292,34038,43278,11972,83462
8600000US83463,97,33,64,,60096,38591,83463
8600000US83464,310,170,140,40139,48910,11135,83464
8600000US83465,121,64,57,75625,84662,27700,83465
8600000US83466,193,109,84,22750,37193,18268,83466
8600000US83467,4862,2436,2426,38864,49908,3829,83467
8600000US83468,109,59,50,52917,59628,18911,83468
8600000US83469,28,15,13,,,,83469
8600000US83501,27510,13333,14177,54792,66911,2816,83501
8600000US83520,189,100,89,44688,63260,22831,83520
8600000US83522,1906,1178,728,54079,60753,6944,83522
8600000US83523,608,317,291,47159,61283,10540,83523
8600000US83524,736,361,375,51346,68697,11363,83524
8600000US83525,323,200,123,24028,35360,14399,83525
8600000US83526,214,120,94,60500,59414,11377,83526
8600000US83530,4149,1994,2155,39263,49695,5710,83530
8600000US83533,184,88,96,57292,76603,20746,83533
8600000US83535,966,531,435,57721,64704,8327,83535
8600000US83536,3517,1719,1798,35197,44470,2705,83536
8600000US83537,858,450,408,56635,76373,15039,83537
8600000US83539,1848,919,929,40729,52191,6687,83539
8600000US83540,1708,840,868,44875,57617,5005,83540
8600000US83541,776,398,378,44886,59669,8501,83541
8600000US83542,100,69,31,27250,32005,7472,83542
8600000US83543,596,333,263,48750,82330,13649,83543
8600000US83544,5060,2868,2192,45298,58721,4360,83544
8600000US83545,311,161,150,44167,46939,8036,83545
8600000US83546,387,203,184,37750,50927,10380,83546
8600000US83547,258,145,113,31000,38883,11522,83547
8600000US83548,86,49,37,47250,49937,9880,83548
8600000US83549,623,329,294,40172,55115,12571,83549
8600000US83552,732,328,404,32000,39353,7472,83552
8600000US83553,995,513,482,32088,42428,5007,83553
8600000US83554,372,205,167,54643,53261,14597,83554
8600000US83555,435,227,208,40417,51970,4740,83555
8600000US83601,11,11,0,,,,83601
8600000US83602,7,7,0,,,,83602
8600000US83604,402,203,199,50938,70986,22218,83604
8600000US83605,32081,15555,16526,45997,55614,3239,83605
8600000US83607,17393,8463,8930,52578,68586,6685,83607
8600000US83610,719,318,401,39000,66560,13503,83610
8600000US83611,1554,823,731,55664,72254,11799,83611
8600000US83612,1585,815,770,41458,55121,6744,83612
8600000US83615,1387,777,610,61250,70629,19341,83615
8600000US83616,21617,10571,11046,82874,119500,10882,83616
8600000US83617,12057,5971,6086,42615,51041,2970,83617
8600000US83619,5456,2450,3006,52004,72559,9637,83619
8600000US83622,1706,883,823,55000,71016,8402,83622
8600000US83623,1001,507,494,29297,40092,8261,83623
8600000US83624,945,487,458,46528,85758,40172,83624
8600000US83626,1014,466,548,50469,54241,7281,83626
8600000US83627,420,208,212,36620,43343,11467,83627
8600000US83628,3182,1644,1538,38468,47472,4490,83628
8600000US83629,1423,733,690,45625,62131,7884,83629
8600000US83631,747,362,385,41250,47061,9694,83631
8600000US83632,343,164,179,69792,67491,14257,83632
8600000US83633,500,258,242,58393,71232,16496,83633
8600000US83634,19882,12012,7870,66935,73039,5990,83634
8600000US83636,64,16,48,,,,83636
8600000US83637,149,69,80,31250,35664,12814,83637
8600000US83638,5624,2850,2774,54546,80622,19032,83638
8600000US83639,2508,1182,1326,41901,56964,7096,83639
8600000US83641,2395,1251,1144,46207,78296,18006,83641
8600000US83642,33284,16102,17182,68758,87391,8774,83642
8600000US83643,121,63,58,,53303,16812,83643
8600000US83644,7675,3579,4096,56021,72402,7063,83644
8600000US83645,643,316,327,43333,66348,12722,83645
8600000US83646,42082,19843,22239,69724,89579,7622,83646
8600000US83647,15333,8014,7319,48929,59843,4511,83647
8600000US83648,2257,1329,928,40638,48933,5709,83648
8600000US83650,446,261,185,47955,56400,17054,83650
8600000US83651,24336,11924,12412,43256,51867,2494,83651
8600000US83654,1220,645,575,48125,61017,8620,83654
8600000US83655,3191,1609,1582,47351,66169,9321,83655
8600000US83656,457,237,220,46250,50597,9794,83656
8600000US83657,207,97,110,45625,43859,10425,83657
8600000US83660,4542,2188,2354,48244,58860,6958,83660
8600000US83661,7462,3849,3613,51512,61164,6388,83661
8600000US83666,22,15,7,,41746,28237,83666
8600000US83669,7275,3456,3819,56875,83642,12754,83669
8600000US83670,368,190,178,48214,50745,13984,83670
8600000US83671,5,5,0,,,,83671
8600000US83672,6279,3115,3164,36420,48817,4321,83672
8600000US83676,3427,1743,1684,45795,64089,8544,83676
8600000US83677,0,0,0,,,,83677
8600000US83686,34880,16708,18172,51429,62134,2724,83686
8600000US83687,23750,12264,11486,50825,66593,6695,83687
8600000US83702,18211,9005,9206,61759,104534,7082,83702
8600000US83703,12633,6353,6280,57982,76590,6395,83703
8600000US83704,31620,15382,16238,49940,62876,3099,83704
8600000US83705,22227,11507,10720,46045,55777,2477,83705
8600000US83706,27386,14031,13355,46866,73787,5526,83706
8600000US83709,43521,21525,21996,72821,83694,3416,83709
8600000US83712,7718,3891,3827,82472,116001,7832,83712
8600000US83713,21661,10435,11226,64557,86528,7716,83713
8600000US83714,17248,8292,8956,53071,80586,6299,83714
8600000US83716,12475,6411,6064,91658,103761,6395,83716
8600000US83801,5566,2863,2703,54022,68897,8193,83801
8600000US83802,189,130,59,35000,34464,5931,83802
8600000US83803,867,492,375,,49529,18375,83803
8600000US83804,1467,646,821,53281,77953,28307,83804
8600000US83805,6157,3012,3145,45417,69775,10661,83805
8600000US83806,196,108,88,36667,43874,9366,83806
8600000US83808,102,58,44,28500,53129,52416,83808
8600000US83809,239,137,102,88375,90217,16100,83809
8600000US83810,763,457,306,48125,103473,63695,83810
8600000US83811,1074,549,525,24784,36023,5854,83811
8600000US83812,58,33,25,30625,43837,15446,83812
8600000US83813,892,472,420,67143,84783,29578,83813
8600000US83814,21264,10427,10837,50498,74722,4852,83814
8600000US83815,26207,12549,13658,53535,67321,3907,83815
8600000US83821,185,82,103,103194,125287,51265,83821
8600000US83822,1527,732,795,35893,42248,5029,83822
8600000US83823,1080,543,537,56906,59965,4111,83823
8600000US83824,228,94,134,31875,45051,13582,83824
8600000US83825,194,99,95,51250,68947,18522,83825
8600000US83826,0,0,0,,,,83826
8600000US83827,155,84,71,27344,39977,10110,83827
8600000US83830,304,124,180,33785,34671,9207,83830
8600000US83832,1079,524,555,65556,85305,13715,83832
8600000US83833,1332,636,696,68750,81254,9348,83833
8600000US83834,158,92,66,49773,46161,12281,83834
8600000US83835,16908,7751,9157,61334,86305,8097,83835
8600000US83836,701,378,323,50000,64317,14513,83836
8600000US83837,2365,1131,1234,36875,48069,4859,83837
8600000US83839,1015,519,496,42476,50580,8124,83839
8600000US83840,186,84,102,39531,44387,12529,83840
8600000US83841,275,161,114,41304,50394,17434,83841
8600000US83842,219,128,91,82500,80576,25695,83842
8600000US83843,22091,11196,10895,40760,59550,3352,83843
8600000US83844,1880,973,907,,,,83844
8600000US83845,1410,610,800,47321,54209,9830,83845
8600000US83846,594,299,295,41591,51387,5453,83846
8600000US83847,1242,731,511,35486,44818,9553,83847
8600000US83848,129,51,78,31250,44467,17633,83848
8600000US83849,1583,803,780,42653,49964,6256,83849
8600000US83850,1690,788,902,34896,70573,31390,83850
8600000US83851,1328,699,629,42000,50115,6070,83851
8600000US83852,679,285,394,35329,37150,5428,83852
8600000US83854,29955,14708,15247,53158,66200,3692,83854
8600000US83855,1662,830,832,42813,53406,6140,83855
8600000US83856,4758,2462,2296,42450,52254,4886,83856
8600000US83857,664,348,316,54792,79060,21260,83857
8600000US83858,11476,5836,5640,60714,80506,8117,83858
8600000US83860,5024,2648,2376,59600,77831,10704,83860
8600000US83861,5159,2617,2542,51085,63492,5859,83861
8600000US83864,14443,6895,7548,53166,70903,7363,83864
8600000US83866,50,33,17,,,,83866
8600000US83867,485,227,258,64750,84668,28648,83867
8600000US83868,645,327,318,35545,40186,7614,83868
8600000US83869,4049,2125,1924,50788,71393,17003,83869
8600000US83870,266,123,143,31250,43493,7179,83870
8600000US83871,1532,777,755,60313,75571,6623,83871
8600000US83872,450,223,227,84643,126224,34435,83872
8600000US83873,1229,633,596,37326,47743,6936,83873
8600000US83874,0,0,0,,,,83874
8600000US83876,1433,731,702,57014,66536,5687,83876
8600000US84001,448,217,231,74792,78068,9996,84001
8600000US84002,208,103,105,110250,116355,35165,84002
8600000US84003,30671,15554,15117,87140,112868,4777,84003
8600000US84004,6786,3347,3439,122202,164660,14668,84004
8600000US84005,15624,7887,7737,78415,87757,3954,84005
8600000US84006,801,380,421,70729,70256,13402,84006
8600000US84007,478,247,231,74653,89434,13967,84007
8600000US84010,32688,15995,16693,71257,92989,3824,84010
8600000US84013,693,379,314,72500,97296,17986,84013
8600000US84014,11961,5696,6265,90596,111263,10087,84014
8600000US84015,43942,21561,22381,68060,78513,2342,84015
8600000US84017,3027,1563,1464,77422,89286,7319,84017
8600000US84018,76,37,39,198897,172634,67214,84018
8600000US84020,32313,16900,15413,115618,149514,7911,84020
8600000US84021,2728,1486,1242,52862,60332,4528,84021
8600000US84022,451,237,214,70441,89014,18171,84022
8600000US84023,166,116,50,82500,74955,17311,84023
8600000US84024,47,30,17,,,,84024
8600000US84025,14946,7684,7262,102598,119386,8521,84025
8600000US84026,1024,393,631,47083,49927,8340,84026
8600000US84027,391,205,186,41765,52389,9244,84027
8600000US84028,476,254,222,44816,62748,15977,84028
8600000US84029,6623,3443,3180,69809,80374,6266,84029
8600000US84031,172,107,65,82639,84424,17480,84031
8600000US84032,14966,7694,7272,75424,95113,6814,84032
8600000US84033,827,458,369,77167,94040,11872,84033
8600000US84034,112,46,66,33000,41166,19902,84034
8600000US84035,275,159,116,,90283,57479,84035
8600000US84036,5103,2684,2419,79792,105486,9395,84036
8600000US84037,24620,12248,12372,95941,113210,5760,84037
8600000US84038,203,89,114,67500,96307,26406,84038
8600000US84039,581,306,275,79286,177636,83817,84039
8600000US84040,17127,8528,8599,93182,111179,5246,84040
8600000US84041,33776,17066,16710,67103,77556,3459,84041
8600000US84042,7068,3454,3614,85945,108263,7892,84042
8600000US84043,35946,17881,18065,88582,102899,3903,84043
8600000US84044,18875,8895,9980,59334,66697,2513,84044
8600000US84045,14387,7340,7047,98595,107244,5404,84045
8600000US84046,313,197,116,81250,80380,19317,84046
8600000US84047,24619,12243,12376,56487,68452,3352,84047
8600000US84049,3875,1802,2073,75451,98543,13393,84049
8600000US84050,7252,3586,3666,89083,110117,8039,84050
8600000US84051,313,162,151,81500,79238,11568,84051
8600000US84052,968,481,487,56597,61660,7419,84052
8600000US84053,671,314,357,64107,79549,16515,84053
8600000US84054,13830,6842,6988,80179,100323,6180,84054
8600000US84055,1023,555,468,77292,80344,11226,84055
8600000US84056,2199,1255,944,50857,60071,5961,84056
8600000US84057,27887,13818,14069,56668,72551,4055,84057
8600000US84058,27352,13998,13354,61516,74874,3032,84058
8600000US84060,6849,3546,3303,105636,158125,19630,84060
8600000US84061,284,184,100,58889,67171,16875,84061
8600000US84062,31126,15307,15819,74086,91109,3781,84062
8600000US84063,140,60,80,55972,310822,265789,84063
8600000US84064,582,281,301,56042,78437,17096,84064
8600000US84065,27564,13783,13781,101604,119099,4838,84065
8600000US84066,8003,4041,3962,66390,75661,3669,84066
8600000US84067,26814,13639,13175,68458,75329,2213,84067
8600000US84069,402,191,211,69091,87814,28885,84069
8600000US84070,21162,10156,11006,67853,78017,3587,84070
8600000US84071,813,366,447,72269,79619,9492,84071
8600000US84072,292,144,148,51458,56430,8386,84072
8600000US84073,173,83,90,105417,93561,29257,84073
8600000US84074,34064,16902,17162,72841,80209,3112,84074
8600000US84075,17757,8986,8771,94368,107402,6142,84075
8600000US84076,265,131,134,79250,83009,12749,84076
8600000US84078,19951,10146,9805,67627,77406,4547,84078
8600000US84080,201,98,103,61375,65305,16573,84080
8600000US84081,30287,15190,15097,89667,99031,4507,84081
8600000US84082,637,345,292,104205,156265,86618,84082
8600000US84083,801,417,384,30583,38697,6221,84083
8600000US84084,27551,13912,13639,70643,81040,3782,84084
8600000US84085,293,141,152,44500,137873,113724,84085
8600000US84086,235,84,151,46607,70953,23151,84086
8600000US84087,11062,5446,5616,86458,93258,4374,84087
8600000US84088,26661,13107,13554,70677,84005,4417,84088
8600000US84092,21911,11112,10799,118418,147913,7818,84092
8600000US84093,17358,8814,8544,103864,130590,6741,84093
8600000US84094,21309,10197,11112,83060,90527,3118,84094
8600000US84095,46022,22385,23637,103307,126087,5267,84095
8600000US84096,28100,13484,14616,99255,111442,6309,84096
8600000US84097,15367,7653,7714,76085,98662,4870,84097
8600000US84098,14233,6935,7298,129150,178511,12436,84098
8600000US84101,4376,2650,1726,42258,64357,9272,84101
8600000US84102,16827,9581,7246,42750,65727,4980,84102
8600000US84103,18901,9518,9383,65914,112114,7251,84103
8600000US84104,18026,8914,9112,45325,55720,3482,84104
8600000US84105,18410,9179,9231,76059,105524,6491,84105
8600000US84106,27705,13664,14041,69097,84940,4275,84106
8600000US84107,26917,12858,14059,53965,66976,2683,84107
8600000US84108,17364,8608,8756,103586,141422,8740,84108
8600000US84109,18555,9191,9364,91746,118534,6506,84109
8600000US84111,10581,5945,4636,36518,55951,4533,84111
8600000US84112,1987,1128,859,,21764,10903,84112
8600000US84113,248,135,113,,,,84113
8600000US84115,20694,9946,10748,41924,54613,4197,84115
8600000US84116,24505,13038,11467,46059,57427,3736,84116
8600000US84117,19960,9236,10724,67106,103552,6899,84117
8600000US84118,50182,24688,25494,67726,78482,2627,84118
8600000US84119,38816,20611,18205,53166,63814,2778,84119
8600000US84120,36241,18171,18070,66118,75012,2475,84120
8600000US84121,32309,15437,16872,85765,117363,6815,84121
8600000US84123,28857,14038,14819,56277,68124,2471,84123
8600000US84124,16556,7865,8691,87109,123778,7565,84124
8600000US84128,17279,8575,8704,73703,78162,3827,84128
8600000US84144,363,196,167,120208,191279,81189,84144
8600000US84180,0,0,0,,,,84180
8600000US84301,530,278,252,59028,69162,7035,84301
8600000US84302,17703,8716,8987,56257,71726,4054,84302
8600000US84304,0,0,0,,,,84304
8600000US84305,529,281,248,75000,81545,12522,84305
8600000US84306,293,132,161,73950,102168,38024,84306
8600000US84307,798,423,375,63125,73875,10815,84307
8600000US84308,171,63,108,53125,87044,29774,84308
8600000US84309,322,160,162,69583,77489,14783,84309
8600000US84310,3129,1660,1469,95451,106395,13092,84310
8600000US84311,429,227,202,65688,68675,10623,84311
8600000US84312,3095,1564,1531,64290,74236,7219,84312
8600000US84313,83,34,49,58333,48800,8519,84313
8600000US84314,757,383,374,91016,92720,10436,84314
8600000US84315,6045,3057,2988,99244,104097,9427,84315
8600000US84316,190,100,90,41500,65511,23265,84316
8600000US84317,1692,890,802,74375,116398,24337,84317
8600000US84318,2926,1414,1512,76917,86129,7391,84318
8600000US84319,5000,2510,2490,63309,76522,9730,84319
8600000US84320,1713,909,804,55086,66374,7079,84320
8600000US84321,34273,17203,17070,44958,60419,2707,84321
8600000US84324,499,256,243,91875,97077,12626,84324
8600000US84325,1493,728,765,81406,97960,13017,84325
8600000US84326,1249,617,632,78112,81570,10860,84326
8600000US84327,549,279,270,62054,76182,9331,84327
8600000US84328,1141,568,573,76563,90348,9451,84328
8600000US84329,69,31,38,,,,84329
8600000US84330,233,109,124,59028,63962,8548,84330
8600000US84331,197,97,100,61250,79870,31419,84331
8600000US84332,5083,2392,2691,78015,101183,11623,84332
8600000US84333,1896,984,912,54702,69028,6852,84333
8600000US84334,164,86,78,66955,74836,11712,84334
8600000US84335,8101,3894,4207,66045,77404,4210,84335
8600000US84336,146,71,75,45938,59405,13075,84336
8600000US84337,7694,4112,3582,55972,65208,4054,84337
8600000US84338,271,133,138,51719,60147,11343,84338
8600000US84339,3352,1733,1619,82840,90558,7279,84339
8600000US84340,2656,1225,1431,78824,91076,10403,84340
8600000US84341,16991,8398,8593,51833,72679,4858,84341
8600000US84401,28018,14549,13469,50477,63988,3532,84401
8600000US84403,28036,13502,14534,63332,85443,5161,84403
8600000US84404,43987,22420,21567,60098,68802,2149,84404
8600000US84405,23354,10911,12443,64136,77933,3300,84405
8600000US84414,20410,10086,10324,83892,95278,3683,84414
8600000US84501,9614,4723,4891,51095,60092,3153,84501
8600000US84511,2847,1385,1462,59097,74899,12205,84511
8600000US84512,572,291,281,41071,47048,8661,84512
8600000US84513,1000,491,509,48854,60378,7304,84513
8600000US84515,0,0,0,,,,84515
8600000US84516,132,68,64,64583,81809,20638,84516
8600000US84518,521,210,311,71417,72710,14710,84518
8600000US84520,821,402,419,28611,42400,8202,84520
8600000US84521,584,291,293,71029,80347,13590,84521
8600000US84522,227,126,101,45625,53291,7247,84522
8600000US84523,1282,665,617,50341,56831,6150,84523
8600000US84525,705,331,374,39800,57627,9104,84525
8600000US84526,2978,1507,1471,55817,66046,8307,84526
8600000US84528,1721,911,810,50304,60483,6231,84528
8600000US84529,230,91,139,54053,93242,60572,84529
8600000US84530,328,69,259,,53478,23260,84530
8600000US84531,621,313,308,28438,32979,5828,84531
8600000US84532,7876,3892,3984,48508,57888,4794,84532
8600000US84533,187,133,54,34219,42260,10817,84533
8600000US84534,1892,950,942,30109,42901,4085,84534
8600000US84535,2203,1151,1052,63047,75555,10542,84535
8600000US84536,1270,611,659,23315,30983,4749,84536
8600000US84537,958,493,465,58125,66247,6425,84537
8600000US84539,208,89,119,55417,58049,11330,84539
8600000US84540,111,87,24,,,,84540
8600000US84542,1074,491,583,42436,50233,6505,84542
8600000US84601,24110,12419,11691,48144,61709,6790,84601
8600000US84604,36413,17538,18875,55293,84407,3962,84604
8600000US84606,30062,14986,15076,36505,51815,2909,84606
8600000US84620,678,331,347,64286,79257,11462,84620
8600000US84621,66,47,19,38854,41002,7553,84621
8600000US84622,1198,559,639,58529,59600,7588,84622
8600000US84623,222,100,122,31534,28731,15684,84623
8600000US84624,3946,1979,1967,63306,73556,7691,84624
8600000US84626,119,50,69,80250,87759,15786,84626
8600000US84627,5278,2341,2937,40401,57389,5649,84627
8600000US84628,423,218,205,55714,61888,9965,84628
8600000US84629,1960,814,1146,68860,86991,20760,84629
8600000US84630,258,115,143,58125,82681,25217,84630
8600000US84631,2175,1157,1018,54250,91932,29639,84631
8600000US84632,854,382,472,55000,62590,8470,84632
8600000US84633,883,427,456,61307,65097,8923,84633
8600000US84634,2913,2511,402,64485,64540,8352,84634
8600000US84635,525,260,265,61813,67100,9056,84635
8600000US84636,325,166,159,51250,63453,11544,84636
8600000US84637,549,312,237,53000,61827,9031,84637
8600000US84638,185,88,97,60417,82157,25937,84638
8600000US84639,692,343,349,53036,69014,11512,84639
8600000US84640,69,43,26,50833,56221,16142,84640
8600000US84642,2500,1223,1277,47708,60212,5075,84642
8600000US84643,306,148,158,46591,53824,8448,84643
8600000US84645,1639,848,791,79674,85930,8972,84645
8600000US84646,1162,523,639,59450,67427,9446,84646
8600000US84647,3272,1818,1454,43984,50723,4609,84647
8600000US84648,4229,2094,2135,61913,69011,5507,84648
8600000US84649,637,316,321,76406,79964,8879,84649
8600000US84651,16584,8190,8394,67128,77032,3179,84651
8600000US84652,606,294,312,53162,74128,14165,84652
8600000US84653,5773,2989,2784,92038,109560,9705,84653
8600000US84654,1934,1030,904,50208,56864,7311,84654
8600000US84655,7407,3911,3496,71759,79794,4335,84655
8600000US84656,240,120,120,74375,72603,9584,84656
8600000US84657,458,211,247,59500,56917,9290,84657
8600000US84660,25796,13261,12535,73631,88626,3755,84660
8600000US84662,1078,508,570,62611,69943,8685,84662
8600000US84663,20879,10178,10701,66929,81407,3852,84663
8600000US84664,5991,2978,3013,109602,128651,9756,84664
8600000US84665,453,282,171,82917,71674,13819,84665
8600000US84667,253,116,137,55208,73013,16663,84667
8600000US84701,5927,2957,2970,45580,59202,5223,84701
8600000US84710,83,51,32,48750,54486,14994,84710
8600000US84711,496,271,225,66250,76460,10002,84711
8600000US84712,88,52,36,38125,44549,7804,84712
8600000US84713,2325,1167,1158,52546,65274,8121,84713
8600000US84714,344,201,143,39844,42074,10783,84714
8600000US84715,242,122,120,68393,74749,14970,84715
8600000US84716,235,133,102,48125,56629,20383,84716
8600000US84718,238,109,129,63333,69396,10911,84718
8600000US84719,63,33,30,,52594,20063,84719
8600000US84720,15834,8235,7599,46154,61674,4512,84720
8600000US84721,15343,7241,8102,47463,64088,6089,84721
8600000US84722,578,323,255,45000,51195,7157,84722
8600000US84723,586,275,311,50875,56928,9433,84723
8600000US84724,897,433,464,52500,64291,15975,84724
8600000US84725,1071,510,561,58938,63979,8169,84725
8600000US84726,727,359,368,43950,69946,21337,84726
8600000US84728,39,19,20,91071,93685,31896,84728
8600000US84729,176,88,88,33438,46162,13188,84729
8600000US84730,191,110,81,88750,96387,26930,84730
8600000US84731,141,73,68,65000,62307,8599,84731
8600000US84732,33,18,15,,76086,36180,84732
8600000US84733,125,53,72,,62404,27237,84733
8600000US84734,224,118,106,39000,46621,9054,84734
8600000US84735,193,99,94,55179,60725,14057,84735
8600000US84736,189,101,88,59464,62234,12760,84736
8600000US84737,13102,6788,6314,53298,62482,4491,84737
8600000US84738,6464,2909,3555,57458,78714,10859,84738
8600000US84739,426,235,191,49479,75746,23742,84739
8600000US84740,143,89,54,32500,36941,12825,84740
8600000US84741,4632,2245,2387,48107,64500,6933,84741
8600000US84742,192,91,101,60833,63397,16986,84742
8600000US84743,16,1,15,,,,84743
8600000US84744,181,95,86,36705,45521,11410,84744
8600000US84745,2864,1475,1389,51437,55698,5104,84745
8600000US84746,842,406,436,47288,79021,22080,84746
8600000US84747,864,515,349,44375,57770,9041,84747
8600000US84749,218,99,119,75865,84767,16686,84749
8600000US84750,656,378,278,38056,48604,9345,84750
8600000US84751,1323,683,640,58000,65159,7141,84751
8600000US84752,669,337,332,53036,60794,8975,84752
8600000US84753,8,8,0,,,,84753
8600000US84754,2783,1386,1397,59648,69005,4121,84754
8600000US84755,35,15,20,72917,70757,38762,84755
8600000US84756,349,166,183,56481,52529,14482,84756
8600000US84757,877,420,457,56641,60179,8085,84757
8600000US84758,413,180,233,59688,64776,10124,84758
8600000US84759,1447,766,681,43750,62557,11798,84759
8600000US84760,401,184,217,63036,69264,14433,84760
8600000US84761,2468,1243,1225,42171,60129,7095,84761
8600000US84762,197,97,100,,93557,50484,84762
8600000US84763,291,122,169,46250,65128,15868,84763
8600000US84764,194,93,101,66065,71717,14575,84764
8600000US84765,4552,2185,2367,84175,102314,13045,84765
8600000US84766,197,89,108,41750,59130,19109,84766
8600000US84767,496,265,231,58092,76717,22227,84767
8600000US84770,31018,15000,16018,51123,67291,4242,84770
8600000US84772,215,110,105,41250,58995,19764,84772
8600000US84773,183,80,103,40577,47669,18514,84773
8600000US84774,1339,651,688,77821,112301,37196,84774
8600000US84775,262,101,161,29702,39359,8798,84775
8600000US84776,449,207,242,60625,63812,6161,84776
8600000US84779,469,215,254,65313,66550,12875,84779
8600000US84780,17173,8429,8744,57740,90052,16499,84780
8600000US84781,170,90,80,,78240,32277,84781
8600000US84782,770,367,403,81496,81150,10735,84782
8600000US84783,764,369,395,47045,72121,25426,84783
8600000US84784,1171,499,672,57941,60746,15993,84784
8600000US84790,32744,15877,16867,59861,77540,4106,84790
8600000US85003,7412,4349,3063,42936,75886,7383,85003
8600000US85004,6097,3117,2980,35739,66790,11296,85004
8600000US85006,20443,10833,9610,35597,50600,2870,85006
8600000US85007,10802,5360,5442,32964,58574,9647,85007
8600000US85008,45802,23611,22191,39996,49447,1657,85008
8600000US85009,34860,19396,15464,30760,45055,3331,85009
8600000US85012,5951,2957,2994,67230,101805,10880,85012
8600000US85013,17334,9013,8321,55585,83906,6074,85013
8600000US85014,22415,11498,10917,50107,68171,4879,85014
8600000US85015,28529,14355,14174,34636,48161,2959,85015
8600000US85016,28878,14465,14413,56423,91185,7877,85016
8600000US85017,28135,13351,14784,32237,43072,2722,85017
8600000US85018,30675,15298,15377,66150,114270,7228,85018
8600000US85019,18329,9158,9171,38363,46034,3104,85019
8600000US85020,27680,13334,14346,53091,79494,4318,85020
8600000US85021,31186,15416,15770,42266,67878,4211,85021
8600000US85022,41897,19647,22250,55614,76933,3155,85022
8600000US85023,26292,13304,12988,55644,75850,4262,85023
8600000US85024,18869,9532,9337,72688,88875,5077,85024
8600000US85027,29164,14608,14556,56184,65355,2504,85027
8600000US85028,15591,7135,8456,89110,114539,6564,85028
8600000US85029,35415,17665,17750,47365,57916,2673,85029
8600000US85031,21457,10925,10532,35706,42765,3375,85031
8600000US85032,56583,28162,28421,54161,69008,2194,85032
8600000US85033,42429,20330,22099,39443,49555,1990,85033
8600000US85034,3396,1518,1878,27391,38393,3377,85034
8600000US85035,38774,18890,19884,41396,50359,2774,85035
8600000US85037,37565,18583,18982,56370,63780,2768,85037
8600000US85040,24023,11931,12092,38543,46984,2263,85040
8600000US85041,42246,20389,21857,53597,66221,3148,85041
8600000US85042,33900,17066,16834,53824,69671,3031,85042
8600000US85043,25475,12332,13143,50873,61319,3274,85043
8600000US85044,32659,15197,17462,73789,101785,4152,85044
8600000US85045,5272,2529,2743,138777,154212,8565,85045
8600000US85048,26529,13131,13398,102494,129409,7487,85048
8600000US85050,22352,10613,11739,89489,124145,6678,85050
8600000US85051,32348,15970,16378,42080,55572,2653,85051
8600000US85053,23623,11595,12028,53142,64552,4012,85053
8600000US85054,6247,3156,3091,88867,108304,10230,85054
8600000US85083,13758,6749,7009,109750,125619,6200,85083
8600000US85085,16399,8011,8388,87058,113618,8111,85085
8600000US85086,32313,15634,16679,99982,124158,8282,85086
8600000US85087,6589,3275,3314,71295,87864,7630,85087
8600000US85118,12142,5949,6193,64449,101084,19047,85118
8600000US85119,19336,9229,10107,48961,60066,3592,85119
8600000US85120,26444,12562,13882,41386,52433,3815,85120
8600000US85121,1172,616,556,8939,20452,7454,85121
8600000US85122,41837,20096,21741,48289,60775,3020,85122
8600000US85123,8803,4103,4700,42418,53665,7793,85123
8600000US85128,12225,5966,6259,45601,56310,4343,85128
8600000US85131,16804,12758,4046,38142,51214,4159,85131
8600000US85132,31749,23454,8295,54673,63737,4152,85132
8600000US85135,396,175,221,38375,37015,7783,85135
8600000US85137,1942,1012,930,53125,62219,9043,85137
8600000US85138,26286,12796,13490,71176,81144,3309,85138
8600000US85139,13268,6404,6864,56280,65662,4904,85139
8600000US85140,32610,16286,16324,69648,81287,3596,85140
8600000US85141,363,201,162,39464,51844,15390,85141
8600000US85142,43550,21624,21926,84344,102252,4017,85142
8600000US85143,26791,12568,14223,62511,71413,4145,85143
8600000US85145,2180,1046,1134,69107,69779,8034,85145
8600000US85147,2754,1659,1095,12467,24879,6185,85147
8600000US85172,1401,718,683,57404,65324,18683,85172
8600000US85173,2502,1094,1408,30439,45474,4902,85173
8600000US85192,1601,898,703,49063,52588,8229,85192
8600000US85193,3901,2175,1726,35136,55510,14444,85193
8600000US85194,6097,3011,3086,55788,69080,5051,85194
8600000US85201,38573,19132,19441,38180,48816,2230,85201
8600000US85202,30708,15397,15311,48465,65907,3645,85202
8600000US85203,28230,14041,14189,50953,71233,2951,85203
8600000US85204,50082,24335,25747,50801,60975,2321,85204
8600000US85205,33797,15592,18205,52936,71988,3267,85205
8600000US85206,29757,14049,15708,50741,67774,5443,85206
8600000US85207,38174,19139,19035,70213,94385,4145,85207
8600000US85208,31004,15511,15493,50092,63716,3626,85208
8600000US85209,31606,15008,16598,61619,78263,3644,85209
8600000US85210,29792,15054,14738,40811,53031,2445,85210
8600000US85212,23344,11378,11966,89325,108466,6898,85212
8600000US85213,27596,13236,14360,65278,92463,5586,85213
8600000US85215,14391,6774,7617,70715,97216,7692,85215
8600000US85224,33966,16419,17547,69846,86711,4595,85224
8600000US85225,52901,26952,25949,61078,75763,2951,85225
8600000US85226,29501,14210,15291,85308,103515,4386,85226
8600000US85233,26872,12621,14251,85419,102581,4693,85233
8600000US85234,35512,16946,18566,83210,103122,4995,85234
8600000US85248,28724,13595,15129,72489,100607,4493,85248
8600000US85249,27751,13168,14583,107333,128916,4664,85249
8600000US85250,15208,6936,8272,72238,102380,8847,85250
8600000US85251,35232,17724,17508,61379,99081,6484,85251
8600000US85253,15172,7387,7785,156655,273722,21418,85253
8600000US85254,36187,17338,18849,91605,121257,5084,85254
8600000US85255,33230,16150,17080,126991,181753,8630,85255
8600000US85256,4223,2081,2142,36868,50872,10604,85256
8600000US85257,29198,15569,13629,63037,80477,4857,85257
8600000US85258,21741,9935,11806,84334,123354,7373,85258
8600000US85259,18656,8678,9978,108647,170607,15347,85259
8600000US85260,31551,14679,16872,84585,118432,5801,85260
8600000US85262,10419,5396,5023,119498,191975,18061,85262
8600000US85263,2555,1289,1266,91250,117698,17347,85263
8600000US85264,1002,482,520,63654,126077,62624,85264
8600000US85266,11149,5543,5606,136573,176336,12245,85266
8600000US85268,21773,9949,11824,81568,120393,11233,85268
8600000US85281,59508,33246,26262,35682,49843,2350,85281
8600000US85282,45142,24528,20614,53475,65954,2448,85282
8600000US85283,40925,20097,20828,62663,76389,2833,85283
8600000US85284,15041,7372,7669,111420,145858,9908,85284
8600000US85286,30151,14871,15280,100609,122755,5869,85286
8600000US85295,30884,14635,16249,94652,110318,4186,85295
8600000US85296,29873,14593,15280,92731,108703,4475,85296
8600000US85297,21017,10022,10995,102210,116513,5551,85297
8600000US85298,21365,10210,11155,105826,119622,6056,85298
8600000US85301,46394,22445,23949,31410,42710,2175,85301
8600000US85302,30707,15000,15707,45556,60386,5282,85302
8600000US85303,23400,11026,12374,54874,67597,4248,85303
8600000US85304,21660,9926,11734,65073,73130,3238,85304
8600000US85305,9913,5062,4851,71080,85697,6580,85305
8600000US85306,20038,9577,10461,61439,71235,3159,85306
8600000US85307,7695,3601,4094,56327,66562,3865,85307
8600000US85308,52873,25473,27400,76116,92259,3064,85308
8600000US85309,681,598,83,,,,85309
8600000US85310,15248,7420,7828,102326,119488,7710,85310
8600000US85320,1133,757,376,30729,54735,15289,85320
8600000US85321,3368,1707,1661,32635,41828,5748,85321
8600000US85322,540,304,236,37266,51003,10862,85322
8600000US85323,29789,14604,15185,51339,59941,2661,85323
8600000US85324,2888,1535,1353,38796,49250,8159,85324
8600000US85325,1139,593,546,42275,52290,7793,85325
8600000US85326,43538,24552,18986,59477,69008,2649,85326
8600000US85328,216,104,112,39071,54675,27398,85328
8600000US85331,23537,11135,12402,103800,126391,6142,85331
8600000US85332,1408,717,691,39063,44957,6937,85332
8600000US85333,550,276,274,46346,51808,11569,85333
8600000US85334,847,514,333,31023,48026,10458,85334
8600000US85335,23812,11518,12294,54646,64332,2624,85335
8600000US85336,359,143,216,32351,40427,6835,85336
8600000US85337,1770,935,835,31000,48978,8411,85337
8600000US85338,34889,17246,17643,74517,87962,4055,85338
8600000US85339,30786,14296,16490,70759,84456,4387,85339
8600000US85340,24047,11805,12242,91710,106679,3981,85340
8600000US85341,0,0,0,,,,85341
8600000US85342,1292,605,687,41150,59018,15687,85342
8600000US85343,168,129,39,49150,56232,16868,85343
8600000US85344,8160,4083,4077,40685,54263,5436,85344
8600000US85345,42660,20751,21909,51726,62079,2482,85345
8600000US85346,4224,2199,2025,24732,37964,9299,85346
8600000US85347,526,269,257,32768,40856,7736,85347
8600000US85348,2137,1058,1079,40739,42002,6402,85348
8600000US85349,20892,10913,9979,34166,47845,5301,85349
8600000US85350,15543,8759,6784,38384,52179,4307,85350
8600000US85351,28992,11699,17293,38253,49534,2617,85351
8600000US85352,430,271,159,31591,41531,10215,85352
8600000US85353,27799,13204,14595,64904,72568,3580,85353
8600000US85354,5531,2898,2633,56462,60375,5491,85354
8600000US85355,8947,4088,4859,91046,105051,9590,85355
8600000US85356,4078,2119,1959,50682,61267,9387,85356
8600000US85357,294,138,156,23194,37076,15135,85357
8600000US85360,137,76,61,51875,57702,20082,85360
8600000US85361,4323,2174,2149,56853,71735,9828,85361
8600000US85362,664,302,362,40962,45145,6868,85362
8600000US85363,5007,2530,2477,41441,52476,7001,85363
8600000US85364,54301,27196,27105,42444,57992,2718,85364
8600000US85365,38528,20148,18380,51799,66870,2865,85365
8600000US85367,19417,9722,9695,47243,59262,3076,85367
8600000US85371,271,115,156,21938,31035,10388,85371
8600000US85373,16352,7254,9098,53247,65267,3266,85373
8600000US85374,40445,18464,21981,54364,66705,2673,85374
8600000US85375,28282,12815,15467,50223,64461,3729,85375
8600000US85377,3153,1655,1498,91393,135377,34324,85377
8600000US85379,33494,16026,17468,77495,86950,3570,85379
8600000US85381,20786,9788,10998,78810,91472,4943,85381
8600000US85382,30832,14125,16707,69833,82101,2664,85382
8600000US85383,35253,16582,18671,112701,134262,5108,85383
8600000US85387,9759,4662,5097,70066,79710,4591,85387
8600000US85388,19849,9582,10267,77700,91244,7612,85388
8600000US85390,7922,3420,4502,48519,73538,10438,85390
8600000US85392,28338,14120,14218,67388,81377,2977,85392
8600000US85395,23975,10195,13780,88792,107357,6058,85395
8600000US85396,13599,6548,7051,87275,100429,6636,85396
8600000US85501,10085,5152,4933,42294,54816,4145,85501
8600000US85530,1191,579,612,28500,38295,10149,85530
8600000US85531,287,156,131,73426,82132,30098,85531
8600000US85533,2516,1320,1196,47956,60493,7962,85533
8600000US85534,2103,1008,1095,48567,74042,14764,85534
8600000US85535,0,0,0,,,,85535
8600000US85536,316,153,163,59519,59430,12125,85536
8600000US85539,3557,1621,1936,43324,52597,8334,85539
8600000US85540,2211,1166,1045,74796,82404,6163,85540
8600000US85541,18722,9006,9716,45928,60796,4210,85541
8600000US85542,2156,922,1234,34875,46434,7871,85542
8600000US85543,2497,1173,1324,50888,60211,6411,85543
8600000US85544,2246,1074,1172,52825,57972,7316,85544
8600000US85545,496,270,226,30714,29900,7749,85545
8600000US85546,15645,9056,6589,52013,58758,2930,85546
8600000US85550,3081,1488,1593,31310,47197,6850,85550
8600000US85551,327,170,157,61818,65614,15656,85551
8600000US85552,4704,2289,2415,54429,65608,6114,85552
8600000US85553,1419,811,608,29000,41822,7483,85553
8600000US85554,548,329,219,38021,45623,8190,85554
8600000US85601,636,357,279,33289,53216,23426,85601
8600000US85602,7402,3639,3763,37714,51930,4714,85602
8600000US85603,5464,2558,2906,33964,45250,3196,85603
8600000US85605,430,205,225,26525,38241,5878,85605
8600000US85606,885,430,455,43846,53941,12359,85606
8600000US85607,10963,5172,5791,35735,47014,4159,85607
8600000US85608,4978,4978,0,,,,85608
8600000US85609,199,97,102,108281,133793,68395,85609
8600000US85610,808,439,369,40000,49211,6840,85610
8600000US85611,790,328,462,53750,83571,21698,85611
8600000US85613,4036,2656,1380,64715,75611,6778,85613
8600000US85614,21882,9704,12178,51083,66505,3153,85614
8600000US85615,7626,3681,3945,65300,79115,10032,85615
8600000US85616,4240,1921,2319,41320,51207,4524,85616
8600000US85617,1014,546,468,29244,47284,8113,85617
8600000US85618,1491,771,720,37266,42572,5199,85618
8600000US85619,60,27,33,,54145,25520,85619
8600000US85620,452,170,282,26802,38755,9398,85620
8600000US85621,15621,7380,8241,29343,48936,7032,85621
8600000US85622,6217,2889,3328,59280,79743,7088,85622
8600000US85623,4265,2215,2050,53250,62067,5597,85623
8600000US85624,1042,534,508,38702,52057,8107,85624
8600000US85625,1813,852,961,39769,49656,7253,85625
8600000US85626,771,374,397,31707,38520,9202,85626
8600000US85627,856,406,450,56917,72945,14699,85627
8600000US85629,17399,8054,9345,80599,87374,3808,85629
8600000US85630,1626,754,872,41484,57863,14913,85630
8600000US85631,2939,1451,1488,43217,46283,5493,85631
8600000US85632,696,363,333,42083,59313,10411,85632
8600000US85633,39,22,17,,44108,26448,85633
8600000US85634,4393,2046,2347,23878,36091,3834,85634
8600000US85635,25755,12073,13682,53371,67507,3540,85635
8600000US85637,1071,517,554,62163,89948,19359,85637
8600000US85638,1625,752,873,35926,44110,5703,85638
8600000US85640,174,88,86,,93594,74585,85640
8600000US85641,18895,9433,9462,87384,101619,4804,85641
8600000US85643,6566,3694,2872,41781,49560,5145,85643
8600000US85645,1908,860,1048,42446,51919,7789,85645
8600000US85646,1242,672,570,57340,84382,18309,85646
8600000US85648,14110,6478,7632,49456,64700,6471,85648
8600000US85650,12076,5598,6478,67895,83598,4891,85650
8600000US85653,12827,6637,6190,61834,68499,4084,85653
8600000US85654,0,0,0,,,,85654
8600000US85658,9821,4682,5139,87938,110183,7702,85658
8600000US85701,4430,2330,2100,42344,62762,8189,85701
8600000US85704,27097,12468,14629,55891,79341,4262,85704
8600000US85705,44657,22294,22363,27657,41062,2656,85705
8600000US85706,37777,17375,20402,34132,43337,1725,85706
8600000US85707,665,567,98,,,,85707
8600000US85708,2318,1112,1206,54904,61263,5565,85708
8600000US85710,43988,20600,23388,41814,55569,2285,85710
8600000US85711,31071,14934,16137,39085,52008,2337,85711
8600000US85712,27365,12854,14511,36215,50226,2678,85712
8600000US85713,36299,18317,17982,36296,45913,2213,85713
8600000US85714,11083,5119,5964,28977,40561,4233,85714
8600000US85715,14382,6942,7440,67134,87921,4393,85715
8600000US85716,25531,12384,13147,40274,58202,4211,85716
8600000US85718,22253,10796,11457,85508,138252,7993,85718
8600000US85719,43755,23401,20354,31975,47762,2853,85719
8600000US85723,0,0,0,,,,85723
8600000US85724,0,0,0,,,,85724
8600000US85726,0,0,0,,,,85726
8600000US85730,29791,14320,15471,51622,64729,3529,85730
8600000US85735,9122,4466,4656,44338,54888,4048,85735
8600000US85736,3961,1925,2036,43517,55045,7804,85736
8600000US85737,17961,8629,9332,76922,100766,7283,85737
8600000US85739,16262,7993,8269,66362,82236,5578,85739
8600000US85741,27767,13112,14655,59087,67727,2344,85741
8600000US85742,21196,10191,11005,75603,91977,4783,85742
8600000US85743,23194,11130,12064,73507,92745,5183,85743
8600000US85745,32396,15544,16852,51364,72756,4432,85745
8600000US85746,31520,14645,16875,47202,58377,3369,85746
8600000US85747,17853,8458,9395,85701,95156,4052,85747
8600000US85748,14956,7142,7814,73410,94649,6831,85748
8600000US85749,15696,7659,8037,87229,117530,6646,85749
8600000US85750,20493,9595,10898,76467,117597,7530,85750
8600000US85755,13608,6534,7074,90541,111782,6562,85755
8600000US85756,31893,19769,12124,50785,61437,3378,85756
8600000US85757,13523,6705,6818,52981,61245,4235,85757
8600000US85901,14238,6881,7357,48223,61110,4870,85901
8600000US85911,1256,591,665,17262,24600,5200,85911
8600000US85912,292,155,137,21875,28083,9954,85912
8600000US85920,391,199,192,70417,76360,16422,85920
8600000US85922,37,12,25,,64174,38541,85922
8600000US85923,341,167,174,37868,45327,13949,85923
8600000US85924,2418,1284,1134,38922,52523,8654,85924
8600000US85925,3369,1813,1556,63359,67259,6978,85925
8600000US85926,315,132,183,41591,59795,18485,85926
8600000US85927,132,57,75,72083,77108,33974,85927
8600000US85928,895,446,449,36250,48201,8337,85928
8600000US85929,5935,2838,3097,49107,63063,8929,85929
8600000US85930,810,451,359,30250,41335,7807,85930
8600000US85931,186,102,84,45208,43622,8888,85931
8600000US85932,336,97,239,55060,118658,85076,85932
8600000US85933,2332,1228,1104,39447,51402,6620,85933
8600000US85934,256,144,112,56250,50645,12511,85934
8600000US85935,3734,1837,1897,62325,80224,12373,85935
8600000US85936,3403,1936,1467,58370,61549,9726,85936
8600000US85937,5221,2453,2768,40634,53919,6330,85937
8600000US85938,1606,844,762,54479,56662,5802,85938
8600000US85939,3298,1678,1620,43966,61580,8183,85939
8600000US85940,1102,652,450,59441,69702,10644,85940
8600000US85941,7389,3395,3994,29571,38331,3519,85941
8600000US85942,87,44,43,,,,85942
8600000US86001,38005,19529,18476,57867,83607,4875,86001
8600000US86003,3,3,0,,,,86003
8600000US86004,26360,13078,13282,67345,81446,3211,86004
8600000US86011,8937,3131,5806,10357,10103,5488,86011
8600000US86015,413,128,285,56023,54022,14650,86015
8600000US86016,32,16,16,16250,17150,6035,86016
8600000US86017,837,440,397,67637,73659,24736,86017
8600000US86018,758,380,378,71324,79639,11713,86018
8600000US86020,1523,738,785,33750,40537,4699,86020
8600000US86021,2775,1105,1670,46075,57115,11265,86021
8600000US86022,1439,671,768,37284,49284,7606,86022
8600000US86023,2077,1179,898,66343,65922,13318,86023
8600000US86024,613,296,317,80132,77156,9184,86024
8600000US86025,4236,2363,1873,45425,56670,9541,86025
8600000US86028,0,0,0,,,,86028
8600000US86029,175,113,62,15549,14328,1259,86029
8600000US86030,1098,574,524,43482,55218,7570,86030
8600000US86031,1236,578,658,17679,26238,3038,86031
8600000US86032,1050,425,625,60129,70129,12377,86032
8600000US86033,4974,2355,2619,23864,39001,3951,86033
8600000US86034,1461,777,684,16803,32068,5898,86034
8600000US86035,1492,710,782,41667,52730,4611,86035
8600000US86036,320,172,148,47188,63733,28673,86036
8600000US86038,26,18,8,,,,86038
8600000US86039,907,463,444,30096,46676,8574,86039
8600000US86040,7601,3786,3815,57377,67567,6103,86040
8600000US86042,1516,806,710,27024,46643,10125,86042
8600000US86043,1911,798,1113,37763,43803,7135,86043
8600000US86044,2258,1041,1217,18723,32476,3094,86044
8600000US86045,8254,3695,4559,44766,53244,3418,86045
8600000US86046,4305,2286,2019,52426,63720,5307,86046
8600000US86047,11313,6506,4807,37943,53191,4031,86047
8600000US86052,255,169,86,,,,86052
8600000US86053,1499,732,767,42222,52157,6263,86053
8600000US86054,1267,605,662,28500,41982,5791,86054
8600000US86301,19330,9302,10028,51665,65271,3777,86301
8600000US86303,14934,7040,7894,55334,74445,6035,86303
8600000US86305,15925,8067,7858,62431,86510,8425,86305
8600000US86313,237,237,0,,,,86313
8600000US86314,29859,14130,15729,47568,57715,2419,86314
8600000US86315,6522,3141,3381,52180,66484,11032,86315
8600000US86320,1482,738,744,28220,43366,8432,86320
8600000US86321,1440,857,583,81837,88752,15105,86321
8600000US86322,9156,4953,4203,41993,54650,7264,86322
8600000US86323,13664,6654,7010,48986,65627,5646,86323
8600000US86324,4093,1806,2287,49115,60666,11423,86324
8600000US86325,4939,2381,2558,53315,65638,8293,86325
8600000US86326,19778,8838,10940,43337,56006,3371,86326
8600000US86327,7833,3514,4319,51318,65421,7323,86327
8600000US86329,930,450,480,64744,65304,16781,86329
8600000US86331,403,207,196,43523,67519,18338,86331
8600000US86332,1591,840,751,38693,51046,6969,86332
8600000US86333,6378,3364,3014,45000,55430,10080,86333
8600000US86334,3299,1558,1741,42500,63348,11643,86334
8600000US86335,4757,2431,2326,41134,49216,7462,86335
8600000US86336,10825,5108,5717,59212,84152,9136,86336
8600000US86337,1057,537,520,30580,47513,9264,86337
8600000US86338,415,213,202,49896,66267,14452,86338
8600000US86343,68,32,36,,57574,37725,86343
8600000US86351,5949,2887,3062,56693,89244,11670,86351
8600000US86401,20465,10724,9741,46957,63693,5706,86401
8600000US86403,15326,7663,7663,43932,61209,5681,86403
8600000US86404,14226,7077,7149,51472,67971,4906,86404
8600000US86406,19633,9732,9901,54358,68660,3952,86406
8600000US86409,22604,11059,11545,38532,50280,2395,86409
8600000US86411,208,101,107,37250,55238,23031,86411
8600000US86413,11336,6825,4511,37075,44235,3670,86413
8600000US86426,12081,5917,6164,46743,62047,5940,86426
8600000US86429,6580,3035,3545,46806,64377,7443,86429
8600000US86431,440,270,170,24700,43750,15748,86431
8600000US86432,3070,1546,1524,36051,42984,9542,86432
8600000US86433,0,0,0,,,,86433
8600000US86434,1125,530,595,38047,46141,4353,86434
8600000US86435,15,8,7,,,,86435
8600000US86436,1042,599,443,26673,38912,17203,86436
8600000US86437,97,48,49,,37464,33283,86437
8600000US86438,731,379,352,33370,50194,18811,86438
8600000US86440,6167,3214,2953,39650,53425,5770,86440
8600000US86441,1948,1121,827,24566,36181,6730,86441
8600000US86442,27478,13401,14077,37924,51350,3328,86442
8600000US86443,0,0,0,,,,86443
8600000US86444,978,498,480,20139,36974,10742,86444
8600000US86445,221,119,102,54444,77407,39849,86445
8600000US86502,893,466,427,21645,31469,6902,86502
8600000US86503,7318,3362,3956,27115,36416,3145,86503
8600000US86504,5054,2527,2527,31042,44871,4496,86504
8600000US86505,5614,2634,2980,24583,34816,2239,86505
8600000US86506,895,409,486,19545,32385,5966,86506
8600000US86507,1568,756,812,24167,32406,3597,86507
8600000US86508,581,268,313,20417,31295,6430,86508
8600000US86510,3049,1373,1676,22813,36919,3489,86510
8600000US86511,2883,1362,1521,25938,40252,5104,86511
8600000US86512,1951,925,1026,27868,35878,4583,86512
8600000US86514,2119,1032,1087,25708,36471,3036,86514
8600000US86515,3462,1681,1781,31588,39600,4976,86515
8600000US86520,1155,535,620,21154,33954,4226,86520
8600000US86535,943,438,505,16500,32413,5538,86535
8600000US86538,1400,676,724,25714,36732,5459,86538
8600000US86540,707,308,399,11369,23423,5117,86540
8600000US86544,897,520,377,24271,39416,6332,86544
8600000US86545,993,456,537,23214,30171,3728,86545
8600000US86547,880,407,473,27560,32650,4813,86547
8600000US86556,1502,676,826,23636,32358,3837,86556
8600000US87001,2595,1181,1414,41375,59858,7270,87001
8600000US87002,16820,8310,8510,38348,54007,4461,87002
8600000US87004,9115,4460,4655,43333,56104,4000,87004
8600000US87005,324,152,172,,85303,72172,87005
8600000US87006,1113,592,521,48889,61891,22457,87006
8600000US87007,834,451,383,33750,42296,10244,87007
8600000US87008,1923,928,995,83068,92731,14881,87008
8600000US87010,989,478,511,52250,69451,13086,87010
8600000US87011,47,20,27,31964,40245,10060,87011
8600000US87012,188,98,90,,,,87012
8600000US87013,3838,1836,2002,,,,87013
8600000US87014,489,305,184,45583,62536,25574,87014
8600000US87015,9974,4740,5234,57589,74028,5956,87015
8600000US87016,2553,1630,923,35734,50294,10820,87016
8600000US87017,304,128,176,,,,87017
8600000US87018,397,197,200,14671,21452,4740,87018
8600000US87020,8514,4485,4029,34726,49570,4473,87020
8600000US87021,2844,1481,1363,43906,54051,9190,87021
8600000US87022,676,298,378,29911,45799,7332,87022
8600000US87023,461,197,264,44063,51960,10976,87023
8600000US87024,1673,777,896,35060,55432,13436,87024
8600000US87025,966,473,493,63208,88081,18851,87025
8600000US87026,3065,1427,1638,34847,44262,4620,87026
8600000US87027,239,134,105,19896,37746,19715,87027
8600000US87028,515,379,136,40638,38754,15584,87028
8600000US87029,201,113,88,,,,87029
8600000US87031,33227,16630,16597,48084,56900,2754,87031
8600000US87032,213,13,200,19266,25788,8727,87032
8600000US87034,1536,702,834,43125,47832,4851,87034
8600000US87035,6059,3001,3058,41875,52778,6142,87035
8600000US87036,1322,767,555,47269,52135,9386,87036
8600000US87037,481,231,250,17007,24129,6667,87037
8600000US87038,495,222,273,,30390,8058,87038
8600000US87040,384,207,177,23393,41986,15324,87040
8600000US87041,551,254,297,36685,40279,6644,87041
8600000US87042,2987,1371,1616,51169,85582,32676,87042
8600000US87043,4173,1941,2232,73832,91382,10291,87043
8600000US87044,232,136,96,48167,70416,18434,87044
8600000US87045,1277,666,611,17760,31811,6571,87045
8600000US87046,116,54,62,,,,87046
8600000US87047,3624,1778,1846,87500,102884,9131,87047
8600000US87048,7634,3974,3660,79162,110089,8070,87048
8600000US87049,890,439,451,42917,54362,15616,87049
8600000US87051,974,534,440,64577,59928,17862,87051
8600000US87052,2181,1099,1082,33879,47594,7225,87052
8600000US87053,926,449,477,29306,36565,4250,87053
8600000US87056,888,461,427,57727,73631,11524,87056
8600000US87059,8662,4200,4462,75607,88988,6734,87059
8600000US87061,373,166,207,23583,26763,10255,87061
8600000US87062,967,476,491,34338,48237,15668,87062
8600000US87063,177,102,75,25250,28456,6453,87063
8600000US87064,84,48,36,,,,87064
8600000US87068,3680,1892,1788,47105,63652,7048,87068
8600000US87070,189,141,48,,,,87070
8600000US87072,444,222,222,46000,48735,5565,87072
8600000US87083,462,227,235,53833,63978,6769,87083
8600000US87102,16312,8579,7733,28739,41765,2937,87102
8600000US87104,10610,5157,5453,46729,73000,7229,87104
8600000US87105,44949,21439,23510,40320,52405,2238,87105
8600000US87106,21265,11071,10194,37420,61168,3939,87106
8600000US87107,24679,11769,12910,48202,73783,5817,87107
8600000US87108,29451,14457,14994,29031,43728,2605,87108
8600000US87109,32638,15100,17538,50545,68997,3794,87109
8600000US87110,31933,15652,16281,50034,66743,2946,87110
8600000US87111,46351,21788,24563,69741,95832,4489,87111
8600000US87112,33971,16300,17671,50831,64961,2457,87112
8600000US87113,11933,5810,6123,82975,99673,9807,87113
8600000US87114,50350,23897,26453,67142,81978,3199,87114
8600000US87116,2635,1426,1209,64464,70802,6738,87116
8600000US87117,361,334,27,,,,87117
8600000US87120,47940,23082,24858,67154,82716,2848,87120
8600000US87121,54348,26575,27773,42185,53316,2812,87121
8600000US87122,14574,7185,7389,111429,146568,8064,87122
8600000US87123,34053,16567,17486,46670,68348,3616,87123
8600000US87124,42707,20096,22611,56502,70248,3072,87124
8600000US87144,30207,14818,15389,69016,81797,3341,87144
8600000US87301,16208,7802,8406,42850,61355,5083,87301
8600000US87305,2672,1353,1319,21509,35624,6282,87305
8600000US87310,888,454,434,29500,44631,6121,87310
8600000US87311,2817,1281,1536,22826,33312,2899,87311
8600000US87312,394,139,255,23553,39219,11246,87312
8600000US87313,4495,2169,2326,34333,44771,3365,87313
8600000US87315,164,99,65,43088,38190,9712,87315
8600000US87316,869,430,439,23125,39595,10317,87316
8600000US87317,1268,601,667,53063,65711,29019,87317
8600000US87319,1406,642,764,23750,29708,5196,87319
8600000US87320,457,229,228,26094,42990,9843,87320
8600000US87321,1653,742,911,32356,47157,7576,87321
8600000US87322,119,41,78,39167,42463,13341,87322
8600000US87323,2950,1477,1473,20250,30653,3997,87323
8600000US87325,2266,1125,1141,34010,43134,3341,87325
8600000US87326,1353,609,744,28804,39113,4475,87326
8600000US87327,6789,3042,3747,37365,46905,4154,87327
8600000US87328,1543,646,897,24083,37425,4633,87328
8600000US87347,156,84,72,76304,73448,18417,87347
8600000US87357,533,293,240,23438,37584,5784,87357
8600000US87364,750,407,343,19318,30885,3935,87364
8600000US87375,2149,1025,1124,29922,39336,4277,87375
8600000US87401,33681,16164,17517,51521,70167,4014,87401
8600000US87402,7427,3800,3627,72361,87552,6079,87402
8600000US87410,12998,6248,6750,50877,62342,4826,87410
8600000US87412,635,343,292,,,,87412
8600000US87413,12091,6247,5844,52238,64867,4037,87413
8600000US87415,1234,579,655,53431,72821,15317,87415
8600000US87416,3845,1892,1953,45268,53910,5834,87416
8600000US87417,4017,1914,2103,52833,62671,8548,87417
8600000US87418,779,430,349,79167,94734,25163,87418
8600000US87419,324,153,171,,,,87419
8600000US87420,8709,4156,4553,34911,48895,3242,87420
8600000US87421,1226,612,614,57596,60616,11025,87421
8600000US87455,1267,662,605,24659,39092,4121,87455
8600000US87461,966,494,472,22763,33588,4000,87461
8600000US87499,403,182,221,31875,37196,6671,87499
8600000US87501,14208,6323,7885,68219,106666,8133,87501
8600000US87505,25989,12193,13796,59536,84264,4571,87505
8600000US87506,10884,5360,5524,68788,118021,10075,87506
8600000US87507,36980,17978,19002,53516,69054,2768,87507
8600000US87508,16480,8557,7923,72283,95524,6798,87508
8600000US87510,575,309,266,,,,87510
8600000US87511,1971,805,1166,,,,87511
8600000US87512,63,26,37,,,,87512
8600000US87513,571,273,298,57935,103166,51453,87513
8600000US87514,671,420,251,38864,73544,33659,87514
8600000US87515,319,115,204,,,,87515
8600000US87516,102,32,70,,,,87516
8600000US87517,258,165,93,22339,27931,11858,87517
8600000US87518,9,0,9,,,,87518
8600000US87519,333,154,179,21842,28537,13784,87519
8600000US87520,1015,463,552,,,,87520
8600000US87521,704,316,388,,,,87521
8600000US87522,2041,1141,900,,,,87522
8600000US87523,645,348,297,,,,87523
8600000US87524,92,39,53,,,,87524
8600000US87525,65,47,18,60500,57009,15742,87525
8600000US87527,557,266,291,,,,87527
8600000US87528,2184,1024,1160,,,,87528
8600000US87529,3977,1973,2004,48189,67229,10537,87529
8600000US87530,860,372,488,,,,87530
8600000US87531,510,365,145,,,,87531
8600000US87532,14095,6967,7128,,,,87532
8600000US87533,78,25,53,,,,87533
8600000US87535,1011,505,506,56250,68455,13963,87535
8600000US87537,1772,1011,761,,,,87537
8600000US87538,541,398,143,,36235,16744,87538
8600000US87539,22,22,0,,,,87539
8600000US87540,810,361,449,66534,97374,25096,87540
8600000US87543,85,56,29,,,,87543
8600000US87544,14188,7149,7039,115248,133593,7468,87544
8600000US87548,1156,347,809,,,,87548
8600000US87549,391,137,254,,,,87549
8600000US87551,297,155,142,,,,87551
8600000US87552,2970,1239,1731,34849,56135,9924,87552
8600000US87553,1209,630,579,33828,43711,3190,87553
8600000US87554,0,0,0,,,,87554
8600000US87556,1856,882,974,32217,43010,5864,87556
8600000US87557,5163,2291,2872,43930,63718,12834,87557
8600000US87558,369,217,152,42917,61241,23345,87558
8600000US87560,969,582,387,27336,30366,11053,87560
8600000US87562,242,180,62,40850,55975,27708,87562
8600000US87564,284,181,103,,50326,31441,87564
8600000US87565,341,205,136,44583,40481,13000,87565
8600000US87566,2850,1575,1275,,,,87566
8600000US87567,1204,516,688,36831,46855,14339,87567
8600000US87569,409,175,234,25139,41391,22342,87569
8600000US87571,9658,4584,5074,35000,49560,3418,87571
8600000US87573,38,25,13,,,,87573
8600000US87574,239,131,108,,79272,54728,87574
8600000US87575,672,475,197,,,,87575
8600000US87577,264,133,131,,,,87577
8600000US87578,211,142,69,,,,87578
8600000US87579,821,477,344,47750,46186,9527,87579
8600000US87580,466,215,251,43650,53908,30886,87580
8600000US87581,32,17,15,,,,87581
8600000US87582,430,152,278,,,,87582
8600000US87583,179,103,76,23902,34930,24972,87583
8600000US87701,15210,7456,7754,30243,45207,4826,87701
8600000US87710,1272,684,588,41144,53040,10385,87710
8600000US87711,557,394,163,19028,21484,5251,87711
8600000US87712,142,61,81,98071,75117,29661,87712
8600000US87713,170,77,93,91667,77300,29244,87713
8600000US87714,862,433,429,30952,47964,9157,87714
8600000US87715,311,136,175,19395,22099,5459,87715
8600000US87718,322,168,154,48359,51957,11509,87718
8600000US87722,571,428,143,49659,59018,25888,87722
8600000US87723,384,199,185,17946,29709,23696,87723
8600000US87724,21,21,0,,,,87724
8600000US87728,314,160,154,36875,47867,10253,87728
8600000US87729,25,12,13,,55213,48725,87729
8600000US87730,23,20,3,,27560,12367,87730
8600000US87731,224,111,113,65117,54274,11754,87731
8600000US87732,1285,519,766,29167,44666,16865,87732
8600000US87733,94,73,21,43750,65640,16407,87733
8600000US87734,135,59,76,21875,30095,9950,87734
8600000US87735,75,53,22,12917,12575,2507,87735
8600000US87736,151,22,129,61806,48506,21918,87736
8600000US87740,5698,2793,2905,29624,44277,4024,87740
8600000US87742,445,186,259,41250,53139,15557,87742
8600000US87743,227,138,89,22708,69087,26530,87743
8600000US87745,518,271,247,54280,60971,16074,87745
8600000US87746,55,48,7,27500,28977,10758,87746
8600000US87747,1303,624,679,41310,50445,8289,87747
8600000US87749,219,174,45,,,,87749
8600000US87750,0,0,0,,,,87750
8600000US87752,339,173,166,22656,39251,10459,87752
8600000US87753,141,52,89,26354,25739,7566,87753
8600000US87801,7566,3809,3757,36511,51070,5254,87801
8600000US87820,91,52,39,35446,34805,2361,87820
8600000US87821,581,244,337,38080,51687,25708,87821
8600000US87823,608,199,409,54792,55435,14928,87823
8600000US87824,83,59,24,56300,53562,22254,87824
8600000US87825,1680,881,799,26542,51869,18554,87825
8600000US87827,82,54,28,23897,27718,13820,87827
8600000US87828,350,83,267,21375,27106,11969,87828
8600000US87829,481,261,220,48958,50019,11192,87829
8600000US87830,1384,726,658,41591,40784,4712,87830
8600000US87831,275,211,64,59531,59200,15848,87831
8600000US87832,150,57,93,,35606,18263,87832
8600000US87901,5333,2588,2745,29380,52009,14142,87901
8600000US87930,521,329,192,,28321,11336,87930
8600000US87931,589,264,325,32339,51442,15974,87931
8600000US87933,138,104,34,,,,87933
8600000US87935,1495,713,782,30938,47648,9218,87935
8600000US87936,255,104,151,35724,71712,51655,87936
8600000US87937,1801,745,1056,18446,29718,6856,87937
8600000US87939,93,28,65,,116442,86812,87939
8600000US87940,570,295,275,59618,73734,33115,87940
8600000US87941,538,274,264,20360,25398,11056,87941
8600000US87942,780,389,391,25833,40872,12663,87942
8600000US87943,146,88,58,31071,36801,14927,87943
8600000US88001,29029,14815,14214,28322,42118,3477,88001
8600000US88002,846,424,422,53705,67436,13522,88002
8600000US88003,495,259,236,,,,88003
8600000US88004,819,819,0,,,,88004
8600000US88005,21712,10611,11101,45170,60917,4839,88005
8600000US88007,18114,8925,9189,46875,68725,6163,88007
8600000US88008,5478,2471,3007,51195,62376,6524,88008
8600000US88009,49,46,3,,,,88009
8600000US88011,24373,10982,13391,54414,82480,6396,88011
8600000US88012,20615,10125,10490,48667,57882,3314,88012
8600000US88020,534,276,258,39479,49390,10696,88020
8600000US88021,13150,6173,6977,30717,42459,3525,88021
8600000US88022,991,463,528,40913,48030,8660,88022
8600000US88023,1809,943,866,34299,42644,6531,88023
8600000US88024,99,51,48,,55725,41003,88024
8600000US88025,255,151,104,43603,57824,19594,88025
8600000US88026,1067,529,538,29618,39773,5804,88026
8600000US88027,248,116,132,26648,52106,21114,88027
8600000US88028,240,118,122,30313,39751,15876,88028
8600000US88029,983,514,469,20396,26619,5959,88029
8600000US88030,16867,8381,8486,28002,41793,3335,88030
8600000US88032,199,112,87,22553,25320,17365,88032
8600000US88033,0,0,0,,,,88033
8600000US88034,44,28,16,,,,88034
8600000US88038,235,137,98,,77683,32470,88038
8600000US88039,305,202,103,67250,62108,14403,88039
8600000US88040,100,61,39,31250,49922,16756,88040
8600000US88041,1041,581,460,38636,43731,8258,88041
8600000US88042,182,90,92,,74548,32557,88042
8600000US88043,1175,571,604,37875,47007,8050,88043
8600000US88044,2749,1235,1514,37747,52742,7905,88044
8600000US88045,2603,1248,1355,35729,49379,8779,88045
8600000US88046,579,303,276,37321,41240,9985,88046
8600000US88047,1790,911,879,70887,73192,17586,88047
8600000US88048,1978,1026,952,36458,47933,12183,88048
8600000US88049,357,192,165,27277,38039,14499,88049
8600000US88051,114,46,68,79750,65608,18688,88051
8600000US88052,200,151,49,12475,15822,4175,88052
8600000US88053,153,133,20,6271,73363,103733,88053
8600000US88055,39,18,21,37813,71250,61325,88055
8600000US88056,176,111,65,30455,37323,13007,88056
8600000US88061,14163,6659,7504,40515,61238,7414,88061
8600000US88063,9616,4292,5324,24875,40823,7883,88063
8600000US88065,412,177,235,49125,56393,16169,88065
8600000US88072,1179,586,593,30805,34830,10339,88072
8600000US88081,12141,6813,5328,25559,41317,9672,88081
8600000US88101,34419,17857,16562,46545,60643,4028,88101
8600000US88103,312,249,63,,,,88103
8600000US88112,124,64,60,43125,73098,27935,88112
8600000US88113,67,45,22,52679,51338,16138,88113
8600000US88114,15,12,3,,,,88114
8600000US88115,76,29,47,,56768,24200,88115
8600000US88116,328,156,172,46250,68434,15685,88116
8600000US88118,220,105,115,52188,48472,12073,88118
8600000US88119,1428,737,691,30944,46401,8420,88119
8600000US88120,160,83,77,57188,69993,16029,88120
8600000US88121,73,34,39,31750,59012,24177,88121
8600000US88124,823,417,406,47727,60768,8077,88124
8600000US88125,54,33,21,,43626,34570,88125
8600000US88126,42,18,24,158472,159688,64156,88126
8600000US88130,13396,6624,6772,40095,51816,3835,88130
8600000US88132,155,89,66,65625,78891,28120,88132
8600000US88134,57,17,40,,,,88134
8600000US88135,1025,533,492,42786,49564,7667,88135
8600000US88136,27,20,7,108214,104620,6408,88136
8600000US88201,19688,9706,9982,51387,70044,5381,88201
8600000US88203,22131,10583,11548,37869,48073,2420,88203
8600000US88210,12692,6271,6421,54461,74679,5947,88210
8600000US88220,27658,13895,13763,67588,77469,3889,88220
8600000US88230,3533,1706,1827,38850,54091,7887,88230
8600000US88231,2248,1128,1120,69188,69647,7083,88231
8600000US88232,1851,1133,718,40972,47707,5184,88232
8600000US88240,28205,14609,13596,58531,72648,4788,88240
8600000US88242,5271,2735,2536,74275,94324,8869,88242
8600000US88250,235,162,73,,41948,17167,88250
8600000US88252,1579,815,764,56337,64298,8247,88252
8600000US88253,553,270,283,57841,81116,35590,88253
8600000US88254,29,29,0,,,,88254
8600000US88255,22,11,11,,,,88255
8600000US88256,1358,703,655,39181,59687,8789,88256
8600000US88260,10623,5441,5182,53444,69958,5945,88260
8600000US88262,7,5,2,,,,88262
8600000US88263,170,93,77,103571,100292,38132,88263
8600000US88264,11,0,11,,,,88264
8600000US88265,104,55,49,52857,66391,27207,88265
8600000US88267,898,426,472,50083,64216,9034,88267
8600000US88268,173,110,63,,,,88268
8600000US88301,938,467,471,34650,46812,9356,88301
8600000US88310,28456,14103,14353,45053,57512,3706,88310
8600000US88311,1010,625,385,40257,90769,49147,88311
8600000US88312,2343,1214,1129,58945,74140,17057,88312
8600000US88314,56,0,56,,,,88314
8600000US88316,1714,867,847,38804,60555,20051,88316
8600000US88317,1376,680,696,52147,67559,9949,88317
8600000US88318,229,111,118,65000,71543,16702,88318
8600000US88321,86,48,38,25125,28239,6559,88321
8600000US88323,0,0,0,,,,88323
8600000US88324,134,61,73,,53638,30401,88324
8600000US88325,640,341,299,54773,54266,12365,88325
8600000US88330,2396,1397,999,46250,55117,5506,88330
8600000US88336,325,157,168,26902,39463,13878,88336
8600000US88337,1870,873,997,48105,54408,8318,88337
8600000US88338,77,46,31,145313,147249,38580,88338
8600000US88339,459,214,245,53347,56204,10686,88339
8600000US88340,2502,1116,1386,33796,40858,4591,88340
8600000US88341,524,280,244,43506,54394,14839,88341
8600000US88342,73,33,40,,47098,21672,88342
8600000US88343,5,0,5,,,,88343
8600000US88344,25,12,13,,,,88344
8600000US88345,7215,3339,3876,44623,62640,7407,88345
8600000US88346,1915,821,1094,25531,55849,26519,88346
8600000US88347,93,55,38,28393,25237,8603,88347
8600000US88348,314,136,178,,59384,38749,88348
8600000US88349,14,0,14,,,,88349
8600000US88350,301,173,128,,35273,26283,88350
8600000US88351,148,83,65,35962,62655,26204,88351
8600000US88352,3904,2191,1713,47886,65087,16864,88352
8600000US88353,152,43,109,22727,22761,4847,88353
8600000US88354,0,0,0,,,,88354
8600000US88355,0,0,0,,,,88355
8600000US88401,4928,2244,2684,25514,38411,4538,88401
8600000US88410,36,21,15,,,,88410
8600000US88411,46,21,25,39375,58138,18652,88411
8600000US88414,29,19,10,,59513,32416,88414
8600000US88415,2959,1679,1280,37576,60581,14241,88415
8600000US88416,35,35,0,,,,88416
8600000US88417,0,0,0,,,,88417
8600000US88418,154,90,64,45625,66386,30758,88418
8600000US88419,94,67,27,50938,61110,19833,88419
8600000US88421,39,39,0,,,,88421
8600000US88422,43,22,21,,73942,58877,88422
8600000US88424,53,43,10,,36328,23562,88424
8600000US88426,846,446,400,38717,58607,15741,88426
8600000US88427,179,105,74,43750,70539,31297,88427
8600000US88430,82,21,61,,57272,28761,88430
8600000US88431,43,12,31,,,,88431
8600000US88434,357,163,194,42000,59202,11711,88434
8600000US88435,3013,1702,1311,28454,45984,7197,88435
8600000US88436,50,20,30,27125,31197,13861,88436
8600000US89001,1047,582,465,60160,59872,10705,89001
8600000US89002,25387,12495,12892,79966,95801,5661,89002
8600000US89003,715,420,295,32743,56962,21677,89003
8600000US89004,289,163,126,74531,219694,191881,89004
8600000US89005,12898,6222,6676,60870,81339,5589,89005
8600000US89007,848,447,401,,54020,15885,89007
8600000US89008,1047,490,557,45500,57770,12782,89008
8600000US89010,384,174,210,46250,57515,7778,89010
8600000US89011,21086,9942,11144,64981,93996,9514,89011
8600000US89012,27834,13274,14560,74170,100656,5557,89012
8600000US89013,270,117,153,34375,41095,7554,89013
8600000US89014,31431,14839,16592,58369,74175,4097,89014
8600000US89015,33336,16733,16603,55164,67295,3035,89015
8600000US89017,102,59,43,62944,57890,10490,89017
8600000US89018,4631,4323,308,57321,54586,9220,89018
8600000US89019,1938,1103,835,47177,126196,96955,89019
8600000US89020,822,474,348,42778,53409,12663,89020
8600000US89021,2084,1152,932,90719,95010,13168,89021
8600000US89022,0,0,0,,,,89022
8600000US89025,887,394,493,62500,68879,14214,89025
8600000US89026,0,0,0,,,,89026
8600000US89027,14985,7331,7654,50597,62466,2854,89027
8600000US89029,7268,3661,3607,34195,45571,3309,89029
8600000US89030,32821,16663,16158,35028,43266,2025,89030
8600000US89031,48746,22865,25881,64278,74869,2304,89031
8600000US89032,32525,15356,17169,59427,67148,3052,89032
8600000US89039,140,62,78,27917,31790,8641,89039
8600000US89040,2778,1299,1479,63089,65584,7582,89040
8600000US89042,851,329,522,63061,64650,15429,89042
8600000US89043,1270,875,395,49583,60969,15831,89043
8600000US89044,16879,7905,8974,82144,105017,7977,89044
8600000US89045,1568,870,698,88400,87550,12865,89045
8600000US89046,294,143,151,31813,49521,18571,89046
8600000US89047,115,52,63,58750,64870,10797,89047
8600000US89048,17558,8630,8928,43164,54572,4086,89048
8600000US89049,2216,1157,1059,36599,42511,5976,89049
8600000US89052,42611,20527,22084,80984,113141,4714,89052
8600000US89054,40,19,21,,40693,38241,89054
8600000US89060,7953,4255,3698,38891,48629,4026,89060
8600000US89061,4940,2382,2558,54710,64425,6084,89061
8600000US89074,39857,19546,20311,71805,91748,3838,89074
8600000US89081,25265,12359,12906,65322,74370,4414,89081
8600000US89084,20150,9602,10548,75571,93385,4676,89084
8600000US89085,2909,1540,1369,121609,117916,11059,89085
8600000US89086,3764,1698,2066,58577,62988,5253,89086
8600000US89101,31936,18748,13188,25245,37608,1590,89101
8600000US89102,28763,15193,13570,35627,50078,2759,89102
8600000US89103,41875,21270,20605,40261,52246,1749,89103
8600000US89104,30001,15856,14145,35484,46618,1813,89104
8600000US89106,18397,8831,9566,30444,44110,2315,89106
8600000US89107,28542,15034,13508,40605,56019,2915,89107
8600000US89108,55212,27209,28003,46759,56917,2372,89108
8600000US89109,6955,3911,3044,43206,91182,12270,89109
8600000US89110,50300,25300,25000,44406,60290,3350,89110
8600000US89113,24586,12272,12314,72212,96112,6346,89113
8600000US89115,41275,19613,21662,36050,45897,1722,89115
8600000US89117,45602,22230,23372,57954,90127,6403,89117
8600000US89118,18267,9689,8578,55444,74851,5002,89118
8600000US89119,42227,22940,19287,34312,44525,2001,89119
8600000US89120,20605,10413,10192,49267,69927,3867,89120
8600000US89121,50791,25072,25719,39528,55145,2317,89121
8600000US89122,38381,18285,20096,45708,58039,2986,89122
8600000US89123,49247,25211,24036,66710,83806,4847,89123
8600000US89124,908,531,377,100139,133546,44252,89124
8600000US89128,29211,13663,15548,58575,80377,4746,89128
8600000US89129,42858,20649,22209,71464,87864,3366,89129
8600000US89130,28434,14289,14145,64480,80277,3390,89130
8600000US89131,35813,17247,18566,93337,106159,3992,89131
8600000US89134,21669,9918,11751,66904,99156,6209,89134
8600000US89135,21937,10465,11472,89046,144051,10244,89135
8600000US89138,11516,5486,6030,112972,154521,16631,89138
8600000US89139,29950,14928,15022,75022,89838,3610,89139
8600000US89141,24171,11794,12377,88242,112130,7021,89141
8600000US89142,25858,12382,13476,48994,60728,3310,89142
8600000US89143,9083,4400,4683,83650,102224,10390,89143
8600000US89144,14929,7266,7663,86780,132240,12613,89144
8600000US89145,19861,9838,10023,57822,86459,5733,89145
8600000US89146,15187,7435,7752,48291,69458,5937,89146
8600000US89147,42977,20772,22205,54722,70840,3114,89147
8600000US89148,38575,18729,19846,73486,84858,3779,89148
8600000US89149,29293,14542,14751,72318,94492,4058,89149
8600000US89156,21349,9994,11355,47641,58179,2821,89156
8600000US89161,145,75,70,50313,270321,399176,89161
8600000US89166,16117,8843,7274,90041,103070,6168,89166
8600000US89169,17088,9834,7254,29414,44627,3580,89169
8600000US89178,27518,12576,14942,82554,94598,4344,89178
8600000US89179,4803,2273,2530,92634,105522,12783,89179
8600000US89183,30789,15153,15636,65491,81682,5171,89183
8600000US89191,626,490,136,,,,89191
8600000US89301,6294,3858,2436,64128,74663,6903,89301
8600000US89310,337,220,117,,71819,23259,89310
8600000US89311,99,51,48,,59575,23030,89311
8600000US89314,224,117,107,48636,56730,11275,89314
8600000US89316,904,487,417,80333,88970,19376,89316
8600000US89317,239,128,111,67212,65809,15337,89317
8600000US89318,937,485,452,55163,60666,10495,89318
8600000US89319,142,76,66,66818,56245,17573,89319
8600000US89402,16,8,8,,,,89402
8600000US89403,12656,6472,6184,61992,72686,4066,89403
8600000US89404,28,13,15,,,,89404
8600000US89405,92,55,37,75129,55471,25045,89405
8600000US89406,18493,9314,9179,51638,65402,3548,89406
8600000US89408,15183,7811,7372,63523,70634,4572,89408
8600000US89409,162,110,52,55565,124930,114330,89409
8600000US89410,8913,4325,4588,60116,72949,5900,89410
8600000US89411,535,226,309,158500,168296,58178,89411
8600000US89412,195,115,80,,87315,88472,89412
8600000US89413,552,281,271,91184,170063,60969,89413
8600000US89414,158,104,54,44250,48444,11892,89414
8600000US89415,2712,1333,1379,50132,54503,7324,89415
8600000US89418,232,130,102,,44591,34903,89418
8600000US89419,4644,3308,1336,49265,58248,6312,89419
8600000US89420,0,0,0,,,,89420
8600000US89421,431,218,213,53266,49489,12929,89421
8600000US89422,111,71,40,50278,58952,34420,89422
8600000US89423,8665,4276,4389,75587,91130,9879,89423
8600000US89424,203,119,84,32344,40583,9414,89424
8600000US89425,327,148,179,55865,73453,39993,89425
8600000US89426,143,81,62,,46490,44472,89426
8600000US89427,837,399,438,25550,34522,5167,89427
8600000US89428,113,59,54,,54496,30548,89428
8600000US89429,6016,3019,2997,40921,55749,5545,89429
8600000US89430,316,160,156,153333,153962,44709,89430
8600000US89431,29117,14868,14249,43539,57873,4175,89431
8600000US89433,15503,7869,7634,52359,61048,2938,89433
8600000US89434,20835,9699,11136,60914,73953,3968,89434
8600000US89436,31549,15298,16251,83125,95272,3654,89436
8600000US89438,87,49,38,68875,71843,30217,89438
8600000US89439,1202,571,631,57879,80012,17262,89439
8600000US89440,755,476,279,57981,74246,19311,89440
8600000US89441,9348,4776,4572,89338,104575,7119,89441
8600000US89442,860,440,420,50524,52321,5041,89442
8600000US89444,2310,1216,1094,54962,65370,6148,89444
8600000US89445,11751,6217,5534,72324,80963,3595,89445
8600000US89446,0,0,0,,,,89446
8600000US89447,5622,2701,2921,41916,56268,7506,89447
8600000US89448,1321,698,623,82708,128258,28979,89448
8600000US89449,2702,1505,1197,56779,82721,18660,89449
8600000US89450,56,28,28,138750,127259,18776,89450
8600000US89451,7322,3653,3669,93321,147211,13951,89451
8600000US89460,11237,5723,5514,57537,77872,5677,89460
8600000US89501,3839,2330,1509,38266,70725,17656,89501
8600000US89502,34982,18465,16517,42017,55730,2209,89502
8600000US89503,24685,12739,11946,51596,68115,4353,89503
8600000US89506,31621,16768,14853,60530,70910,3178,89506
8600000US89508,9508,4622,4886,73944,82436,3831,89508
8600000US89509,29118,14050,15068,57835,89485,5077,89509
8600000US89510,1358,769,589,72750,108121,29363,89510
8600000US89511,21128,10561,10567,94777,136303,8068,89511
8600000US89512,19507,9361,10146,35315,47280,3970,89512
8600000US89519,6926,3080,3846,94592,149970,21994,89519
8600000US89521,23590,11599,11991,87042,101967,4075,89521
8600000US89523,27196,13004,14192,72354,89275,3347,89523
8600000US89701,20741,11141,9600,52839,68087,3679,89701
8600000US89702,0,0,0,,,,89702
8600000US89703,8174,4030,4144,68868,100526,10429,89703
8600000US89704,3516,1853,1663,84148,129171,28729,89704
8600000US89705,4207,2009,2198,63750,80763,8750,89705
8600000US89706,15622,7635,7987,44410,56922,3655,89706
8600000US89801,19274,10103,9171,78875,91601,5471,89801
8600000US89815,10230,5233,4997,96704,104566,5698,89815
8600000US89820,3822,2051,1771,94139,89700,10377,89820
8600000US89821,409,177,232,62727,62742,14503,89821
8600000US89822,1709,967,742,80375,91860,16069,89822
8600000US89823,77,45,32,65962,73258,50585,89823
8600000US89825,1022,479,543,24862,34130,8057,89825
8600000US89826,0,0,0,,,,89826
8600000US89828,325,167,158,147958,133732,17663,89828
8600000US89830,160,117,43,,43584,33501,89830
8600000US89831,0,0,0,,,,89831
8600000US89832,920,439,481,35750,45500,7525,89832
8600000US89833,88,54,34,70063,53469,16580,89833
8600000US89834,103,81,22,28203,49317,33978,89834
8600000US89835,1263,663,600,57692,61387,7120,89835
8600000US89883,2858,1526,1332,56029,68648,9448,89883
8600000US90001,40485,20637,19848,38521,49526,2009,90001
8600000US90002,35689,16582,19107,35410,46741,2551,90002
8600000US90003,49231,23278,25953,37226,47313,1915,90003
8600000US90004,49453,24854,24599,48754,82746,4064,90004
8600000US90005,32290,16101,16189,35149,51847,3323,90005
8600000US90006,46811,23174,23637,35411,47118,1685,90006
8600000US90007,35951,17977,17974,25226,46236,6492,90007
8600000US90008,26201,11227,14974,39907,63335,4427,90008
8600000US90010,3374,1679,1695,61849,78696,11475,90010
8600000US90011,74461,37434,37027,36954,48248,1580,90011
8600000US90012,32500,20283,12217,42275,69507,4653,90012
8600000US90013,11573,7184,4389,21676,63177,9836,90013
8600000US90014,8225,5202,3023,35857,68165,9373,90014
8600000US90015,17456,8662,8794,39016,73169,5997,90015
8600000US90016,36447,17397,19050,46680,63545,3783,90016
8600000US90017,20816,11223,9593,31423,57436,4918,90017
8600000US90018,40740,19265,21475,41768,61594,3176,90018
8600000US90019,54048,26619,27429,52625,80493,3782,90019
8600000US90020,32071,15351,16720,46504,68484,4432,90020
8600000US90021,2584,1599,985,15149,48503,8318,90021
8600000US90022,48208,23333,24875,43366,55679,1937,90022
8600000US90023,33756,16910,16846,41308,51844,2198,90023
8600000US90024,46096,20739,25357,63306,118734,8328,90024
8600000US90025,42239,21310,20929,83655,110323,6852,90025
8600000US90026,57997,29387,28610,60820,87428,4204,90026
8600000US90027,39579,18922,20657,64091,98471,5829,90027
8600000US90028,28548,15710,12838,43998,62984,3575,90028
8600000US90029,31633,15981,15652,39562,54922,2899,90029
8600000US90031,29947,14738,15209,44343,62182,2946,90031
8600000US90032,37010,17655,19355,50989,67707,2478,90032
8600000US90033,34388,16406,17982,35548,47358,1800,90033
8600000US90034,48232,24552,23680,71295,94539,4442,90034
8600000US90035,22747,10219,12528,79534,122836,7553,90035
8600000US90036,31941,14621,17320,80998,117596,5761,90036
8600000US90037,46452,23143,23309,33856,44965,2221,90037
8600000US90038,23005,12387,10618,39984,58616,3430,90038
8600000US90039,24755,11949,12806,86031,120338,8915,90039
8600000US90040,9506,4661,4845,46532,59182,4106,90040
8600000US90041,24379,11727,12652,80547,110014,8314,90041
8600000US90042,50530,24405,26125,59746,81162,2761,90042
8600000US90043,35774,16427,19347,47500,72415,3817,90043
8600000US90044,67711,31098,36613,34311,48445,2053,90044
8600000US90045,34550,16628,17922,96812,133721,6683,90045
8600000US90046,46711,25396,21315,67667,110994,5356,90046
8600000US90047,38899,17035,21864,47477,62696,3069,90047
8600000US90048,20460,9485,10975,95197,142203,10910,90048
8600000US90049,30526,13796,16730,127658,222152,11010,90049
8600000US90056,6276,2397,3879,86100,126595,16776,90056
8600000US90057,38324,20910,17414,33861,44208,1368,90057
8600000US90058,1729,783,946,20982,36307,7971,90058
8600000US90059,29913,13657,16256,41995,51635,2294,90059
8600000US90061,20063,9184,10879,39739,54084,4242,90061
8600000US90062,26056,12211,13845,44835,60143,4729,90062
8600000US90063,39126,19518,19608,46613,60423,3121,90063
8600000US90064,20560,9713,10847,95865,150538,9197,90064
8600000US90065,38213,19129,19084,63147,92947,3720,90065
8600000US90066,49509,25221,24288,79088,111045,3428,90066
8600000US90067,2112,949,1163,129306,226934,46245,90067
8600000US90068,18723,9863,8860,83756,148340,10377,90068
8600000US90069,19359,11809,7550,92952,142159,11426,90069
8600000US90071,0,0,0,,,,90071
8600000US90073,916,823,93,,,,90073
8600000US90077,7080,3330,3750,210833,314963,36231,90077
8600000US90079,0,0,0,,,,90079
8600000US90089,3754,1773,1981,,,,90089
8600000US90090,0,0,0,,,,90090
8600000US90094,7379,3313,4066,146325,197913,20094,90094
8600000US90095,0,0,0,,,,90095
8600000US90201,71477,35694,35783,42255,51922,1176,90201
8600000US90210,15938,7374,8564,143542,285015,27266,90210
8600000US90211,6594,2922,3672,82212,134771,15309,90211
8600000US90212,10519,4905,5614,93846,164716,16864,90212
8600000US90220,38382,18218,20164,53988,64497,3016,90220
8600000US90221,36933,18363,18570,48762,59127,3064,90221
8600000US90222,22586,10892,11694,45689,56929,2610,90222
8600000US90230,26154,11889,14265,80677,108043,5637,90230
8600000US90232,12365,5853,6512,82164,115579,8631,90232
8600000US90240,19390,9245,10145,82722,107106,7099,90240
8600000US90241,34089,16942,17147,69308,82738,4128,90241
8600000US90242,32228,14805,17423,66019,81456,3472,90242
8600000US90245,12922,6101,6821,98813,123252,7818,90245
8600000US90247,37031,17982,19049,51386,66979,3371,90247
8600000US90248,9305,4667,4638,62179,83702,6365,90248
8600000US90249,20816,9628,11188,59778,78116,4919,90249
8600000US90250,71916,34212,37704,53303,70363,2000,90250
8600000US90254,16280,8707,7573,137188,198769,12224,90254
8600000US90255,55095,27491,27604,42581,54643,1895,90255
8600000US90260,27077,13921,13156,62047,76609,4359,90260
8600000US90262,50902,24059,26843,49801,63759,2926,90262
8600000US90263,1811,751,1060,,,,90263
8600000US90265,15477,7415,8062,149202,268512,27638,90265
8600000US90266,26350,12651,13699,150083,244248,13294,90266
8600000US90270,19385,9724,9661,39760,53933,3188,90270
8600000US90272,16995,7991,9004,194151,321822,22736,90272
8600000US90274,19692,9400,10292,162163,237069,14350,90274
8600000US90275,33156,15586,17570,133156,170403,8480,90275
8600000US90277,28084,13905,14179,102281,136151,6874,90277
8600000US90278,31330,16093,15237,118000,143486,6063,90278
8600000US90280,68727,33436,35291,50246,63193,2092,90280
8600000US90290,4266,2097,2169,118667,148834,19576,90290
8600000US90291,23757,12350,11407,91779,147458,9228,90291
8600000US90292,20329,10628,9701,109268,154761,13939,90292
8600000US90293,11538,5608,5930,103874,139737,10169,90293
8600000US90301,28324,13441,14883,44135,55718,3882,90301
8600000US90302,22724,10271,12453,47863,61916,3702,90302
8600000US90303,18405,8758,9647,50438,65174,3908,90303
8600000US90304,18603,9253,9350,44574,56728,3579,90304
8600000US90305,12927,5775,7152,74009,93656,6605,90305
8600000US90401,6877,3349,3528,72872,108484,13729,90401
8600000US90402,9191,4298,4893,147111,300069,32180,90402
8600000US90403,21041,9848,11193,107335,145057,13237,90403
8600000US90404,19124,9357,9767,75221,109200,9124,90404
8600000US90405,23706,11738,11968,94446,135291,9731,90405
8600000US90501,32170,15465,16705,70671,86206,3239,90501
8600000US90502,14887,7476,7411,69824,93739,11084,90502
8600000US90503,35867,17118,18749,90102,111890,4193,90503
8600000US90504,26999,13200,13799,86563,104607,5349,90504
8600000US90505,29009,13867,15142,96827,122390,5635,90505
8600000US90506,0,0,0,,,,90506
8600000US90601,25714,12500,13214,74296,90102,4120,90601
8600000US90602,19760,9443,10317,51237,72827,3621,90602
8600000US90603,16560,8304,8256,98181,104654,4728,90603
8600000US90604,32178,15455,16723,70877,85611,3431,90604
8600000US90605,30340,14783,15557,75575,95052,4161,90605
8600000US90606,25413,12562,12851,70640,84158,3980,90606
8600000US90620,36688,17610,19078,88082,104591,6157,90620
8600000US90621,26857,13454,13403,60799,81105,6560,90621
8600000US90623,13035,6224,6811,99576,122630,9691,90623
8600000US90630,38281,18089,20192,92073,111110,3954,90630
8600000US90631,53186,25493,27693,79500,106067,4313,90631
8600000US90638,40038,19134,20904,87429,103534,3884,90638
8600000US90640,48876,23321,25555,53615,69826,2828,90640
8600000US90650,80782,40147,40635,66453,79508,2154,90650
8600000US90660,48522,23532,24990,65617,76907,2743,90660
8600000US90670,12819,6063,6756,67500,79834,5863,90670
8600000US90680,22630,10763,11867,58402,74010,4424,90680
8600000US90701,13304,6324,6980,63792,80744,6951,90701
8600000US90703,40949,19606,21343,98934,120762,3990,90703
8600000US90704,2877,1462,1415,69828,92580,20654,90704
8600000US90706,57127,27577,29550,55729,72571,3264,90706
8600000US90710,21538,10126,11412,59817,77660,3658,90710
8600000US90712,24334,11444,12890,91242,101566,4087,90712
8600000US90713,22675,11015,11660,100132,111782,4831,90713
8600000US90715,15761,7564,8197,72616,86373,5733,90715
8600000US90716,10357,5184,5173,45150,55322,4371,90716
8600000US90717,17401,8518,8883,69150,90721,6006,90717
8600000US90720,17274,8043,9231,101484,126826,7327,90720
8600000US90723,39121,18792,20329,53031,61387,2508,90723
8600000US90731,46730,23832,22898,51161,76961,3655,90731
8600000US90732,18154,8344,9810,99519,118023,6139,90732
8600000US90740,21291,9696,11595,67970,107218,5912,90740
8600000US90742,653,338,315,81667,130312,34466,90742
8600000US90743,231,122,109,150208,171440,51661,90743
8600000US90744,40057,19611,20446,47776,61854,2615,90744
8600000US90745,44714,21295,23419,76551,92482,3996,90745
8600000US90746,21841,10208,11633,84523,100575,4619,90746
8600000US90747,0,0,0,,,,90747
8600000US90755,9188,4347,4841,75461,91260,6390,90755
8600000US90802,33705,18063,15642,53358,71149,4030,90802
8600000US90803,28681,14348,14333,87870,123294,6030,90803
8600000US90804,31153,14849,16304,49860,65498,3463,90804
8600000US90805,68557,32961,35596,49370,63574,2427,90805
8600000US90806,31600,14905,16695,49962,65024,4385,90806
8600000US90807,25739,12395,13344,77488,102732,6204,90807
8600000US90808,30869,14825,16044,109918,131700,6651,90808
8600000US90810,28596,13611,14985,58095,73099,3213,90810
8600000US90813,41169,20475,20694,36075,48693,2439,90813
8600000US90814,15701,7167,8534,69867,91277,6071,90814
8600000US90815,33396,16187,17209,88710,112094,4268,90815
8600000US90822,139,119,20,,,,90822
8600000US90831,0,0,0,,,,90831
8600000US91001,30238,14625,15613,98289,137757,9542,91001
8600000US91006,25725,12050,13675,100730,129342,6515,91006
8600000US91007,27415,12610,14805,80166,109833,6883,91007
8600000US91008,1011,451,560,117955,191151,36556,91008
8600000US91010,21350,10047,11303,72381,92664,8975,91010
8600000US91011,15308,7259,8049,161450,238909,16410,91011
8600000US91016,32847,15939,16908,74076,102492,5412,91016
8600000US91020,7098,3329,3769,73839,85007,8872,91020
8600000US91024,9000,4239,4761,96630,139631,10739,91024
8600000US91030,19563,9177,10386,96692,146042,8269,91030
8600000US91040,16846,8209,8637,81940,102055,7175,91040
8600000US91042,21932,11018,10914,55507,77979,4852,91042
8600000US91046,143,77,66,28125,41899,25296,91046
8600000US91101,18456,8271,10185,65592,84648,5698,91101
8600000US91103,22039,10522,11517,69059,108717,9438,91103
8600000US91104,29760,13748,16012,74011,102994,4824,91104
8600000US91105,10049,4798,5251,122917,171620,12566,91105
8600000US91106,21132,10428,10704,80291,115010,10535,91106
8600000US91107,26511,12763,13748,95630,130353,6199,91107
8600000US91108,10495,4900,5595,158884,217814,23929,91108
8600000US91201,19653,9027,10626,58004,89198,6500,91201
8600000US91202,19820,9050,10770,70841,99531,6645,91202
8600000US91203,12430,5897,6533,55783,77432,6144,91203
8600000US91204,15300,7010,8290,45245,61347,5647,91204
8600000US91205,31617,14556,17061,43769,62639,2658,91205
8600000US91206,28291,13101,15190,62915,89168,4836,91206
8600000US91207,9201,4197,5004,88365,138958,18886,91207
8600000US91208,12687,5864,6823,102950,139253,12497,91208
8600000US91210,512,299,213,159500,208144,71546,91210
8600000US91214,23933,11003,12930,100625,123978,5386,91214
8600000US91301,19954,9794,10160,121614,167322,11941,91301
8600000US91302,20197,9754,10443,129145,220887,16010,91302
8600000US91303,23552,12291,11261,55130,71237,4237,91303
8600000US91304,42011,20966,21045,68282,93518,4248,91304
8600000US91306,38698,19232,19466,67869,84763,4114,91306
8600000US91307,21073,9772,11301,116803,143130,6579,91307
8600000US91311,33130,16395,16735,86156,112763,5143,91311
8600000US91316,23637,10789,12848,74611,106450,7219,91316
8600000US91320,33920,16866,17054,115102,148141,5989,91320
8600000US91321,26048,12768,13280,68831,93691,4754,91321
8600000US91324,24181,12825,11356,75949,99564,5331,91324
8600000US91325,27903,13841,14062,68642,94280,5074,91325
8600000US91326,29362,14357,15005,112865,140812,6817,91326
8600000US91330,3197,1312,1885,,,,91330
8600000US91331,79208,40368,38840,60360,74642,2767,91331
8600000US91335,62617,30405,32212,60413,79053,3086,91335
8600000US91340,26683,13197,13486,53564,69250,4186,91340
8600000US91342,71548,35695,35853,70106,84462,2616,91342
8600000US91343,48792,23554,25238,62791,80607,2645,91343
8600000US91344,42813,21122,21691,92286,116097,5322,91344
8600000US91345,15102,7762,7340,75969,85335,7390,91345
8600000US91350,27433,13230,14203,112664,125919,4774,91350
8600000US91351,24452,11989,12463,80397,95067,4010,91351
8600000US91352,36367,17820,18547,55177,72208,3674,91352
8600000US91354,22929,11100,11829,126753,146283,6165,91354
8600000US91355,24248,11674,12574,92707,109758,4830,91355
8600000US91356,24880,11869,13011,74561,122873,8897,91356
8600000US91360,34998,16660,18338,95852,117314,5106,91360
8600000US91361,16655,7882,8773,121331,187436,13111,91361
8600000US91362,28338,13233,15105,109934,154463,8346,91362
8600000US91364,21867,10822,11045,103278,139766,8234,91364
8600000US91367,37278,17774,19504,87699,121050,5727,91367
8600000US91371,0,0,0,,,,91371
8600000US91377,10330,4951,5379,128622,161799,14556,91377
8600000US91381,14658,6921,7737,128310,164094,13789,91381
8600000US91384,22414,13527,8887,108102,118664,4462,91384
8600000US91387,31176,15131,16045,90433,109760,4058,91387
8600000US91390,14549,7627,6922,116298,134389,6427,91390
8600000US91401,32598,16478,16120,54058,80244,3294,91401
8600000US91402,52405,25396,27009,42857,58142,1874,91402
8600000US91403,21208,10143,11065,95944,144325,11052,91403
8600000US91405,41937,20419,21518,43548,61340,2912,91405
8600000US91406,42039,21739,20300,55542,74465,3135,91406
8600000US91411,19894,9684,10210,54555,76128,4802,91411
8600000US91423,28258,13102,15156,83732,135467,7109,91423
8600000US91436,11729,5414,6315,149423,232530,25507,91436
8600000US91501,16728,7899,8829,70326,93380,6641,91501
8600000US91502,9889,5001,4888,38147,56703,5862,91502
8600000US91504,21080,10070,11010,75825,109197,7461,91504
8600000US91505,24847,11984,12863,84651,104520,6023,91505
8600000US91506,15236,7036,8200,79148,105278,7200,91506
8600000US91601,32549,17217,15332,52607,72868,4893,91601
8600000US91602,16830,8370,8460,81917,109254,8950,91602
8600000US91604,26543,12836,13707,103470,159114,9314,91604
8600000US91605,41290,20495,20795,47000,64913,3155,91605
8600000US91606,34925,17160,17765,46397,64775,2586,91606
8600000US91607,25868,12162,13706,62139,91120,5618,91607
8600000US91608,0,0,0,,,,91608
8600000US91701,31181,15123,16058,94591,108992,4063,91701
8600000US91702,48449,22911,25538,62514,77497,3496,91702
8600000US91706,58633,29454,29179,62161,72364,2585,91706
8600000US91708,3060,652,2408,90612,100657,13692,91708
8600000US91709,60452,29239,31213,104590,119160,4026,91709
8600000US91710,71658,43005,28653,79592,94699,3429,91710
8600000US91711,29981,14354,15627,97593,127462,6256,91711
8600000US91722,26864,12774,14090,77459,87058,4004,91722
8600000US91723,14157,6898,7259,64583,80308,7828,91723
8600000US91724,20512,9960,10552,83598,100230,5162,91724
8600000US91730,54253,25855,28398,69034,82675,3255,91730
8600000US91731,22968,11434,11534,39383,54071,3366,91731
8600000US91732,48704,24385,24319,51899,67002,2631,91732
8600000US91733,33580,17080,16500,45519,58423,1741,91733
8600000US91737,19397,9105,10292,105406,125581,7010,91737
8600000US91739,29476,15105,14371,105221,130474,7375,91739
8600000US91740,20626,10022,10604,82447,97065,5587,91740
8600000US91741,20372,9460,10912,105874,133347,6939,91741
8600000US91744,66247,32857,33390,66278,78534,2373,91744
8600000US91745,44339,21770,22569,84224,105137,3966,91745
8600000US91746,23852,11656,12196,68254,78418,3275,91746
8600000US91748,38500,18630,19870,71000,89383,3655,91748
8600000US91750,26644,12862,13782,86352,108998,5856,91750
8600000US91752,24197,12060,12137,79181,96311,5188,91752
8600000US91754,27207,12484,14723,60261,83768,4050,91754
8600000US91755,23478,11238,12240,52624,77964,6605,91755
8600000US91759,335,149,186,52250,70962,13095,91759
8600000US91761,45388,22081,23307,71727,82760,2963,91761
8600000US91762,44235,21287,22948,56881,70173,2557,91762
8600000US91763,28330,13597,14733,58094,67427,3089,91763
8600000US91764,40199,19602,20597,56168,67823,2543,91764
8600000US91765,37644,18168,19476,97968,116961,5268,91765
8600000US91766,52855,25949,26906,55785,71631,2307,91766
8600000US91767,37530,17993,19537,57521,70282,3060,91767
8600000US91768,27128,12839,14289,51149,68404,3907,91768
8600000US91770,50785,24648,26137,53506,68784,2620,91770
8600000US91773,27359,12713,14646,84355,103382,5055,91773
8600000US91775,19743,9453,10290,82598,109546,6413,91775
8600000US91776,31933,15112,16821,54131,72021,3529,91776
8600000US91780,27496,12868,14628,68456,88610,4840,91780
8600000US91784,20531,10027,10504,118916,142621,8162,91784
8600000US91786,41348,19675,21673,58649,70100,2521,91786
8600000US91789,36052,17333,18719,99398,119425,5269,91789
8600000US91790,35186,16865,18321,79926,93191,3472,91790
8600000US91791,26848,12854,13994,80890,100715,4295,91791
8600000US91792,23588,11326,12262,77333,88783,3119,91792
8600000US91801,45272,21218,24054,55832,77641,3683,91801
8600000US91803,24919,12357,12562,60394,80843,3954,91803
8600000US91901,14338,7144,7194,92287,114789,16966,91901
8600000US91902,15998,7888,8110,95330,114772,8339,91902
8600000US91905,1346,694,652,34911,49757,17906,91905
8600000US91906,2933,1661,1272,47227,70405,11878,91906
8600000US91910,57923,28560,29363,61922,78413,2381,91910
8600000US91911,64466,31773,32693,58598,71107,2625,91911
8600000US91913,38214,18862,19352,96617,117117,14813,91913
8600000US91914,11257,5683,5574,133730,148439,11341,91914
8600000US91915,21863,10557,11306,112083,122929,8319,91915
8600000US91916,1479,718,761,98235,112497,17767,91916
8600000US91917,668,296,372,85096,89172,30546,91917
8600000US91931,328,142,186,,52361,20044,91931
8600000US91932,19910,9996,9914,51838,65996,3783,91932
8600000US91934,215,150,65,,46619,20009,91934
8600000US91935,6904,3413,3491,100534,118820,11494,91935
8600000US91941,25400,12165,13235,86791,107489,5435,91941
8600000US91942,32425,15212,17213,61628,76518,3036,91942
8600000US91945,20233,9877,10356,62698,70931,3085,91945
8600000US91948,15,15,0,,,,91948
8600000US91950,49372,24843,24529,45712,61820,3013,91950
8600000US91962,1815,893,922,107390,116194,15924,91962
8600000US91963,799,436,363,,67121,20628,91963
8600000US91977,47410,22903,24507,64173,79473,2568,91977
8600000US91978,7712,3781,3931,72933,84110,6414,91978
8600000US91980,528,267,261,,,,91980
8600000US92003,4063,2116,1947,77208,124293,19449,92003
8600000US92004,2057,1063,994,38856,62600,14571,92004
8600000US92007,9042,4104,4938,106811,145054,17169,92007
8600000US92008,22439,11204,11235,85980,116997,6608,92008
8600000US92009,34047,16007,18040,126348,164380,7953,92009
8600000US92010,11910,5417,6493,102095,118422,9959,92010
8600000US92011,18687,8820,9867,114691,152857,9572,92011
8600000US92014,11316,5735,5581,140625,209938,20552,92014
8600000US92019,33249,16176,17073,82261,100179,4416,92019
8600000US92020,44539,22431,22108,55666,76025,3095,92020
8600000US92021,53194,26241,26953,56863,75251,2912,92021
8600000US92024,40731,19997,20734,114131,160647,9434,92024
8600000US92025,39335,19859,19476,60042,82523,4224,92025
8600000US92026,38807,19276,19531,71597,90371,3842,92026
8600000US92027,42534,21562,20972,63904,82558,3799,92027
8600000US92028,38434,18831,19603,69620,95164,5172,92028
8600000US92029,15427,7412,8015,90278,115692,7043,92029
8600000US92036,1999,1117,882,52451,58030,7705,92036
8600000US92037,32353,15476,16877,105904,185349,9245,92037
8600000US92040,35447,17977,17470,74918,89820,4204,92040
8600000US92054,33180,16904,16276,60017,83520,5067,92054
8600000US92055,11889,11101,788,,,,92055
8600000US92056,43381,20873,22508,77751,92686,2803,92056
8600000US92057,45451,22340,23111,72633,92416,3938,92057
8600000US92058,31964,17102,14862,46010,63524,4224,92058
8600000US92059,1019,463,556,94399,127361,25023,92059
8600000US92060,92,43,49,,67329,29967,92060
8600000US92061,1465,754,711,44325,70266,13829,92061
8600000US92064,37762,18080,19682,105788,133963,4767,92064
8600000US92065,28402,14291,14111,89750,107365,4194,92065
8600000US92066,428,208,220,59688,71909,17581,92066
8600000US92067,6945,3405,3540,163281,221052,27796,92067
8600000US92069,37914,18995,18919,69625,90938,4990,92069
8600000US92070,647,309,338,47583,79988,21336,92070
8600000US92071,45093,21074,24019,83712,95040,3177,92071
8600000US92075,10435,4759,5676,105027,148785,12359,92075
8600000US92078,36371,17216,19155,79673,104783,6110,92078
8600000US92081,23499,12319,11180,76134,90713,5381,92081
8600000US92082,14227,6912,7315,83788,103534,7282,92082
8600000US92083,28718,14976,13742,63262,74640,3469,92083
8600000US92084,38530,18989,19541,66099,88174,3246,92084
8600000US92086,1428,705,723,37333,69337,16879,92086
8600000US92091,1227,559,668,141818,188154,55131,92091
8600000US92101,37784,21313,16471,66202,98404,7608,92101
8600000US92102,33883,17449,16434,47467,64099,3090,92102
8600000US92103,31065,15625,15440,77551,110648,6681,92103
8600000US92104,38724,19563,19161,64157,84250,3880,92104
8600000US92105,53888,26216,27672,40947,55864,2599,92105
8600000US92106,15389,7886,7503,102250,146947,15261,92106
8600000US92107,27393,13921,13472,82522,105077,5622,92107
8600000US92108,19773,10042,9731,72170,89635,5629,92108
8600000US92109,43469,23381,20088,77774,101991,4434,92109
8600000US92110,25478,12193,13285,68368,90469,5336,92110
8600000US92111,39479,19920,19559,69442,85900,3534,92111
8600000US92113,40325,21450,18875,36787,48644,2416,92113
8600000US92114,54261,26887,27374,64390,79051,2666,92114
8600000US92115,53517,26270,27247,48442,68497,3399,92115
8600000US92116,29331,15000,14331,67461,91136,4696,92116
8600000US92117,46174,23285,22889,77621,95744,2877,92117
8600000US92118,18198,9610,8588,101520,145423,8131,92118
8600000US92119,19208,8935,10273,84191,103749,6918,92119
8600000US92120,23843,11686,12157,91947,116348,6843,92120
8600000US92121,3877,2208,1669,106688,132701,11830,92121
8600000US92122,42769,22162,20607,80232,98778,3707,92122
8600000US92123,25319,13039,12280,78880,97537,4278,92123
8600000US92124,22650,11051,11599,89080,111370,6424,92124
8600000US92126,66934,34712,32222,93994,108611,3075,92126
8600000US92127,33261,15828,17433,134769,167102,9604,92127
8600000US92128,40802,18793,22009,97952,117419,4021,92128
8600000US92129,40826,20047,20779,121357,138965,4459,92129
8600000US92130,40294,19586,20708,149344,192395,8255,92130
8600000US92131,24811,11977,12834,128653,159743,6370,92131
8600000US92132,0,0,0,,,,92132
8600000US92134,280,209,71,,,,92134
8600000US92135,646,559,87,,,,92135
8600000US92139,28365,13440,14925,64510,76309,3185,92139
8600000US92140,3645,3536,109,,,,92140
8600000US92145,1598,756,842,162700,233520,44532,92145
8600000US92147,551,512,39,,,,92147
8600000US92154,66923,34497,32426,64942,76324,2357,92154
8600000US92155,490,474,16,,,,92155
8600000US92173,23042,10574,12468,42561,53897,2325,92173
8600000US92201,49451,22823,26628,42757,57868,2822,92201
8600000US92203,24144,11882,12262,67739,85426,5225,92203
8600000US92210,4814,2374,2440,99871,181676,26270,92210
8600000US92211,22781,10427,12354,62043,100484,8820,92211
8600000US92220,25434,12204,13230,41144,54773,2837,92220
8600000US92222,0,0,0,,,,92222
8600000US92223,39218,18749,20469,73588,87449,3351,92223
8600000US92225,17295,11465,5830,41886,61696,4899,92225
8600000US92227,18333,8917,9416,43460,62469,6073,92227
8600000US92230,2596,1067,1529,48284,51235,10727,92230
8600000US92231,28547,13039,15508,40759,59321,6333,92231
8600000US92233,6309,5168,1141,35230,42402,6476,92233
8600000US92234,40880,20850,20030,46367,70274,7624,92234
8600000US92236,33309,15962,17347,34222,45494,2242,92236
8600000US92239,255,140,115,40000,57017,24871,92239
8600000US92240,24668,12158,12510,36067,47019,3052,92240
8600000US92241,6675,3473,3202,30532,44788,4280,92241
8600000US92242,1050,479,571,29063,40455,6350,92242
8600000US92243,35873,17319,18554,46648,65649,3438,92243
8600000US92249,5373,2597,2776,44293,55433,8531,92249
8600000US92250,6415,3409,3006,53042,66605,9449,92250
8600000US92251,17100,10263,6837,84544,91632,9575,92251
8600000US92252,7460,3747,3713,37632,52336,6927,92252
8600000US92253,31949,15550,16399,81193,120097,8472,92253
8600000US92254,7189,3743,3446,24755,33129,3134,92254
8600000US92256,2714,1378,1336,50515,58036,7049,92256
8600000US92257,1047,512,535,21250,33662,7425,92257
8600000US92258,728,445,283,,31397,13797,92258
8600000US92259,87,32,55,31786,48220,26755,92259
8600000US92260,29057,13753,15304,54099,82015,4511,92260
8600000US92262,24107,13639,10468,49229,80000,4092,92262
8600000US92264,18222,10815,7407,50795,83669,3965,92264
8600000US92266,108,80,28,28125,31684,12975,92266
8600000US92267,5,5,0,,,,92267
8600000US92268,541,288,253,47500,56346,10737,92268
8600000US92270,16840,8576,8264,71227,120123,9729,92270
8600000US92273,1227,580,647,27054,34003,8015,92273
8600000US92274,10768,5698,5070,27779,36996,3124,92274
8600000US92275,1764,744,1020,27794,40530,9783,92275
8600000US92276,6043,2947,3096,44970,57364,7422,92276
8600000US92277,16874,8698,8176,40903,52482,4708,92277
8600000US92278,4088,3788,300,41912,65582,23004,92278
8600000US92280,19,19,0,,,,92280
8600000US92281,1797,850,947,35809,47239,4753,92281
8600000US92282,999,482,517,37177,49058,16626,92282
8600000US92283,1205,582,623,23413,39812,7297,92283
8600000US92284,20070,9667,10403,41989,60084,4098,92284
8600000US92285,1964,1005,959,31458,41747,8719,92285
8600000US92301,21812,11421,10391,38591,49336,4136,92301
8600000US92304,21,21,0,,,,92304
8600000US92305,499,243,256,53854,76402,18412,92305
8600000US92307,28599,14208,14391,58819,83281,7663,92307
8600000US92308,30900,14634,16266,49098,65056,3000,92308
8600000US92309,390,205,185,38750,42522,12150,92309
8600000US92310,5907,3638,2269,53333,59622,4601,92310
8600000US92311,22648,10444,12204,42409,56387,3801,92311
8600000US92313,10059,4586,5473,67034,80421,6034,92313
8600000US92314,8734,4315,4419,51752,67351,5740,92314
8600000US92315,4128,2034,2094,51083,75626,9948,92315
8600000US92316,21632,10708,10924,55603,64523,3267,92316
8600000US92320,6931,3373,3558,52983,68640,5560,92320
8600000US92321,925,520,405,62171,75178,18660,92321
8600000US92322,536,245,291,29750,48514,20734,92322
8600000US92324,42586,19714,22872,51105,63488,2926,92324
8600000US92325,6858,3420,3438,57153,71523,6782,92325
8600000US92327,615,389,226,27917,36149,14517,92327
8600000US92328,336,204,132,34375,45053,10667,92328
8600000US92332,92,89,3,,,,92332
8600000US92333,316,142,174,74706,80498,25400,92333
8600000US92335,69568,34204,35364,50730,60229,2048,92335
8600000US92336,69738,33519,36219,90172,103673,3191,92336
8600000US92337,27973,14053,13920,77087,90135,4243,92337
8600000US92338,0,0,0,,,,92338
8600000US92339,900,463,437,60625,75310,13636,92339
8600000US92341,189,103,86,,45793,27186,92341
8600000US92342,4911,2535,2376,75109,78342,8901,92342
8600000US92344,16801,8562,8239,82229,97722,10958,92344
8600000US92345,56123,27686,28437,50836,61933,2324,92345
8600000US92346,45911,23447,22464,61823,83622,2922,92346
8600000US92347,661,325,336,45168,36644,11097,92347
8600000US92352,4563,2083,2480,79340,102198,13345,92352
8600000US92354,17746,8152,9594,54850,79576,5539,92354
8600000US92356,4780,2412,2368,30513,44337,6417,92356
8600000US92358,721,338,383,41100,51515,10356,92358
8600000US92359,6892,3352,3540,62306,77793,5190,92359
8600000US92363,4042,1869,2173,31958,46046,5152,92363
8600000US92364,0,0,0,,,,92364
8600000US92365,2128,1124,1004,55729,57589,7485,92365
8600000US92368,720,377,343,32545,53653,18415,92368
8600000US92371,13186,6490,6696,55153,66272,5548,92371
8600000US92372,4966,2354,2612,50964,70878,11959,92372
8600000US92373,25854,11695,14159,69818,103587,8281,92373
8600000US92374,33455,16027,17428,71297,91446,6101,92374
8600000US92376,61722,30298,31424,52618,64444,2419,92376
8600000US92377,14663,6896,7767,83384,95212,6150,92377
8600000US92378,243,114,129,78571,84052,19359,92378
8600000US92382,3517,1714,1803,58073,71723,8708,92382
8600000US92384,13,10,3,167500,144940,70708,92384
8600000US92385,178,85,93,49464,72960,41384,92385
8600000US92386,1708,764,944,40714,51454,10198,92386
8600000US92389,111,61,50,27625,29313,10405,92389
8600000US92391,1786,927,859,43523,55604,11344,92391
8600000US92392,39328,18220,21108,57885,71458,4141,92392
8600000US92394,23600,12614,10986,53636,66084,5354,92394
8600000US92395,30136,14579,15557,47921,66905,4627,92395
8600000US92397,3229,1521,1708,61496,87338,15404,92397
8600000US92398,1499,691,808,54073,69211,22259,92398
8600000US92399,40983,19278,21705,63984,82274,3566,92399
8600000US92401,1466,688,778,23295,36417,8392,92401
8600000US92404,42784,20276,22508,44474,57066,2359,92404
8600000US92405,20862,10043,10819,39681,49996,3238,92405
8600000US92407,48954,24626,24328,63171,75498,2877,92407
8600000US92408,10416,5686,4730,39472,50566,4388,92408
8600000US92410,29994,14296,15698,30072,43846,2827,92410
8600000US92411,17905,8453,9452,40539,51691,4847,92411
8600000US92501,16543,8413,8130,56239,69639,4818,92501
8600000US92503,69569,34708,34861,66579,82790,4100,92503
8600000US92504,44957,21642,23315,62699,81299,3954,92504
8600000US92505,38520,18890,19630,64505,77758,2637,92505
8600000US92506,35839,17268,18571,91216,115912,5363,92506
8600000US92507,46849,23447,23402,48872,63158,2846,92507
8600000US92508,28688,13718,14970,104668,121591,5653,92508
8600000US92509,58424,30069,28355,66232,78297,2887,92509
8600000US92518,903,454,449,74741,81017,10367,92518
8600000US92530,39290,19340,19950,55399,66972,2960,92530
8600000US92532,17280,8480,8800,85181,93744,7210,92532
8600000US92536,2389,1245,1144,53107,67982,15814,92536
8600000US92539,3604,1900,1704,42370,55559,11099,92539
8600000US92543,26775,11739,15036,33197,43136,2244,92543
8600000US92544,36471,18097,18374,49793,65950,3369,92544
8600000US92545,32135,15297,16838,46910,60847,3216,92545
8600000US92548,5756,2935,2821,44717,53394,5551,92548
8600000US92549,2134,1056,1078,68977,75825,10096,92549
8600000US92551,23360,10827,12533,61938,71753,3730,92551
8600000US92553,52915,25968,26947,50741,61007,2178,92553
8600000US92555,31834,15226,16608,84612,96464,4387,92555
8600000US92557,38460,18587,19873,70234,82632,2762,92557
8600000US92561,1120,673,447,71343,84330,22880,92561
8600000US92562,47191,22167,25024,89002,111168,4989,92562
8600000US92563,46420,22919,23501,90906,104836,4960,92563
8600000US92567,7235,3677,3558,68086,78555,6067,92567
8600000US92570,42679,22020,20659,52325,69780,5566,92570
8600000US92571,37983,19534,18449,61780,70066,3567,92571
8600000US92582,11047,5296,5751,70578,76862,5265,92582
8600000US92583,23968,11796,12172,42931,57889,3842,92583
8600000US92584,36837,18087,18750,88201,99609,3542,92584
8600000US92585,15994,7824,8170,73417,92072,6071,92585
8600000US92586,17284,7426,9858,39780,54036,3130,92586
8600000US92587,13215,6585,6630,80156,104405,10755,92587
8600000US92590,3486,1880,1606,70865,114594,30699,92590
8600000US92591,30187,13877,16310,83189,102621,5601,92591
8600000US92592,59828,29925,29903,101676,119549,4723,92592
8600000US92595,25323,12285,13038,74735,88843,4060,92595
8600000US92596,20182,10179,10003,101327,112396,6050,92596
8600000US92602,17659,7893,9766,105433,135709,16988,92602
8600000US92603,14561,7252,7309,131196,201535,21837,92603
8600000US92604,22100,10686,11414,105108,127991,7679,92604
8600000US92606,18783,9224,9559,96588,124191,11627,92606
8600000US92610,10276,4717,5559,131845,156097,10714,92610
8600000US92612,28844,14373,14471,79366,112634,8209,92612
8600000US92614,20761,10144,10617,97742,124854,7179,92614
8600000US92617,15837,6636,9201,39135,80489,8107,92617
8600000US92618,33063,16926,16137,101822,131295,9935,92618
8600000US92620,36281,16739,19542,110483,133603,7581,92620
8600000US92624,5417,2672,2745,97976,132316,18203,92624
8600000US92625,10381,4771,5610,140232,233336,24770,92625
8600000US92626,41384,20468,20916,84968,107611,4118,92626
8600000US92627,49227,25453,23774,71776,99335,4862,92627
8600000US92629,21933,10571,11362,100243,143112,10992,92629
8600000US92630,49080,24187,24893,92552,117062,5250,92630
8600000US92637,16218,5816,10402,41928,58892,4602,92637
8600000US92646,45440,22080,23360,96915,117287,3554,92646
8600000US92647,48144,24017,24127,80218,101921,4240,92647
8600000US92648,38687,19833,18854,93413,134697,7568,92648
8600000US92649,28444,14267,14177,97459,127982,7039,92649
8600000US92651,20786,10176,10610,126469,204080,20530,92651
8600000US92653,23568,11277,12291,99078,141266,7422,92653
8600000US92655,6467,3023,3444,42342,61704,7630,92655
8600000US92656,39524,18493,21031,108288,127707,3776,92656
8600000US92657,7982,3941,4041,204688,308022,36822,92657
8600000US92660,28677,13358,15319,122222,190129,10060,92660
8600000US92661,2957,1555,1402,106673,203000,53613,92661
8600000US92662,2336,1047,1289,106143,223394,47375,92662
8600000US92663,18767,9660,9107,103965,157989,12891,92663
8600000US92672,28359,13698,14661,81347,120313,7484,92672
8600000US92673,22740,11441,11299,147747,185642,11960,92673
8600000US92675,28411,13546,14865,88692,134807,9735,92675
8600000US92676,1769,963,806,103935,128961,13230,92676
8600000US92677,53171,25368,27803,103322,140673,6242,92677
8600000US92678,446,238,208,90962,101867,21373,92678
8600000US92679,24534,12194,12340,162447,205683,8890,92679
8600000US92683,73533,36460,37073,61813,86467,2990,92683
8600000US92688,33001,15606,17395,108876,131451,6267,92688
8600000US92691,40696,20187,20509,113280,131872,6509,92691
8600000US92692,38130,18473,19657,114167,140655,4856,92692
8600000US92694,18241,8843,9398,166262,207449,12554,92694
8600000US92701,36559,19073,17486,46728,60058,3118,92701
8600000US92703,51492,26400,25092,57186,72285,2522,92703
8600000US92704,67029,34462,32567,65645,81961,2912,92704
8600000US92705,35497,17717,17780,101711,145032,7889,92705
8600000US92706,25670,12498,13172,64102,89042,5231,92706
8600000US92707,45755,22859,22896,73648,84405,2753,92707
8600000US92708,46000,22257,23743,84509,110168,5902,92708
8600000US92780,46279,22348,23931,70536,91747,3759,92780
8600000US92782,16959,8210,8749,112204,153094,9939,92782
8600000US92801,48541,23367,25174,60554,75175,4758,92801
8600000US92802,31965,15588,16377,58944,73523,3254,92802
8600000US92804,67771,32708,35063,61611,79803,3575,92804
8600000US92805,53950,27005,26945,63691,78698,2597,92805
8600000US92806,31048,15742,15306,68272,83948,3452,92806
8600000US92807,28974,13975,14999,107390,132536,6157,92807
8600000US92808,15823,7670,8153,124466,155744,8341,92808
8600000US92821,29077,13813,15264,89970,109358,5738,92821
8600000US92823,3366,1546,1820,144325,165969,19428,92823
8600000US92831,30090,14839,15251,65948,90103,4186,92831
8600000US92832,19322,9594,9728,61208,78834,4838,92832
8600000US92833,40132,19638,20494,74578,98617,4787,92833
8600000US92835,19208,9146,10062,102929,144104,9347,92835
8600000US92840,43442,21685,21757,68233,83453,3656,92840
8600000US92841,26844,13388,13456,59882,76167,3863,92841
8600000US92843,35588,18227,17361,60232,75525,4127,92843
8600000US92844,18936,9141,9795,57126,71684,3940,92844
8600000US92845,12868,6225,6643,99063,115313,6665,92845
8600000US92860,21227,11853,9374,96214,115998,6642,92860
8600000US92861,4753,2262,2491,146417,209509,34727,92861
8600000US92865,16161,8143,8018,101643,113304,6426,92865
8600000US92866,12277,5243,7034,72846,90247,10842,92866
8600000US92867,34101,16381,17720,90233,123884,7687,92867
8600000US92868,22033,12431,9602,65217,79935,6183,92868
8600000US92869,28794,13948,14846,102536,129979,6529,92869
8600000US92870,41040,19659,21381,89360,109953,4451,92870
8600000US92879,35345,17644,17701,66638,80221,2715,92879
8600000US92880,48618,23744,24874,105087,117421,4984,92880
8600000US92881,25514,12348,13166,98861,122881,10609,92881
8600000US92882,53559,26049,27510,75804,92980,2311,92882
8600000US92883,25378,12421,12957,106403,121328,6681,92883
8600000US92886,38634,18567,20067,123737,154190,6878,92886
8600000US92887,15600,7572,8028,142615,170900,8267,92887
8600000US93001,26354,13295,13059,65884,84212,4890,93001
8600000US93003,40549,19694,20855,77185,95778,3850,93003
8600000US93004,23671,11277,12394,82240,100731,6554,93004
8600000US93010,35160,17475,17685,92045,115460,6004,93010
8600000US93012,29712,13530,16182,103043,133121,6277,93012
8600000US93013,13471,6580,6891,77711,123631,12523,93013
8600000US93015,12994,6194,6800,67882,78873,5905,93015
8600000US93021,29237,13980,15257,104483,137312,6104,93021
8600000US93022,5774,3074,2700,75500,99555,11302,93022
8600000US93023,16996,8009,8987,72670,106206,7772,93023
8600000US93030,43491,21823,21668,68543,84698,5099,93030
8600000US93033,58829,30944,27885,61698,72884,2019,93033
8600000US93035,23456,11361,12095,86630,106116,5809,93035
8600000US93036,34175,17043,17132,70173,86565,3680,93036
8600000US93040,1360,595,765,49853,60796,8136,93040
8600000US93041,18296,9375,8921,63103,70745,3695,93041
8600000US93042,107,107,0,,,,93042
8600000US93043,119,57,62,88333,104506,76304,93043
8600000US93060,24347,12025,12322,58352,74393,4967,93060
8600000US93063,44824,21692,23132,89341,110453,4862,93063
8600000US93064,0,0,0,,,,93064
8600000US93065,55956,27324,28632,98946,123268,5056,93065
8600000US93066,2634,1436,1198,101827,156830,28387,93066
8600000US93067,454,179,275,57788,86041,34525,93067
8600000US93101,25934,13007,12927,56697,79380,4650,93101
8600000US93103,16864,9038,7826,90986,121079,8830,93103
8600000US93105,22731,10639,12092,91966,124300,6593,93105
8600000US93108,8986,4144,4842,139130,247597,25181,93108
8600000US93109,10111,5301,4810,96799,142960,15401,93109
8600000US93110,13570,6825,6745,81429,122985,14515,93110
8600000US93111,14214,6817,7397,106750,135196,6718,93111
8600000US93117,50975,25276,25699,62547,87833,3376,93117
8600000US93201,910,487,423,31154,38685,5313,93201
8600000US93202,2527,1428,1099,48302,56723,7892,93202
8600000US93203,14423,7274,7149,38836,48553,2394,93203
8600000US93204,9107,6318,2789,41709,46914,4086,93204
8600000US93205,1217,607,610,22746,40359,9229,93205
8600000US93206,1172,608,564,36172,51677,11021,93206
8600000US93207,202,114,88,18846,33171,14747,93207
8600000US93208,47,2,45,,,,93208
8600000US93210,13552,8493,5059,59302,80925,9158,93210
8600000US93212,18900,13659,5241,38075,47683,4712,93212
8600000US93215,40385,24013,16372,41877,55364,3638,93215
8600000US93218,572,311,261,24583,40648,9151,93218
8600000US93219,6728,3526,3202,29176,43290,6433,93219
8600000US93220,58,58,0,,,,93220
8600000US93221,10294,5022,5272,50469,74713,5947,93221
8600000US93222,1153,602,551,60742,78125,17530,93222
8600000US93223,7347,3458,3889,38360,48680,3797,93223
8600000US93224,333,170,163,43250,56178,7883,93224
8600000US93225,3780,1875,1905,43021,62256,15912,93225
8600000US93226,170,96,74,44464,64192,22517,93226
8600000US93230,48012,24357,23655,59904,77095,3111,93230
8600000US93234,4576,2338,2238,24412,34740,5252,93234
8600000US93235,3046,1499,1547,33441,39804,6960,93235
8600000US93238,830,438,392,,63631,23035,93238
8600000US93239,1017,501,516,29145,45447,12272,93239
8600000US93240,5183,2343,2840,42758,53505,6840,93240
8600000US93241,11159,5706,5453,39463,45507,3516,93241
8600000US93242,2421,1195,1226,44741,67216,11991,93242
8600000US93243,1533,832,701,40595,47031,10455,93243
8600000US93244,344,190,154,67625,113797,40518,93244
8600000US93245,27447,14466,12981,57314,70398,3357,93245
8600000US93247,12941,6792,6149,34309,48638,4989,93247
8600000US93249,1340,727,613,35094,42359,5448,93249
8600000US93250,10628,5943,4685,35112,44575,3703,93250
8600000US93251,187,99,88,45500,56764,13821,93251
8600000US93252,2320,1779,541,30526,44880,7403,93252
8600000US93254,609,300,309,54444,63313,10757,93254
8600000US93255,538,223,315,23333,49764,34770,93255
8600000US93256,3490,1581,1909,27611,36910,5320,93256
8600000US93257,52701,26255,26446,41048,57960,2678,93257
8600000US93258,1605,949,656,28387,42957,11821,93258
8600000US93260,181,99,82,40521,46485,16870,93260
8600000US93261,1937,1067,870,20845,30040,4340,93261
8600000US93262,63,32,31,,,,93262
8600000US93263,14455,7559,6896,42953,58240,4966,93263
8600000US93265,2926,1579,1347,59191,75594,12341,93265
8600000US93266,843,373,470,46107,61488,16918,93266
8600000US93267,4372,2212,2160,32319,48936,8713,93267
8600000US93268,12075,6127,5948,46289,62477,5174,93268
8600000US93270,3911,2103,1808,37697,63736,13547,93270
8600000US93271,2086,1075,1011,70972,87320,12092,93271
8600000US93272,2779,1528,1251,34706,46421,5111,93272
8600000US93274,49749,24537,25212,52096,68698,4148,93274
8600000US93276,129,74,55,27361,48293,14847,93276
8600000US93277,38136,17847,20289,57596,78546,4371,93277
8600000US93280,20698,13052,7646,37770,47821,3781,93280
8600000US93283,2022,1149,873,34611,43208,11220,93283
8600000US93285,1970,940,1030,30665,48446,12693,93285
8600000US93286,6590,3209,3381,42489,59746,6197,93286
8600000US93287,96,56,40,92083,87380,17512,93287
8600000US93291,39714,19758,19956,57223,84493,6003,93291
8600000US93292,28318,13500,14818,54832,72375,5179,93292
8600000US93301,8690,4107,4583,35412,53525,5372,93301
8600000US93304,34528,16992,17536,38102,50725,3172,93304
8600000US93305,24931,12126,12805,31454,41325,1875,93305
8600000US93306,50420,24547,25873,53254,74055,4073,93306
8600000US93307,55739,27566,28173,38891,50843,2102,93307
8600000US93308,39898,19907,19991,43659,60105,2430,93308
8600000US93309,44361,21580,22781,50742,65751,2481,93309
8600000US93311,33378,16776,16602,95293,121943,5761,93311
8600000US93312,42382,20987,21395,97311,115927,5047,93312
8600000US93313,36520,17890,18630,72946,85885,5168,93313
8600000US93314,20484,10222,10262,108767,131775,8084,93314
8600000US93401,23633,12207,11426,65846,95889,5717,93401
8600000US93402,13390,6484,6906,75302,98692,12702,93402
8600000US93405,34157,19902,14255,45611,73074,5697,93405
8600000US93410,0,0,0,,,,93410
8600000US93420,24320,11895,12425,83210,104804,5102,93420
8600000US93422,26278,13219,13059,82548,100731,5742,93422
8600000US93424,750,406,344,71090,113970,46367,93424
8600000US93426,1343,772,571,81917,92749,13434,93426
8600000US93427,4639,2343,2296,82917,98643,9774,93427
8600000US93428,5398,2574,2824,69766,85596,6180,93428
8600000US93429,99,36,63,49286,57000,12076,93429
8600000US93430,2621,1329,1292,63373,87231,15259,93430
8600000US93432,877,408,469,90321,109339,26173,93432
8600000US93433,10090,4801,5289,68333,80559,6989,93433
8600000US93434,4872,2353,2519,45361,56653,5803,93434
8600000US93436,41831,22277,19554,59375,79112,3828,93436
8600000US93437,2225,1361,864,63777,71860,6406,93437
8600000US93440,1171,608,563,71433,107579,25167,93440
8600000US93441,857,406,451,101964,129597,22926,93441
8600000US93442,9395,4573,4822,68115,79334,5839,93442
8600000US93444,16536,8306,8230,83222,105682,7816,93444
8600000US93445,5683,2814,2869,64541,75801,7799,93445
8600000US93446,35175,16861,18314,65694,87638,4265,93446
8600000US93449,7235,3493,3742,88003,114472,10465,93449
8600000US93450,529,288,241,51250,63190,16730,93450
8600000US93451,2958,1501,1457,63401,81445,11741,93451
8600000US93452,638,393,245,,61869,22447,93452
8600000US93453,2494,1238,1256,43186,65551,22340,93453
8600000US93454,28599,14110,14489,62015,75293,3296,93454
8600000US93455,34679,16360,18319,84404,100266,3788,93455
8600000US93458,37590,18962,18628,53890,65612,2251,93458
8600000US93460,4048,2039,2009,92557,119530,13412,93460
8600000US93461,1159,555,604,56208,67780,13332,93461
8600000US93463,6465,2907,3558,81914,117922,15168,93463
8600000US93465,6717,3259,3458,84366,106200,8625,93465
8600000US93501,3710,1930,1780,32109,45372,6404,93501
8600000US93505,10600,6340,4260,48312,62039,6809,93505
8600000US93510,6353,3432,2921,102563,122530,9429,93510
8600000US93512,292,139,153,45481,43285,13367,93512
8600000US93513,1340,656,684,57813,67775,5900,93513
8600000US93514,11533,5813,5720,57027,73197,3754,93514
8600000US93516,1810,903,907,46739,54976,8760,93516
8600000US93517,499,308,191,60878,67947,19679,93517
8600000US93518,795,401,394,36298,64032,17649,93518
8600000US93519,22,22,0,,,,93519
8600000US93522,56,32,24,,21172,10047,93522
8600000US93523,2186,1147,1039,63274,78627,9328,93523
8600000US93524,168,159,9,,,,93524
8600000US93526,500,278,222,41625,57546,8581,93526
8600000US93527,1403,555,848,72595,76408,21744,93527
8600000US93528,111,72,39,,,,93528
8600000US93529,364,184,180,,93425,61909,93529
8600000US93530,15,10,5,,56907,43177,93530
8600000US93531,295,157,138,135917,129924,52121,93531
8600000US93532,2238,1123,1115,62932,80988,11993,93532
8600000US93534,28407,12798,15609,39906,49109,2009,93534
8600000US93535,50536,24371,26165,43929,54539,2259,93535
8600000US93536,53833,28697,25136,75380,91653,3494,93536
8600000US93541,180,109,71,,72668,23992,93541
8600000US93543,10550,5268,5282,48542,69703,7213,93543
8600000US93544,1045,564,481,44156,65724,16977,93544
8600000US93545,1432,722,710,43859,55463,8794,93545
8600000US93546,7506,3853,3653,66500,83895,9643,93546
8600000US93549,261,148,113,61875,76819,24040,93549
8600000US93550,52428,24950,27478,41675,54760,2114,93550
8600000US93551,37963,18307,19656,92500,108317,4282,93551
8600000US93552,27779,13702,14077,63261,75614,7195,93552
8600000US93553,1538,680,858,57833,76072,15574,93553
8600000US93554,64,28,36,,34354,30621,93554
8600000US93555,24611,12335,12276,64431,80715,5571,93555
8600000US93558,40,31,9,,18968,10295,93558
8600000US93560,14688,7771,6917,56274,72263,4522,93560
8600000US93561,27020,15566,11454,63288,79427,6094,93561
8600000US93562,1225,587,638,34643,46185,7204,93562
8600000US93563,400,235,165,82656,105609,44804,93563
8600000US93591,4583,2263,2320,46258,51213,5251,93591
8600000US93592,62,40,22,63194,64620,32080,93592
8600000US93601,1466,823,643,59278,71845,13417,93601
8600000US93602,3110,1606,1504,65231,74927,8083,93602
8600000US93603,136,63,73,28828,155951,210724,93603
8600000US93604,599,249,350,84186,119450,48222,93604
8600000US93605,101,50,51,91250,96047,22741,93605
8600000US93606,615,283,332,30855,46764,12731,93606
8600000US93608,688,324,364,39844,43403,7587,93608
8600000US93609,4010,1961,2049,41569,53906,6784,93609
8600000US93610,18256,7533,10723,48694,64787,5173,93610
8600000US93611,35304,16681,18623,87379,101233,3205,93611
8600000US93612,26548,13016,13532,42664,54950,4259,93612
8600000US93614,9236,4222,5014,64722,83599,6270,93614
8600000US93615,4386,2285,2101,36311,46096,6843,93615
8600000US93616,1904,991,913,35066,52935,9385,93616
8600000US93618,20536,10082,10454,42665,59906,3875,93618
8600000US93619,26905,13551,13354,118010,138604,5876,93619
8600000US93620,6223,2970,3253,42484,63804,8569,93620
8600000US93621,94,64,30,42353,45892,18906,93621
8600000US93622,7237,3485,3752,42399,54198,6492,93622
8600000US93623,123,66,57,108092,76390,27504,93623
8600000US93624,679,417,262,32167,38409,6177,93624
8600000US93625,5569,2783,2786,55588,70421,6970,93625
8600000US93626,1514,683,831,82500,110745,27787,93626
8600000US93627,130,39,91,,,,93627
8600000US93628,127,66,61,,62213,27450,93628
8600000US93630,13611,6953,6658,46311,68444,8830,93630
8600000US93631,11847,5886,5961,65466,89749,9992,93631
8600000US93633,0,0,0,,,,93633
8600000US93634,21,8,13,,,,93634
8600000US93635,27127,13652,13475,52664,71271,5847,93635
8600000US93636,9388,4558,4830,80074,97564,6881,93636
8600000US93637,27446,12732,14714,52207,66361,3709,93637
8600000US93638,34059,17228,16831,41129,56398,3878,93638
8600000US93640,8317,4564,3753,29962,37376,3505,93640
8600000US93641,198,172,26,,39477,56427,93641
8600000US93643,2363,1158,1205,60445,68740,7928,93643
8600000US93644,7387,3586,3801,52597,72924,8972,93644
8600000US93645,231,90,141,,209085,146825,93645
8600000US93646,6771,3307,3464,26413,39962,3672,93646
8600000US93647,7276,3874,3402,36884,47815,6043,93647
8600000US93648,10942,5393,5549,33117,42734,4617,93648
8600000US93650,2891,1537,1354,33100,40843,4523,93650
8600000US93651,1599,878,721,108594,112465,16349,93651
8600000US93652,319,162,157,37313,51232,15493,93652
8600000US93653,1177,542,635,70370,79510,14892,93653
8600000US93654,21935,10998,10937,46839,63842,4025,93654
8600000US93656,4598,2443,2155,50902,59350,6501,93656
8600000US93657,24487,12375,12112,53624,72013,3887,93657
8600000US93660,2667,1323,1344,32627,41110,5718,93660
8600000US93662,21416,10688,10728,42305,60421,4064,93662
8600000US93664,390,209,181,102222,111635,20072,93664
8600000US93665,582,385,197,37018,34622,4513,93665
8600000US93666,535,266,269,,37242,8604,93666
8600000US93667,1820,900,920,76719,87763,12358,93667
8600000US93668,761,399,362,45074,62269,13153,93668
8600000US93669,164,85,79,35833,43053,10502,93669
8600000US93673,498,244,254,39643,48561,11222,93673
8600000US93675,2790,1406,1384,72000,81268,9133,93675
8600000US93701,6652,3299,3353,21820,27681,2629,93701
8600000US93702,30234,15491,14743,26580,37815,1966,93702
8600000US93703,22779,10815,11964,31209,44787,3189,93703
8600000US93704,22543,10902,11641,56769,72416,4342,93704
8600000US93705,26256,12466,13790,38105,49958,2680,93705
8600000US93706,27315,13960,13355,30433,45727,2951,93706
8600000US93710,25805,11786,14019,49882,63499,4828,93710
8600000US93711,31411,14881,16530,71825,108126,5850,93711
8600000US93720,35610,16124,19486,84614,105997,4663,93720
8600000US93721,6672,4640,2032,26885,42202,5881,93721
8600000US93722,57724,28136,29588,56028,69619,3028,93722
8600000US93723,9502,4737,4765,82708,109996,20370,93723
8600000US93725,18189,8727,9462,43469,58093,3834,93725
8600000US93726,30920,15118,15802,38435,48428,2450,93726
8600000US93727,56868,27811,29057,54491,71268,2423,93727
8600000US93728,11792,6159,5633,34667,49270,4391,93728
8600000US93730,8726,4145,4581,114171,146208,14355,93730
8600000US93901,20763,10080,10683,60060,77855,3586,93901
8600000US93905,38963,19902,19061,49659,60101,1947,93905
8600000US93906,46464,23246,23218,65203,82588,3627,93906
8600000US93907,17867,8944,8923,76360,97879,7996,93907
8600000US93908,9689,4984,4705,135606,162667,12265,93908
8600000US93920,1106,600,506,53690,78919,26005,93920
8600000US93921,2910,1325,1585,91313,127234,21588,93921
8600000US93923,10488,4751,5737,95644,169607,20966,93923
8600000US93924,5496,2613,2883,103426,160129,21105,93924
8600000US93925,1401,688,713,53222,76114,13618,93925
8600000US93926,6131,3116,3015,57246,70516,5289,93926
8600000US93927,12125,6109,6016,55788,68711,5221,93927
8600000US93928,773,619,154,,,,93928
8600000US93930,11798,6357,5441,48141,62051,5098,93930
8600000US93932,484,189,295,37273,52145,17269,93932
8600000US93933,19406,8974,10432,64921,80165,4647,93933
8600000US93940,27178,13805,13373,81807,112996,6742,93940
8600000US93943,0,0,0,,,,93943
8600000US93950,12694,5682,7012,81710,111031,6560,93950
8600000US93953,3641,1625,2016,138542,175143,42992,93953
8600000US93954,298,136,162,58500,56217,10814,93954
8600000US93955,25854,12504,13350,61445,75944,4042,93955
8600000US93960,20593,14683,5910,58981,75965,7952,93960
8600000US93962,367,222,145,117593,112400,33951,93962
8600000US94002,20890,10159,10731,134529,181171,9967,94002
8600000US94005,3844,1849,1995,110372,143202,19923,94005
8600000US94010,32501,15152,17349,144281,235979,10975,94010
8600000US94014,41294,20339,20955,88942,104352,4739,94014
8600000US94015,54769,26601,28168,90972,110730,3948,94015
8600000US94019,16166,7456,8710,122959,171153,15414,94019
8600000US94020,1250,675,575,116705,137908,31258,94020
8600000US94021,388,148,240,,505120,980109,94021
8600000US94022,14807,7288,7519,216042,326570,20465,94022
8600000US94024,17492,8315,9177,237454,321996,18057,94024
8600000US94025,31934,15334,16600,151279,225722,11631,94025
8600000US94027,5716,2734,2982,,512536,44658,94027
8600000US94028,5229,2326,2903,220625,300293,38810,94028
8600000US94030,18337,8874,9463,120533,149216,8291,94030
8600000US94037,2337,1164,1173,90066,125181,22614,94037
8600000US94038,2554,1266,1288,144327,187126,50083,94038
8600000US94040,27913,14437,13476,129188,178502,10241,94040
8600000US94041,12027,6374,5653,129444,167803,10731,94041
8600000US94043,25318,13429,11889,125916,168742,7246,94043
8600000US94044,31661,15502,16159,115602,137864,8175,94044
8600000US94060,866,522,344,111379,144284,61046,94060
8600000US94061,30776,14979,15797,105513,145126,6776,94061
8600000US94062,21942,10553,11389,158269,240605,15176,94062
8600000US94063,26060,14089,11971,71458,100244,4595,94063
8600000US94065,9670,4552,5118,161719,193275,14055,94065
8600000US94066,35083,17250,17833,102081,126157,6412,94066
8600000US94070,23456,11300,12156,172048,221289,9068,94070
8600000US94074,167,73,94,121290,243694,222482,94074
8600000US94080,54754,26731,28023,96927,120879,4297,94080
8600000US94085,18695,10122,8573,116332,148129,9918,94085
8600000US94086,39691,20777,18914,129112,158235,6920,94086
8600000US94087,42502,21278,21224,153036,195474,7797,94087
8600000US94089,19000,9930,9070,112750,139625,7145,94089
8600000US94102,28487,16586,11901,41835,81606,5908,94102
8600000US94103,26268,15525,10743,57015,114448,12640,94103
8600000US94104,479,346,133,52679,140675,63060,94104
8600000US94105,8311,4383,3928,213009,255071,39245,94105
8600000US94107,26344,14039,12305,150451,193007,10318,94107
8600000US94108,13281,6397,6884,62173,100377,9800,94108
8600000US94109,53832,28046,25786,88593,134441,6981,94109
8600000US94110,63370,34756,28614,123576,166302,6581,94110
8600000US94111,3306,1688,1618,110455,158067,21300,94111
8600000US94112,71173,35348,35825,89355,115728,3904,94112
8600000US94114,30699,18157,12542,155551,211933,7573,94114
8600000US94115,30384,15340,15044,114819,163371,8981,94115
8600000US94116,40076,19010,21066,107619,155816,8712,94116
8600000US94117,39976,20054,19922,152071,201503,9878,94117
8600000US94118,35569,16194,19375,110216,163708,7278,94118
8600000US94121,37423,18188,19235,95036,135025,5821,94121
8600000US94122,53348,26075,27273,109607,139357,5762,94122
8600000US94123,23106,10977,12129,148276,206890,10672,94123
8600000US94124,27026,12916,14110,56607,84542,4740,94124
8600000US94127,17159,8531,8628,158162,209277,17279,94127
8600000US94128,130,62,68,,,,94128
8600000US94129,3046,1376,1670,184035,248626,46776,94129
8600000US94130,2658,1535,1123,59063,84714,15240,94130
8600000US94131,25288,13758,11530,137762,183275,11977,94131
8600000US94132,27767,13069,14698,74187,101936,5189,94132
8600000US94133,23889,11772,12117,66811,115126,8342,94133
8600000US94134,34638,16888,17750,76229,101875,4914,94134
8600000US94158,6244,3114,3130,153077,161731,18448,94158
8600000US94301,13689,6767,6922,153733,243258,17121,94301
8600000US94303,34785,17075,17710,103680,163681,8326,94303
8600000US94304,3159,1550,1609,127731,211357,28735,94304
8600000US94305,14746,8056,6690,54653,127570,17063,94305
8600000US94306,20916,9781,11135,142438,200755,10920,94306
8600000US94401,27531,13509,14022,89176,119222,5248,94401
8600000US94402,19828,9811,10017,155078,209903,11968,94402
8600000US94403,35294,17457,17837,123968,159731,6269,94403
8600000US94404,28937,14142,14795,143109,173154,5709,94404
8600000US94501,51359,24746,26613,89769,114031,3723,94501
8600000US94502,11199,5443,5756,140463,166889,12132,94502
8600000US94503,14961,7221,7740,98247,119500,6507,94503
8600000US94505,12327,5980,6347,114977,138354,10522,94505
8600000US94506,18143,8702,9441,205121,251472,15474,94506
8600000US94507,11913,6085,5828,226450,286950,21840,94507
8600000US94508,3776,1922,1854,87422,114904,16832,94508
8600000US94509,50135,24464,25671,60821,76299,3094,94509
8600000US94510,22458,10838,11620,98940,126631,8027,94510
8600000US94511,1709,950,759,38801,64682,16561,94511
8600000US94512,16,16,0,,,,94512
8600000US94513,46613,22744,23869,103128,117470,4288,94513
8600000US94514,1067,558,509,68958,126229,60399,94514
8600000US94515,6069,3300,2769,84000,133198,18796,94515
8600000US94516,132,73,59,86250,87712,27529,94516
8600000US94517,10402,5069,5333,143591,172994,19582,94517
8600000US94518,23342,11444,11898,93085,111618,6729,94518
8600000US94519,15987,8001,7986,85906,99999,7452,94519
8600000US94520,29721,15081,14640,57252,71562,3735,94520
8600000US94521,34320,16390,17930,97011,113670,4456,94521
8600000US94523,28133,13424,14709,109161,128620,6283,94523
8600000US94525,2636,1245,1391,74534,88326,10108,94525
8600000US94526,24757,11478,13279,142426,196006,11813,94526
8600000US94528,307,162,145,140496,156290,85201,94528
8600000US94530,21077,9968,11109,99954,128680,8047,94530
8600000US94531,32583,15075,17508,97104,107115,4526,94531
8600000US94533,56313,27940,28373,67442,85265,3999,94533
8600000US94534,29941,14088,15853,110761,136486,9456,94534
8600000US94535,2410,1203,1207,64888,75429,7507,94535
8600000US94536,56917,28470,28447,116609,136107,3833,94536
8600000US94538,54165,27313,26852,106139,123361,3678,94538
8600000US94539,39853,18876,20977,170358,196616,6112,94539
8600000US94541,50798,25205,25593,74552,89523,3190,94541
8600000US94542,11820,5670,6150,108438,131544,9699,94542
8600000US94544,60529,30025,30504,74896,92057,2887,94544
8600000US94545,26050,12684,13366,83132,103843,7058,94545
8600000US94546,34762,16258,18504,91513,111029,3826,94546
8600000US94547,20113,9599,10514,110476,129048,7509,94547
8600000US94548,363,204,159,109453,129383,40204,94548
8600000US94549,22475,10518,11957,159583,230189,12774,94549
8600000US94550,38967,18877,20090,128466,151622,5164,94550
8600000US94551,34296,16773,17523,113305,134851,5464,94551
8600000US94552,12031,5860,6171,151667,197532,14772,94552
8600000US94553,40037,19163,20874,96997,116459,5024,94553
8600000US94555,28283,13888,14395,142135,166363,7685,94555
8600000US94556,12673,6041,6632,150372,210066,13108,94556
8600000US94558,54247,26886,27361,88765,117374,3427,94558
8600000US94559,21431,10529,10902,73408,100258,6732,94559
8600000US94560,36388,18232,18156,108181,126240,5281,94560
8600000US94561,29808,14623,15185,93515,103855,4616,94561
8600000US94563,14709,7075,7634,208640,292512,21301,94563
8600000US94564,15802,7345,8457,90596,106195,5790,94564
8600000US94565,71121,34508,36613,67772,84982,3303,94565
8600000US94566,34973,17399,17574,153684,189328,8184,94566
8600000US94567,537,262,275,57250,104704,35044,94567
8600000US94568,40534,19954,20580,140864,166559,5079,94568
8600000US94569,205,122,83,153750,164748,20607,94569
8600000US94571,8569,4151,4418,66911,76224,5827,94571
8600000US94572,8016,3722,4294,69491,101359,13465,94572
8600000US94573,21,16,5,,,,94573
8600000US94574,7222,3458,3764,89095,151874,14725,94574
8600000US94575,1170,380,790,,,,94575
8600000US94576,98,58,40,,126434,90082,94576
8600000US94577,38551,18164,20387,75121,96764,3725,94577
8600000US94578,31443,14378,17065,58120,77647,3465,94578
8600000US94579,18001,8838,9163,79907,95813,5898,94579
8600000US94580,23404,11502,11902,90946,101997,4181,94580
8600000US94582,28649,14125,14524,156824,187191,6566,94582
8600000US94583,25963,12385,13578,146696,171584,7085,94583
8600000US94585,22757,10890,11867,78750,90078,4710,94585
8600000US94586,760,424,336,125568,192083,42798,94586
8600000US94587,60538,30379,30159,105448,126295,3701,94587
8600000US94588,26655,12553,14102,143903,170005,8717,94588
8600000US94589,23417,10822,12595,64860,76665,3860,94589
8600000US94590,29217,14206,15011,49558,62901,2998,94590
8600000US94591,44762,21351,23411,80888,98861,3693,94591
8600000US94592,921,454,467,126389,145218,30421,94592
8600000US94595,15897,6472,9425,73783,111424,7295,94595
8600000US94596,17604,8553,9051,101259,134284,8022,94596
8600000US94597,18489,9232,9257,105370,127962,7682,94597
8600000US94598,21922,9986,11936,148313,182934,11053,94598
8600000US94599,2877,1289,1588,64545,115825,21770,94599
8600000US94601,39468,19899,19569,46830,63615,2924,94601
8600000US94602,24041,11698,12343,90661,125615,6332,94602
8600000US94603,24883,11921,12962,50742,62683,2715,94603
8600000US94605,33749,15656,18093,69087,97630,8226,94605
8600000US94606,32041,15319,16722,53108,70624,2970,94606
8600000US94607,22074,10736,11338,50149,79676,3470,94607
8600000US94608,26673,13118,13555,82753,103807,4210,94608
8600000US94609,19814,9637,10177,80026,106542,7542,94609
8600000US94610,27386,12746,14640,96681,135097,6242,94610
8600000US94611,32562,15303,17259,124483,174278,7891,94611
8600000US94612,14830,7830,7000,51006,84797,7025,94612
8600000US94613,836,17,819,,,,94613
8600000US94618,13899,6451,7448,156116,207973,14546,94618
8600000US94619,19165,8921,10244,85855,119241,7061,94619
8600000US94621,23762,11025,12737,38591,53975,3357,94621
8600000US94702,13909,6603,7306,78289,104656,5711,94702
8600000US94703,18223,8911,9312,77259,109937,5748,94703
8600000US94704,28307,13534,14773,31379,63155,5190,94704
8600000US94705,11555,5768,5787,121219,194844,14843,94705
8600000US94706,15600,7381,8219,91588,123067,5939,94706
8600000US94707,9753,4753,5000,149081,208731,18565,94707
8600000US94708,9383,4508,4875,160938,215829,16270,94708
8600000US94709,10770,5406,5364,71175,107020,8519,94709
8600000US94710,5960,2921,3039,67250,98269,9346,94710
8600000US94720,2842,1293,1549,,367682,241909,94720
8600000US94801,21990,10759,11231,51516,70119,3146,94801
8600000US94803,21622,10564,11058,85266,110869,7051,94803
8600000US94804,32020,15556,16464,55903,73786,4093,94804
8600000US94805,11860,5542,6318,78740,101287,8538,94805
8600000US94806,49496,24752,24744,59564,75073,3066,94806
8600000US94850,0,0,0,,,,94850
8600000US94901,32559,16262,16297,87495,135280,7021,94901
8600000US94903,24170,11421,12749,102947,141212,10169,94903
8600000US94904,9957,4667,5290,129727,236835,17190,94904
8600000US94920,10019,4701,5318,166313,283382,26378,94920
8600000US94922,528,261,267,,139218,105669,94922
8600000US94923,846,430,416,86802,189241,88100,94923
8600000US94924,1038,480,558,59167,103623,27406,94924
8600000US94925,7284,3185,4099,147587,192786,18993,94925
8600000US94928,35241,16387,18854,66621,81292,3581,94928
8600000US94929,144,70,74,117813,186249,98227,94929
8600000US94930,7150,3280,3870,105100,133318,12257,94930
8600000US94931,6783,3127,3656,76497,93379,8260,94931
8600000US94933,570,269,301,79028,93293,25182,94933
8600000US94937,762,390,372,82903,94762,18280,94937
8600000US94938,674,348,326,88636,113403,42590,94938
8600000US94939,5760,2590,3170,107055,171440,28473,94939
8600000US94940,234,102,132,91688,105291,34940,94940
8600000US94941,24725,11473,13252,145602,229869,13034,94941
8600000US94945,15198,7347,7851,106425,130422,7081,94945
8600000US94946,581,282,299,103750,197480,35068,94946
8600000US94947,21365,10301,11064,102748,132198,8836,94947
8600000US94949,14179,7012,7167,89871,134552,10882,94949
8600000US94950,123,67,56,70547,97122,58321,94950
8600000US94951,3718,1696,2022,94126,113090,11672,94951
8600000US94952,28938,14153,14785,84772,117014,5870,94952
8600000US94954,29997,14532,15465,90911,110095,4478,94954
8600000US94956,1084,462,622,68651,105992,24232,94956
8600000US94957,1033,544,489,,372571,78012,94957
8600000US94960,12214,5715,6499,130016,188637,16247,94960
8600000US94963,371,173,198,116250,192160,69506,94963
8600000US94964,3418,3246,172,,97488,60640,94964
8600000US94965,9830,4429,5401,103424,160596,15138,94965
8600000US94970,671,325,346,120882,141105,30662,94970
8600000US94971,288,106,182,106000,152801,109042,94971
8600000US94972,23,12,11,,,,94972
8600000US94973,1257,679,578,72135,125705,45962,94973
8600000US95002,1660,891,769,91667,115557,14720,95002
8600000US95003,20359,9503,10856,96600,128912,6867,95003
8600000US95004,3104,1620,1484,106047,123234,15524,95004
8600000US95005,6182,2934,3248,87168,113417,9786,95005
8600000US95006,7839,4008,3831,90130,115126,11234,95006
8600000US95007,653,318,335,,77476,70954,95007
8600000US95008,37254,18343,18911,115453,144360,4759,95008
8600000US95010,7449,3336,4113,80011,98186,10255,95010
8600000US95012,6944,3447,3497,54333,65981,5771,95012
8600000US95013,63,22,41,67708,73843,37117,95013
8600000US95014,46067,22402,23665,160801,194395,7173,95014
8600000US95017,532,269,263,63333,97903,20921,95017
8600000US95018,5833,2875,2958,102163,119722,11319,95018
8600000US95019,5775,2861,2914,46038,59593,9200,95019
8600000US95020,46137,22381,23756,95829,116993,4509,95020
8600000US95023,38665,19272,19393,83305,101652,4009,95023
8600000US95030,10387,5004,5383,197647,300157,23412,95030
8600000US95032,19917,9776,10141,135833,194565,12912,95032
8600000US95033,7697,3958,3739,162308,203556,14450,95033
8600000US95035,60442,30689,29753,125055,142677,3771,95035
8600000US95037,38279,18786,19493,120864,153515,6254,95037
8600000US95039,764,318,446,41551,43157,9417,95039
8600000US95041,206,110,96,56667,58463,18337,95041
8600000US95043,614,321,293,74205,104828,16871,95043
8600000US95045,3110,1427,1683,77644,93643,12130,95045
8600000US95046,4725,2434,2291,113187,139644,14861,95046
8600000US95050,31721,17052,14669,88872,109212,4849,95050
8600000US95051,46105,23595,22510,125520,146764,4172,95051
8600000US95053,3639,1701,1938,,,,95053
8600000US95054,19138,9967,9171,148011,160106,8945,95054
8600000US95060,40225,20170,20055,71485,108148,6263,95060
8600000US95062,31733,16054,15679,74061,100310,5417,95062
8600000US95064,9911,4245,5666,46375,86173,21688,95064
8600000US95065,6565,3140,3425,92225,125404,8157,95065
8600000US95066,12192,6075,6117,106113,156058,13704,95066
8600000US95070,24721,11736,12985,177041,238457,14366,95070
8600000US95073,8941,4338,4603,88667,121431,10404,95073
8600000US95075,341,168,173,68125,124888,37022,95075
8600000US95076,62148,31182,30966,63979,87605,3700,95076
8600000US95110,15620,8787,6833,87634,112562,8817,95110
8600000US95111,46170,23371,22799,69039,89871,4293,95111
8600000US95112,50899,26948,23951,63500,91801,3902,95112
8600000US95113,1903,1101,802,122120,160292,22618,95113
8600000US95116,41427,21141,20286,60855,78878,3101,95116
8600000US95117,23545,11998,11547,91347,124821,8108,95117
8600000US95118,24216,11943,12273,107701,138663,6291,95118
8600000US95119,7729,3801,3928,118090,132662,10414,95119
8600000US95120,28355,13879,14476,185800,217091,7836,95120
8600000US95121,29990,14816,15174,102728,124432,5372,95121
8600000US95122,42829,21255,21574,73388,90620,3848,95122
8600000US95123,51779,25021,26758,112946,129066,3267,95123
8600000US95124,37792,18974,18818,143425,170138,7072,95124
8600000US95125,42114,19827,22287,116708,161318,5918,95125
8600000US95126,29433,15250,14183,92788,129319,5975,95126
8600000US95127,50446,26227,24219,92419,112511,3756,95127
8600000US95128,29787,14870,14917,88007,117965,4775,95128
8600000US95129,30453,15123,15330,144333,170495,7478,95129
8600000US95130,10998,5342,5656,120639,154746,11687,95130
8600000US95131,25381,13169,12212,121567,145256,8461,95131
8600000US95132,33294,16397,16897,111623,132101,4490,95132
8600000US95133,22626,11339,11287,82487,107899,6412,95133
8600000US95134,23042,12723,10319,139558,152679,6458,95134
8600000US95135,17049,7970,9079,142531,164386,9170,95135
8600000US95136,36165,17279,18886,104909,129147,6043,95136
8600000US95138,15504,7659,7845,173286,221429,18855,95138
8600000US95139,5468,2893,2575,135089,148439,11613,95139
8600000US95140,115,64,51,71563,76752,32767,95140
8600000US95148,38140,18602,19538,129984,146982,4525,95148
8600000US95202,4388,2035,2353,14484,24968,3953,95202
8600000US95203,11755,5908,5847,41452,57187,4699,95203
8600000US95204,22259,10507,11752,48062,65758,4485,95204
8600000US95205,26455,13765,12690,35544,45798,3229,95205
8600000US95206,43316,20970,22346,48908,59077,2493,95206
8600000US95207,38467,17917,20550,44103,62304,2453,95207
8600000US95209,32075,15581,16494,78883,90364,3852,95209
8600000US95210,29342,13618,15724,43587,58526,4611,95210
8600000US95211,1606,693,913,,,,95211
8600000US95212,20113,9918,10195,88178,104976,7162,95212
8600000US95215,17561,9592,7969,45501,64708,6045,95215
8600000US95219,22003,10669,11334,83194,119916,10361,95219
8600000US95220,6015,2927,3088,74583,102447,14970,95220
8600000US95222,4421,2166,2255,52289,73716,8075,95222
8600000US95223,2579,1424,1155,59330,87394,22193,95223
8600000US95224,166,65,101,32961,56926,33377,95224
8600000US95225,339,185,154,66417,79268,24295,95225
8600000US95226,16,16,0,,,,95226
8600000US95227,628,302,326,92938,129285,51532,95227
8600000US95228,3740,1921,1819,80706,95414,11849,95228
8600000US95230,371,211,160,85299,102369,59760,95230
8600000US95231,4252,2967,1285,41445,50300,7744,95231
8600000US95232,164,77,87,56579,70184,31429,95232
8600000US95233,432,193,239,70625,85103,27497,95233
8600000US95234,52,37,15,,,,95234
8600000US95236,3243,1593,1650,74184,106294,14433,95236
8600000US95237,2533,1291,1242,56190,78552,11947,95237
8600000US95240,34548,17040,17508,46309,66540,2350,95240
8600000US95242,20313,9831,10482,68611,97056,9060,95242
8600000US95245,1646,868,778,49549,73086,17687,95245
8600000US95246,1019,565,454,40997,52892,12025,95246
8600000US95247,3560,1518,2042,49162,88339,16233,95247
8600000US95248,175,84,91,28750,35230,14572,95248
8600000US95249,3529,1837,1692,35745,56667,13610,95249
8600000US95250,0,0,0,,,,95250
8600000US95251,541,233,308,58547,76136,26184,95251
8600000US95252,12487,6011,6476,77188,89292,6753,95252
8600000US95254,1106,585,521,100795,103789,20949,95254
8600000US95255,1200,682,518,34444,45702,7757,95255
8600000US95257,354,130,224,51193,58879,17502,95257
8600000US95258,3062,1520,1542,88630,111884,13460,95258
8600000US95301,27360,14048,13312,57322,75619,4172,95301
8600000US95303,684,405,279,58542,189405,122261,95303
8600000US95304,11637,7004,4633,88152,121341,14003,95304
8600000US95305,37,20,17,,,,95305
8600000US95306,794,435,359,45705,63830,22447,95306
8600000US95307,30875,15307,15568,54405,65061,2676,95307
8600000US95310,1660,863,797,37929,56989,10540,95310
8600000US95311,1506,725,781,44107,58034,10284,95311
8600000US95312,200,100,100,62688,69219,26118,95312
8600000US95313,965,500,465,48063,64254,17529,95313
8600000US95314,95,67,28,,,,95314
8600000US95315,9674,4837,4837,55795,63984,5506,95315
8600000US95316,4878,2380,2498,67012,85118,12584,95316
8600000US95317,601,364,237,39464,91064,36118,95317
8600000US95318,179,114,65,,73261,17821,95318
8600000US95319,1217,705,512,31512,38375,8950,95319
8600000US95320,9704,4759,4945,68326,88725,7059,95320
8600000US95321,3011,1338,1673,52297,74347,9862,95321
8600000US95322,7778,3862,3916,53737,71451,11946,95322
8600000US95323,917,468,449,65000,74314,10304,95323
8600000US95324,6144,3019,3125,62022,86792,8606,95324
8600000US95325,77,31,46,,,,95325
8600000US95326,6879,3100,3779,74777,88429,8588,95326
8600000US95327,6981,4709,2272,52656,76079,14936,95327
8600000US95328,3215,1444,1771,54806,64657,11632,95328
8600000US95329,2123,1107,1016,60556,78479,10916,95329
8600000US95330,15641,7817,7824,81339,91046,4483,95330
8600000US95333,1844,972,872,48785,70086,13886,95333
8600000US95334,11570,5723,5847,52284,64740,5195,95334
8600000US95335,183,109,74,40893,36918,15029,95335
8600000US95336,35217,16825,18392,62362,78316,3668,95336
8600000US95337,27584,13439,14145,80351,93986,4641,95337
8600000US95338,8883,4403,4480,51833,65774,5102,95338
8600000US95340,27507,13464,14043,56089,77035,3819,95340
8600000US95341,20711,10526,10185,37105,57729,4630,95341
8600000US95345,642,233,409,51563,51698,18447,95345
8600000US95346,1355,769,586,65365,80114,19487,95346
8600000US95348,25351,12069,13282,45195,63922,7082,95348
8600000US95350,40579,19115,21464,49832,65701,2776,95350
8600000US95351,33956,16536,17420,40819,50962,2465,95351
8600000US95354,18556,9126,9430,49358,65972,5463,95354
8600000US95355,44924,21018,23906,65854,83558,3580,95355
8600000US95356,25316,12501,12815,69334,100272,8197,95356
8600000US95357,8249,4039,4210,65933,82822,7223,95357
8600000US95358,23416,12614,10802,59708,75092,4037,95358
8600000US95360,9136,4490,4646,60586,75061,9350,95360
8600000US95361,25509,12560,12949,62921,87755,5457,95361
8600000US95363,19111,9937,9174,66578,82395,6309,95363
8600000US95364,0,0,0,,,,95364
8600000US95365,3283,1831,1452,39808,46645,5103,95365
8600000US95366,13009,6394,6615,84201,105560,6123,95366
8600000US95367,18671,9092,9579,67746,83691,4573,95367
8600000US95368,10074,5115,4959,73073,79515,6975,95368
8600000US95369,748,407,341,48750,65571,10354,95369
8600000US95370,22792,10903,11889,55676,81483,5662,95370
8600000US95372,1608,951,657,76667,78784,12244,95372
8600000US95374,1395,762,633,49938,135739,73439,95374
8600000US95375,5,5,0,,,,95375
8600000US95376,38278,18848,19430,76261,89722,3016,95376
8600000US95377,23129,11577,11552,105120,118201,6054,95377
8600000US95379,2892,1478,1414,62179,64692,9170,95379
8600000US95380,30562,14972,15590,45901,63991,3707,95380
8600000US95382,28700,13447,15253,69720,89556,6898,95382
8600000US95383,3284,1728,1556,64338,108592,40656,95383
8600000US95385,342,192,150,51429,57157,18408,95385
8600000US95386,7225,3662,3563,58529,74655,6185,95386
8600000US95387,439,210,229,39952,48575,14446,95387
8600000US95388,9400,5001,4399,44646,57873,5031,95388
8600000US95389,1291,846,445,63214,69350,17551,95389
8600000US95391,10104,4766,5338,130476,141114,9824,95391
8600000US95401,30314,14663,15651,66633,91416,5652,95401
8600000US95403,35559,17268,18291,73985,93715,4506,95403
8600000US95404,32388,15803,16585,77127,106234,5881,95404
8600000US95405,17631,8017,9614,84354,103584,5906,95405
8600000US95407,30788,15569,15219,59971,71665,3338,95407
8600000US95409,22614,9919,12695,74333,99740,5154,95409
8600000US95410,1029,520,509,47422,102858,51557,95410
8600000US95412,357,202,155,70536,84438,23511,95412
8600000US95415,1039,554,485,40878,74512,25482,95415
8600000US95417,357,241,116,63625,69048,12766,95417
8600000US95420,489,291,198,102607,98843,25479,95420
8600000US95421,1511,723,788,55833,77197,10049,95421
8600000US95422,11637,5726,5911,29069,40937,3310,95422
8600000US95423,3236,1708,1528,44611,63747,14311,95423
8600000US95425,8260,3953,4307,69153,90078,6678,95425
8600000US95426,1214,688,526,82219,83294,15998,95426
8600000US95427,206,95,111,24125,31852,14063,95427
8600000US95428,1947,1044,903,37031,53782,10283,95428
8600000US95429,124,83,41,54643,92784,57747,95429
8600000US95430,7,7,0,,,,95430
8600000US95431,196,122,74,,,,95431
8600000US95432,445,251,194,44063,56683,18313,95432
8600000US95435,14,0,14,,,,95435
8600000US95436,5438,2755,2683,63556,89706,8965,95436
8600000US95437,11680,5816,5864,45833,59848,3592,95437
8600000US95439,531,336,195,52500,91173,34168,95439
8600000US95441,1705,978,727,86154,116706,15385,95441
8600000US95442,2560,1278,1282,114879,150064,33678,95442
8600000US95443,211,112,99,16250,21907,9235,95443
8600000US95444,546,178,368,62685,70224,25139,95444
8600000US95445,1893,901,992,56227,66478,10297,95445
8600000US95446,4519,2353,2166,61161,81278,9439,95446
8600000US95448,14640,7262,7378,89719,140252,14819,95448
8600000US95449,1217,691,526,46111,73460,20940,95449
8600000US95450,270,155,115,58958,77358,18730,95450
8600000US95451,9250,4387,4863,51469,69016,6510,95451
8600000US95452,923,408,515,87961,91722,32899,95452
8600000US95453,9052,4387,4665,45763,67836,6867,95453
8600000US95454,1915,880,1035,34699,45094,8141,95454
8600000US95456,672,250,422,44261,58640,17752,95456
8600000US95457,2691,1399,1292,48260,60709,10267,95457
8600000US95458,2437,1338,1099,41579,66325,24718,95458
8600000US95459,461,228,233,50972,65497,16642,95459
8600000US95460,1997,1047,950,64464,87951,23059,95460
8600000US95461,1987,995,992,42250,64632,17573,95461
8600000US95462,1090,564,526,45588,74254,22086,95462
8600000US95463,152,56,96,61513,55431,14298,95463
8600000US95464,1936,1018,918,45246,52010,8652,95464
8600000US95465,1863,931,932,58778,120512,32231,95465
8600000US95466,748,429,319,60139,74692,14003,95466
8600000US95467,4617,2177,2440,63384,78526,10758,95467
8600000US95468,1013,476,537,48365,56521,7271,95468
8600000US95469,1463,743,720,52650,68043,10872,95469
8600000US95470,4405,2265,2140,62600,80071,8278,95470
8600000US95471,348,176,172,,48818,19564,95471
8600000US95472,26396,12812,13584,87716,113085,5963,95472
8600000US95476,30059,14622,15437,76151,117983,12907,95476
8600000US95482,24301,11794,12507,50000,75119,7357,95482
8600000US95485,2221,1116,1105,37102,59595,11978,95485
8600000US95486,73,56,17,,49696,51769,95486
8600000US95488,190,106,84,57452,80407,43870,95488
8600000US95490,9988,4617,5371,42292,53052,4703,95490
8600000US95492,23072,11765,11307,99521,113915,4206,95492
8600000US95493,241,104,137,62760,60189,9800,95493
8600000US95494,107,56,51,,74860,58803,95494
8600000US95497,1038,400,638,78350,102344,19507,95497
8600000US95501,19417,9519,9898,42500,61057,6666,95501
8600000US95503,20049,9593,10456,51462,65925,4032,95503
8600000US95511,265,128,137,,37508,17959,95511
8600000US95514,94,58,36,58333,93500,72238,95514
8600000US95519,14624,7588,7036,52758,70608,5089,95519
8600000US95521,18772,9181,9591,36051,60983,8859,95521
8600000US95524,1525,817,708,73531,92651,14070,95524
8600000US95525,1293,745,548,46653,58405,8749,95525
8600000US95526,201,114,87,30000,39304,7785,95526
8600000US95527,544,277,267,42396,51211,9163,95527
8600000US95528,1094,544,550,56250,80024,15017,95528
8600000US95531,18424,10133,8291,46282,60779,5494,95531
8600000US95536,2260,1170,1090,51424,80312,10655,95536
8600000US95537,325,216,109,,44958,19711,95537
8600000US95540,10855,5288,5567,46302,56593,3880,95540
8600000US95542,1781,882,899,31055,46125,12390,95542
8600000US95543,556,246,310,35855,44991,13767,95543
8600000US95545,101,67,34,,72631,39151,95545
8600000US95546,2701,1113,1588,34375,54092,13304,95546
8600000US95547,826,340,486,55577,73777,12829,95547
8600000US95548,964,488,476,36125,49397,6676,95548
8600000US95549,835,467,368,70469,80206,10569,95549
8600000US95550,57,23,34,,31447,19411,95550
8600000US95551,1044,464,580,53077,80445,25022,95551
8600000US95552,540,289,251,27056,38977,8861,95552
8600000US95553,789,492,297,,72045,45272,95553
8600000US95554,247,132,115,62639,61095,12071,95554
8600000US95555,289,141,148,32083,57732,20952,95555
8600000US95556,435,231,204,39300,36718,7460,95556
8600000US95558,347,188,159,40000,78638,28301,95558
8600000US95559,72,16,56,,,,95559
8600000US95560,1275,744,531,78566,90044,27018,95560
8600000US95562,2563,1324,1239,37108,51091,6553,95562
8600000US95563,561,251,310,,68846,38128,95563
8600000US95564,368,198,170,41250,58288,11099,95564
8600000US95565,566,268,298,39115,52098,12785,95565
8600000US95567,1526,714,812,50938,83644,25472,95567
8600000US95568,232,149,83,45769,48314,12246,95568
8600000US95569,295,178,117,47609,54360,22931,95569
8600000US95570,1900,909,991,51406,79001,10652,95570
8600000US95571,204,107,97,31458,48536,17321,95571
8600000US95573,1229,659,570,49306,53112,11331,95573
8600000US95585,402,227,175,22222,33679,7854,95585
8600000US95587,49,10,39,,,,95587
8600000US95589,907,505,402,51250,55621,21094,95589
8600000US95595,140,85,55,47500,169530,133843,95595
8600000US95601,105,52,53,,115827,59028,95601
8600000US95602,15078,7156,7922,73485,92054,6193,95602
8600000US95603,24089,11648,12441,66272,90791,5387,95603
8600000US95604,87,42,45,75729,79125,35549,95604
8600000US95605,10991,5604,5387,45456,63045,7887,95605
8600000US95606,229,119,110,54152,74919,42056,95606
8600000US95607,299,152,147,68990,123148,46474,95607
8600000US95608,49219,22594,26625,61437,91958,3847,95608
8600000US95610,36419,16902,19517,58780,73362,2803,95610
8600000US95612,778,437,341,79750,93735,19634,95612
8600000US95614,3219,1571,1648,97407,101345,11723,95614
8600000US95615,797,501,296,58231,77857,23325,95615
8600000US95616,46738,21796,24942,52827,88536,5081,95616
8600000US95618,20996,10097,10899,92531,135597,6916,95618
8600000US95619,4610,2425,2185,67632,81167,10671,95619
8600000US95620,16126,8233,7893,78079,93304,9346,95620
8600000US95621,32951,15659,17292,59693,71976,3879,95621
8600000US95623,3070,1615,1455,63160,86769,10614,95623
8600000US95624,49001,23329,25672,91971,113247,5835,95624
8600000US95625,67,59,8,58371,62800,23809,95625
8600000US95626,4762,2530,2232,73355,86811,7519,95626
8600000US95627,2847,1335,1512,66169,88772,24363,95627
8600000US95628,33226,16035,17191,81235,110352,4915,95628
8600000US95629,679,305,374,75852,77469,17293,95629
8600000US95630,58294,30399,27895,109942,126506,3056,95630
8600000US95631,5288,2596,2692,79000,84312,7879,95631
8600000US95632,23199,11406,11793,74190,90349,4689,95632
8600000US95633,2949,1599,1350,74362,90264,13188,95633
8600000US95634,2716,1422,1294,54013,63031,9860,95634
8600000US95635,791,381,410,57899,61577,14081,95635
8600000US95636,873,412,461,49981,61235,14500,95636
8600000US95637,163,82,81,51641,42524,12930,95637
8600000US95638,1696,861,835,81500,107945,24092,95638
8600000US95639,251,101,150,59226,58433,19414,95639
8600000US95640,9489,6433,3056,67635,78027,9323,95640
8600000US95641,1367,628,739,36932,55181,7550,95641
8600000US95642,5701,2574,3127,54004,69421,8377,95642
8600000US95645,1312,668,644,40500,56142,9489,95645
8600000US95646,76,71,5,60875,76241,37323,95646
8600000US95648,40451,19219,21232,81267,97933,3287,95648
8600000US95650,11023,5627,5396,93783,119781,17270,95650
8600000US95651,694,385,309,80926,139378,58757,95651
8600000US95652,511,233,278,51250,56049,19420,95652
8600000US95653,405,232,173,58646,71516,28155,95653
8600000US95655,3126,1497,1629,89107,95623,11699,95655
8600000US95658,5555,2767,2788,82781,112236,9752,95658
8600000US95659,679,376,303,64375,80150,14768,95659
8600000US95660,25742,12082,13660,45328,57064,3416,95660
8600000US95661,24677,11335,13342,83289,107383,5022,95661
8600000US95662,25099,12607,12492,77993,91439,4289,95662
8600000US95663,1978,892,1086,98393,120542,16734,95663
8600000US95664,1272,747,525,71921,78738,14906,95664
8600000US95665,3944,1968,1976,69265,88496,17772,95665
8600000US95666,4466,2240,2226,57813,72963,7011,95666
8600000US95667,30077,14464,15613,69443,89658,4232,95667
8600000US95668,605,288,317,64375,77272,10746,95668
8600000US95669,1812,913,899,70417,80532,11677,95669
8600000US95670,42861,21024,21837,64784,84940,3502,95670
8600000US95672,4216,1973,2243,102750,128360,16905,95672
8600000US95673,11668,5679,5989,62604,72133,4485,95673
8600000US95674,682,340,342,83654,110530,13891,95674
8600000US95675,574,282,292,37772,42129,11940,95675
8600000US95677,19502,9244,10258,87014,100338,4512,95677
8600000US95678,32929,16158,16771,70060,87136,4035,95678
8600000US95679,53,26,27,,,,95679
8600000US95680,10,0,10,,,,95680
8600000US95681,933,549,384,53362,68419,21112,95681
8600000US95682,23983,11919,12064,87743,105394,5165,95682
8600000US95683,5136,2371,2765,107395,126833,12972,95683
8600000US95684,3031,1502,1529,60163,73444,15696,95684
8600000US95685,3849,1793,2056,61270,81201,10017,95685
8600000US95686,819,404,415,41094,53131,10055,95686
8600000US95687,53658,28723,24935,81586,96270,3200,95687
8600000US95688,28157,13951,14206,88053,108115,4200,95688
8600000US95689,1442,759,683,56146,101698,34770,95689
8600000US95690,1535,772,763,56850,83942,24058,95690
8600000US95691,27764,13243,14521,73086,90074,4384,95691
8600000US95692,3903,2046,1857,72555,93803,14250,95692
8600000US95693,5308,2589,2719,100679,114053,15230,95693
8600000US95694,7896,3970,3926,82620,105884,15622,95694
8600000US95695,31161,14691,16470,62380,82056,3666,95695
8600000US95697,312,214,98,69688,62129,18138,95697
8600000US95698,128,85,43,,77675,49670,95698
8600000US95699,20,14,6,,,,95699
8600000US95701,677,341,336,71058,80960,15882,95701
8600000US95703,902,437,465,82794,83442,17337,95703
8600000US95709,4232,2247,1985,76472,97346,9087,95709
8600000US95713,8001,4116,3885,64176,84642,11716,95713
8600000US95714,394,176,218,46705,75777,23415,95714
8600000US95715,75,39,36,50250,67460,34871,95715
8600000US95717,106,62,44,54643,61856,25639,95717
8600000US95720,61,30,31,43750,85659,55020,95720
8600000US95721,15,15,0,,,,95721
8600000US95722,4083,2091,1992,98295,117342,10911,95722
8600000US95724,15,15,0,,,,95724
8600000US95726,6722,3128,3594,62699,78171,6159,95726
8600000US95728,163,110,53,,126539,66272,95728
8600000US95735,8,6,2,151250,143517,49434,95735
8600000US95736,198,99,99,,82131,72339,95736
8600000US95742,8207,4159,4048,126348,128879,7515,95742
8600000US95746,17747,8604,9143,135360,187005,14339,95746
8600000US95747,49015,23229,25786,103895,121408,4565,95747
8600000US95757,35177,16793,18384,101823,118905,5369,95757
8600000US95758,47806,22143,25663,79885,95132,4215,95758
8600000US95762,31132,15018,16114,132470,162474,7739,95762
8600000US95765,27194,12627,14567,106554,125838,5610,95765
8600000US95776,17323,8624,8699,77699,92203,7586,95776
8600000US95811,5272,2685,2587,52145,81689,10605,95811
8600000US95814,10761,6469,4292,35264,59876,4865,95814
8600000US95815,18395,9410,8985,31467,44134,3767,95815
8600000US95816,15451,7316,8135,65292,90921,4810,95816
8600000US95817,11386,5010,6376,45410,62046,5794,95817
8600000US95818,17281,8320,8961,80938,115430,17318,95818
8600000US95819,16056,7090,8966,104414,126421,7975,95819
8600000US95820,26963,13440,13523,50031,62738,4496,95820
8600000US95821,26801,12372,14429,42290,63122,3379,95821
8600000US95822,34163,16455,17708,54552,74494,3632,95822
8600000US95823,55873,26903,28970,44981,58069,2976,95823
8600000US95824,21608,10775,10833,33986,44773,2690,95824
8600000US95825,27977,12918,15059,37956,53600,2898,95825
8600000US95826,31065,14639,16426,62527,75698,2846,95826
8600000US95827,16334,7970,8364,56064,73560,4339,95827
8600000US95828,45008,21914,23094,51229,63704,2541,95828
8600000US95829,20508,9951,10557,86483,99305,3807,95829
8600000US95830,785,417,368,80278,109667,29234,95830
8600000US95831,34959,16024,18935,75632,95598,4155,95831
8600000US95832,8008,4081,3927,44811,52542,5467,95832
8600000US95833,30332,14672,15660,60455,78514,4100,95833
8600000US95834,20822,10142,10680,63228,76706,4157,95834
8600000US95835,29540,14046,15494,96743,119462,10512,95835
8600000US95837,262,169,93,242557,231230,44649,95837
8600000US95838,27363,13428,13935,44849,56301,2950,95838
8600000US95841,15972,7365,8607,47215,60684,4177,95841
8600000US95842,23958,11201,12757,50412,61832,3288,95842
8600000US95843,33804,16273,17531,78102,87026,3957,95843
8600000US95864,18680,9185,9495,101446,152449,10122,95864
8600000US95901,24400,11895,12505,49759,62482,3851,95901
8600000US95903,1229,754,475,45250,53919,7637,95903
8600000US95910,65,26,39,,,,95910
8600000US95912,3602,1872,1730,68590,89294,17636,95912
8600000US95914,646,278,368,,49467,15097,95914
8600000US95915,0,0,0,,,,95915
8600000US95916,1110,616,494,32273,41986,6068,95916
8600000US95917,2956,1546,1410,57917,89297,16402,95917
8600000US95918,2046,1087,959,79152,91075,16311,95918
8600000US95919,945,541,404,46995,55991,13278,95919
8600000US95920,229,104,125,46250,82312,28841,95920
8600000US95922,384,229,155,59531,70395,12638,95922
8600000US95923,28,14,14,,45414,35665,95923
8600000US95925,209,89,120,22669,27288,7172,95925
8600000US95926,32311,15675,16636,45782,68607,4441,95926
8600000US95928,31108,15480,15628,47599,74518,4747,95928
8600000US95930,129,73,56,,56881,25589,95930
8600000US95932,5577,2888,2689,50551,68054,7053,95932
8600000US95934,264,158,106,,46067,23590,95934
8600000US95935,401,166,235,,58741,58029,95935
8600000US95936,93,55,38,21250,33864,15618,95936
8600000US95937,1092,510,582,49095,68362,16305,95937
8600000US95938,3244,1462,1782,82097,94105,14578,95938
8600000US95939,541,327,214,34375,49426,11625,95939
8600000US95941,497,218,279,,43456,14931,95941
8600000US95942,554,305,249,,118617,41048,95942
8600000US95943,651,398,253,58309,104324,30624,95943
8600000US95944,29,20,9,,,,95944
8600000US95945,21080,9433,11647,46771,69112,5726,95945
8600000US95946,8045,3996,4049,65500,86298,11085,95946
8600000US95947,1661,850,811,42277,54435,10806,95947
8600000US95948,8149,4007,4142,53438,67222,4816,95948
8600000US95949,17017,8264,8753,67873,85505,4432,95949
8600000US95950,202,99,103,31731,35562,9292,95950
8600000US95951,1871,958,913,43688,48874,6033,95951
8600000US95953,7875,3887,3988,57556,78044,12208,95953
8600000US95954,11319,5453,5866,47563,57079,3898,95954
8600000US95955,1109,590,519,67875,85733,16133,95955
8600000US95956,268,138,130,110625,103647,31521,95956
8600000US95957,647,310,337,60625,80005,11599,95957
8600000US95959,15396,8138,7258,60985,88343,7662,95959
8600000US95960,689,386,303,46591,51130,10851,95960
8600000US95961,19109,9646,9463,52728,67343,3971,95961
8600000US95962,1022,609,413,97523,89820,26697,95962
8600000US95963,10993,5498,5495,47205,58342,4644,95963
8600000US95965,15539,8052,7487,33561,50942,4062,95965
8600000US95966,23270,11511,11759,44381,56977,3482,95966
8600000US95968,1017,512,505,27195,42658,12696,95968
8600000US95969,22772,10762,12010,48717,69942,5937,95969
8600000US95970,484,222,262,50188,91448,36245,95970
8600000US95971,5195,2721,2474,49614,64480,8230,95971
8600000US95973,27181,13199,13982,64517,86934,5631,95973
8600000US95974,31,14,17,,,,95974
8600000US95975,1326,714,612,,71175,22701,95975
8600000US95977,1334,695,639,60683,64200,14999,95977
8600000US95978,77,19,58,,43205,47126,95978
8600000US95979,399,231,168,39167,66102,26005,95979
8600000US95981,22,12,10,,,,95981
8600000US95982,2363,1244,1119,71714,84379,9128,95982
8600000US95983,305,147,158,,94666,75197,95983
8600000US95984,33,8,25,,,,95984
8600000US95986,53,38,15,58214,46603,14663,95986
8600000US95987,4392,2203,2189,60774,103366,27689,95987
8600000US95988,6273,2975,3298,48493,61284,6461,95988
8600000US95991,29461,14128,15333,47871,63991,2899,95991
8600000US95993,27970,13934,14036,67384,87204,5391,95993
8600000US96001,27409,13516,13893,51831,75684,3617,96001
8600000US96002,25613,11816,13797,52693,72499,4786,96002
8600000US96003,35632,17265,18367,51512,68668,2181,96003
8600000US96006,299,147,152,55000,65125,20235,96006
8600000US96007,17858,8808,9050,43973,59048,5714,96007
8600000US96008,1117,428,689,61900,80438,17262,96008
8600000US96009,293,152,141,58281,77733,23855,96009
8600000US96010,145,101,44,43393,46821,14247,96010
8600000US96011,121,67,54,20833,38553,16264,96011
8600000US96013,3549,1562,1987,45319,55810,7569,96013
8600000US96014,145,79,66,34762,32797,9891,96014
8600000US96015,386,206,180,40993,59058,34616,96015
8600000US96016,320,137,183,94398,69920,27772,96016
8600000US96017,137,80,57,42143,61788,27697,96017
8600000US96019,7699,3850,3849,52135,61324,4084,96019
8600000US96020,1951,1024,927,56194,66404,8905,96020
8600000US96021,11762,5728,6034,43032,58354,7020,96021
8600000US96022,12592,5925,6667,50625,66421,4258,96022
8600000US96023,838,413,425,31481,44995,8664,96023
8600000US96024,742,377,365,41397,64006,16680,96024
8600000US96025,1608,783,825,33857,43418,3541,96025
8600000US96027,1937,980,957,57202,62833,7516,96027
8600000US96028,1098,486,612,41897,73449,23232,96028
8600000US96029,143,79,64,40417,50347,18263,96029
8600000US96031,106,52,54,23750,29640,8722,96031
8600000US96032,1959,1028,931,46213,62396,7729,96032
8600000US96033,431,210,221,42500,47848,6073,96033
8600000US96034,195,78,117,33125,52635,17530,96034
8600000US96035,2821,1483,1338,41250,51982,7854,96035
8600000US96037,309,113,196,,57244,17471,96037
8600000US96038,561,306,255,47632,57914,11049,96038
8600000US96039,771,386,385,35197,53427,14282,96039
8600000US96040,178,72,106,,45990,20847,96040
8600000US96041,2349,1107,1242,28880,47916,10509,96041
8600000US96044,801,430,371,43026,49971,4925,96044
8600000US96046,165,86,79,,52967,27284,96046
8600000US96047,734,384,350,43750,62405,17138,96047
8600000US96048,633,297,336,50338,55162,9343,96048
8600000US96049,59,29,30,35625,33046,15681,96049
8600000US96050,355,206,149,24938,46461,10472,96050
8600000US96051,1145,597,548,46328,64685,12782,96051
8600000US96052,1346,779,567,34669,53634,8979,96052
8600000US96054,289,163,126,39231,46169,14385,96054
8600000US96055,2975,1433,1542,47798,63928,8181,96055
8600000US96056,1308,668,640,52019,61874,9795,96056
8600000US96057,1090,577,513,40469,55556,9757,96057
8600000US96058,504,285,219,36838,61412,22582,96058
8600000US96059,497,264,233,39514,48615,12039,96059
8600000US96061,19,8,11,,,,96061
8600000US96062,756,377,379,60833,95050,22370,96062
8600000US96063,183,108,75,49625,64873,25045,96063
8600000US96064,3782,1959,1823,48489,64536,4923,96064
8600000US96065,307,161,146,35000,48446,8581,96065
8600000US96067,5736,2719,3017,47964,72691,16348,96067
8600000US96068,161,121,40,,25317,8005,96068
8600000US96069,701,352,349,54676,68893,18717,96069
8600000US96071,49,25,24,71071,61608,17313,96071
8600000US96073,3195,1596,1599,85694,99389,9064,96073
8600000US96074,154,91,63,38750,47034,15758,96074
8600000US96075,328,226,102,15391,26874,9878,96075
8600000US96076,200,115,85,38333,47319,14923,96076
8600000US96080,21792,10824,10968,41617,58839,4017,96080
8600000US96084,333,157,176,41250,48355,9433,96084
8600000US96085,62,33,29,,93139,42545,96085
8600000US96086,269,133,136,41667,47029,8454,96086
8600000US96087,481,291,190,40147,54037,12264,96087
8600000US96088,3823,2062,1761,48056,59282,5883,96088
8600000US96090,383,199,184,43906,57569,12731,96090
8600000US96091,538,295,243,47500,58480,7157,96091
8600000US96092,246,185,61,41964,65059,31590,96092
8600000US96093,2920,1465,1455,42364,54371,9460,96093
8600000US96094,5252,2577,2675,51862,82206,24114,96094
8600000US96096,604,320,284,53125,69295,12304,96096
8600000US96097,7463,3509,3954,42332,56812,4622,96097
8600000US96101,4524,2276,2248,42097,52549,5907,96101
8600000US96103,1313,600,713,65234,112605,59017,96103
8600000US96104,436,207,229,43438,52271,11682,96104
8600000US96105,93,35,58,46161,45177,9326,96105
8600000US96106,190,100,90,86250,88218,14991,96106
8600000US96107,1234,642,592,55938,71220,15565,96107
8600000US96108,56,32,24,,46671,28086,96108
8600000US96109,710,403,307,42202,56492,17325,96109
8600000US96110,136,71,65,59250,72117,22733,96110
8600000US96111,68,49,19,51193,67316,29527,96111
8600000US96112,142,54,88,44500,52878,14628,96112
8600000US96113,1800,1453,347,48824,49391,5564,96113
8600000US96114,2652,1370,1282,87639,91285,11077,96114
8600000US96115,115,68,47,,35050,12602,96115
8600000US96116,159,83,76,51913,67199,19470,96116
8600000US96117,230,113,117,37647,34526,10640,96117
8600000US96118,1460,709,751,46822,59132,9405,96118
8600000US96119,43,22,21,,34281,38970,96119
8600000US96120,820,422,398,59625,84905,23437,96120
8600000US96121,274,172,102,87596,107310,54314,96121
8600000US96122,2421,1095,1326,52083,62705,11021,96122
8600000US96123,22,10,12,35250,33000,11333,96123
8600000US96124,284,111,173,41992,75671,34112,96124
8600000US96125,184,82,102,114297,124229,21892,96125
8600000US96126,103,74,29,,52758,28352,96126
8600000US96128,584,320,264,64423,90929,22423,96128
8600000US96129,351,165,186,119111,142088,83840,96129
8600000US96130,17284,12840,4444,56369,71581,4082,96130
8600000US96132,63,25,38,31250,33314,10860,96132
8600000US96133,73,42,31,23036,24265,2782,96133
8600000US96134,1420,762,658,38500,60553,13336,96134
8600000US96135,118,45,73,,63018,73324,96135
8600000US96136,42,6,36,,25869,21052,96136
8600000US96137,2845,1357,1488,55043,66732,5690,96137
8600000US96140,945,501,444,53239,72233,14838,96140
8600000US96141,256,127,129,67679,111134,56649,96141
8600000US96142,622,330,292,74630,83055,20271,96142
8600000US96143,2720,1407,1313,47946,63722,10916,96143
8600000US96145,1826,968,858,72431,90088,17073,96145
8600000US96146,822,491,331,80000,140372,46643,96146
8600000US96148,529,313,216,73214,77385,22084,96148
8600000US96150,24268,12338,11930,56321,79542,4573,96150
8600000US96155,0,0,0,,,,96155
8600000US96161,14265,7299,6966,93971,128675,10884,96161
8600000US96701,32775,16809,15966,95223,111279,3887,96701
8600000US96703,1594,751,843,59833,80263,12395,96703
8600000US96704,6072,2943,3129,52714,101222,33171,96704
8600000US96705,2092,1097,995,79000,84464,8255,96705
8600000US96706,52541,25571,26970,101147,113610,3714,96706
8600000US96707,34764,16895,17869,100739,115673,4450,96707
8600000US96708,8062,3967,4095,86117,112055,16051,96708
8600000US96710,246,109,137,,67908,38062,96710
8600000US96712,5718,2947,2771,89241,122213,12578,96712
8600000US96713,996,489,507,,80432,25494,96713
8600000US96714,645,343,302,39000,58805,8606,96714
8600000US96716,2431,1135,1296,74776,88278,12063,96716
8600000US96717,3545,1746,1799,84013,93659,8184,96717
8600000US96719,1373,639,734,64958,79118,19639,96719
8600000US96720,39385,19331,20054,59878,74565,3571,96720
8600000US96722,1623,802,821,73242,93550,15123,96722
8600000US96725,2272,1242,1030,70906,86338,15245,96725
8600000US96726,378,186,192,,95339,33489,96726
8600000US96727,4095,1998,2097,60707,73940,8113,96727
8600000US96728,388,192,196,70119,80412,17244,96728
8600000US96729,877,468,409,41375,59189,8376,96729
8600000US96730,1078,550,528,80625,95798,11913,96730
8600000US96731,2101,1028,1073,83068,107443,13011,96731
8600000US96732,22507,11158,11349,81329,95996,5119,96732
8600000US96734,39830,21162,18668,101605,131764,5716,96734
8600000US96737,2998,1453,1545,16884,32771,8975,96737
8600000US96738,4782,2340,2442,73891,83931,7387,96738
8600000US96740,32023,16377,15646,76296,97211,6390,96740
8600000US96741,5029,2514,2515,89844,103019,10992,96741
8600000US96742,71,36,35,61875,74364,12716,96742
8600000US96743,10724,4819,5905,88416,122965,18984,96743
8600000US96744,42145,21104,21041,106174,125597,4505,96744
8600000US96746,15547,7457,8090,83434,90474,5886,96746
8600000US96747,709,358,351,58182,68888,13560,96747
8600000US96748,3348,1578,1770,49896,62504,8108,96748
8600000US96749,13374,6596,6778,54355,67667,6052,96749
8600000US96750,2630,1313,1317,64159,82594,14494,96750
8600000US96751,69,35,34,46019,43345,9196,96751
8600000US96752,2720,1351,1369,78487,79924,8697,96752
8600000US96753,22342,11061,11281,72050,99665,6184,96753
8600000US96754,2457,1225,1232,87179,109716,16193,96754
8600000US96755,2359,1110,1249,67203,74956,10683,96755
8600000US96756,4721,2309,2412,70313,89924,6460,96756
8600000US96757,426,213,213,42917,52583,10672,96757
8600000US96759,283,165,118,43649,35946,19047,96759
8600000US96760,2405,1184,1221,58992,63273,9160,96760
8600000US96761,17972,9309,8663,79071,110413,11119,96761
8600000US96762,5021,2615,2406,100341,116934,12860,96762
8600000US96763,2318,1164,1154,53589,69856,10325,96763
8600000US96764,488,246,242,53553,67993,16544,96764
8600000US96765,291,122,169,72647,70763,18173,96765
8600000US96766,13838,6970,6868,78876,96035,7645,96766
8600000US96768,14670,7232,7438,80463,95037,5984,96768
8600000US96769,242,126,116,43897,52110,10525,96769
8600000US96770,406,206,200,23125,36792,11714,96770
8600000US96771,5928,2857,3071,36487,52537,7570,96771
8600000US96772,1919,930,989,48125,64095,8068,96772
8600000US96773,53,26,27,73750,77396,25941,96773
8600000US96774,181,102,79,,39198,19770,96774
8600000US96776,1084,611,473,45598,71118,16822,96776
8600000US96777,1462,691,771,50000,75147,31376,96777
8600000US96778,12148,6018,6130,37417,52339,4907,96778
8600000US96779,2027,933,1094,101014,129061,20261,96779
8600000US96780,546,262,284,,84628,55944,96780
8600000US96781,922,384,538,53179,81291,37654,96781
8600000US96782,30832,16074,14758,87651,106832,5159,96782
8600000US96783,1332,580,752,41875,51508,8293,96783
8600000US96785,2871,1560,1311,39784,58466,15775,96785
8600000US96786,30907,16393,14514,62688,75849,3290,96786
8600000US96789,41297,21168,20129,98499,113342,3017,96789
8600000US96790,7773,3764,4009,78664,113544,14327,96790
8600000US96791,6200,3018,3182,81212,99528,7695,96791
8600000US96792,35425,17229,18196,64059,81406,4079,96792
8600000US96793,25030,12149,12881,81702,97149,6063,96793
8600000US96795,7327,3471,3856,86324,108180,10676,96795
8600000US96796,1638,756,882,64500,97083,18213,96796
8600000US96797,58171,28433,29738,90993,106668,4047,96797
8600000US96813,20911,10407,10504,74355,96576,6033,96813
8600000US96814,17257,8126,9131,63495,85415,5758,96814
8600000US96815,22701,11553,11148,61735,84177,3973,96815
8600000US96816,42339,20269,22070,85164,116371,4727,96816
8600000US96817,47140,23082,24058,61384,91810,5945,96817
8600000US96818,42455,21565,20890,75917,91888,3821,96818
8600000US96819,42214,21534,20680,80546,104888,4930,96819
8600000US96821,15133,7321,7812,134892,164225,8886,96821
8600000US96822,40026,19078,20948,73024,101213,4278,96822
8600000US96825,23416,11428,11988,118571,147620,7103,96825
8600000US96826,27283,13424,13859,50400,66037,4208,96826
8600000US96850,0,0,0,,,,96850
8600000US96853,599,465,134,,,,96853
8600000US96857,2815,2590,225,,,,96857
8600000US96859,111,64,47,,,,96859
8600000US96860,2203,1923,280,,,,96860
8600000US96863,46,46,0,,,,96863
8600000US97001,324,102,222,43333,57422,28088,97001
8600000US97002,4672,2425,2247,71587,93306,9726,97002
8600000US97004,3619,1818,1801,80036,101251,11029,97004
8600000US97005,20966,9961,11005,49127,68296,5785,97005
8600000US97006,55349,27619,27730,74116,87728,2507,97006
8600000US97007,54747,26905,27842,83605,100711,3315,97007
8600000US97008,23524,11374,12150,65091,80246,4335,97008
8600000US97009,6834,3541,3293,79149,98336,9547,97009
8600000US97011,522,262,260,42024,53004,15640,97011
8600000US97013,17731,8775,8956,70461,86067,4451,97013
8600000US97014,913,484,429,50357,57012,9298,97014
8600000US97015,17970,8764,9206,75723,89869,4787,97015
8600000US97016,4891,2349,2542,47794,63366,9521,97016
8600000US97017,2566,1218,1348,81477,95691,11673,97017
8600000US97018,1733,902,831,67587,79213,9512,97018
8600000US97019,2516,1294,1222,68882,83990,9636,97019
8600000US97020,763,393,370,66250,77103,11030,97020
8600000US97021,765,418,347,54375,74211,13584,97021
8600000US97022,3151,1426,1725,76020,87613,10569,97022
8600000US97023,7873,3946,3927,66226,86297,13768,97023
8600000US97024,8317,3999,4318,60829,72989,5596,97024
8600000US97026,3110,1767,1343,66676,76582,10552,97026
8600000US97027,9433,4371,5062,61638,79291,7577,97027
8600000US97028,147,106,41,66971,78339,32208,97028
8600000US97029,271,140,131,49375,89179,37149,97029
8600000US97030,28854,13540,15314,50318,61710,3169,97030
8600000US97031,14483,7144,7339,63838,87325,9380,97031
8600000US97032,3578,1789,1789,55859,70122,7002,97032
8600000US97033,40,28,12,25833,63250,40938,97033
8600000US97034,14760,6908,7852,120473,174269,10773,97034
8600000US97035,20824,10113,10711,94531,130985,8035,97035
8600000US97037,775,413,362,45679,54797,9984,97037
8600000US97038,11562,5868,5694,61716,74479,4308,97038
8600000US97039,406,217,189,57212,75313,16535,97039
8600000US97040,1158,616,542,69042,79003,14077,97040
8600000US97041,2086,1064,1022,70833,81499,10472,97041
8600000US97042,2442,1276,1166,73669,87366,10113,97042
8600000US97045,43423,21179,22244,76495,91935,3498,97045
8600000US97048,6147,3114,3033,55534,68251,5454,97048
8600000US97049,1282,669,613,76528,82402,13764,97049
8600000US97050,160,79,81,50893,54928,10671,97050
8600000US97051,12114,5776,6338,55194,69073,4664,97051
8600000US97053,2619,1312,1307,64652,97057,33055,97053
8600000US97054,1501,677,824,74844,78870,9612,97054
8600000US97055,14076,6848,7228,68789,80470,4688,97055
8600000US97056,8972,4710,4262,73505,85649,6657,97056
8600000US97057,9,4,5,22750,21933,2420,97057
8600000US97058,15657,7675,7982,50407,62914,2951,97058
8600000US97060,16525,8355,8170,67239,83776,4733,97060
8600000US97062,22369,10694,11675,82077,103323,4452,97062
8600000US97063,823,452,371,51774,83795,39694,97063
8600000US97064,2543,1319,1224,58300,64063,6207,97064
8600000US97065,465,257,208,42250,70233,24144,97065
8600000US97067,1708,928,780,55038,60227,8757,97067
8600000US97068,22519,10720,11799,104618,139386,8906,97068
8600000US97070,19265,8441,10824,69842,103831,7268,97070
8600000US97071,20628,9675,10953,47994,61204,3494,97071
8600000US97080,33862,16791,17071,72917,86821,4230,97080
8600000US97086,23909,11559,12350,89852,120447,6807,97086
8600000US97089,10740,5253,5487,94656,107965,6754,97089
8600000US97101,2975,1456,1519,56538,70928,8208,97101
8600000US97102,280,133,147,,137319,54936,97102
8600000US97103,14309,7098,7211,52846,67589,3579,97103
8600000US97106,3797,1988,1809,100855,112275,9026,97106
8600000US97107,1383,712,671,57132,64217,7512,97107
8600000US97108,409,143,266,43472,50734,10975,97108
8600000US97109,402,223,179,68500,102395,31007,97109
8600000US97110,917,362,555,37232,62348,14443,97110
8600000US97111,2740,1295,1445,62575,69661,8139,97111
8600000US97112,1561,801,760,44231,55746,8963,97112
8600000US97113,10822,5585,5237,63689,76899,6543,97113
8600000US97114,3668,1810,1858,61172,77057,7253,97114
8600000US97115,3001,1411,1590,74375,86879,9470,97115
8600000US97116,20437,9522,10915,61981,77683,4658,97116
8600000US97117,549,301,248,82132,98702,24034,97117
8600000US97118,767,395,372,41083,74121,35703,97118
8600000US97119,3973,2105,1868,88750,112056,22638,97119
8600000US97121,1085,577,508,59554,69526,11895,97121
8600000US97122,328,194,134,41196,44982,10153,97122
8600000US97123,36018,17918,18100,74211,89940,3713,97123
8600000US97124,41627,20881,20746,86400,99239,3838,97124
8600000US97125,209,99,110,139875,126629,36807,97125
8600000US97127,3022,1499,1523,63832,74210,8644,97127
8600000US97128,29052,14391,14661,53815,79052,6074,97128
8600000US97130,354,188,166,51691,61794,14152,97130
8600000US97131,2219,1114,1105,60156,74702,14053,97131
8600000US97132,23199,11113,12086,63750,82649,4316,97132
8600000US97133,3475,1724,1751,95433,115342,13340,97133
8600000US97134,175,106,69,61823,74093,21405,97134
8600000US97135,651,366,285,,38716,11583,97135
8600000US97136,1362,591,771,43585,50850,7488,97136
8600000US97137,988,522,466,89083,101234,9029,97137
8600000US97138,8391,4075,4316,47017,64171,5771,97138
8600000US97140,17983,8616,9367,105388,122837,7064,97140
8600000US97141,10849,5444,5405,46557,65303,7118,97141
8600000US97144,76,43,33,,52603,32581,97144
8600000US97145,368,203,165,85486,67449,16693,97145
8600000US97146,5138,2565,2573,57806,71966,4921,97146
8600000US97147,283,111,172,43036,60319,18154,97147
8600000US97148,2996,1449,1547,79688,114078,14257,97148
8600000US97149,786,408,378,50873,59574,15232,97149
8600000US97201,16832,8449,8383,51625,96865,7828,97201
8600000US97202,35594,16920,18674,73924,100566,4817,97202
8600000US97203,26951,13430,13521,60908,75017,3436,97203
8600000US97204,1065,800,265,11763,35474,26299,97204
8600000US97205,6939,3590,3349,33302,64671,5368,97205
8600000US97206,42463,21025,21438,63381,76845,2662,97206
8600000US97208,0,0,0,,,,97208
8600000US97209,16982,9167,7815,61070,87462,8833,97209
8600000US97210,10601,5220,5381,79696,138806,11514,97210
8600000US97211,29184,14349,14835,78154,95509,4136,97211
8600000US97212,21561,10265,11296,101492,136986,8071,97212
8600000US97213,26704,13223,13481,71574,92113,3538,97213
8600000US97214,22740,11554,11186,65183,87672,4154,97214
8600000US97215,15721,7710,8011,80024,105871,7244,97215
8600000US97216,13539,6600,6939,45742,58314,3867,97216
8600000US97217,29060,14446,14614,74094,89405,3996,97217
8600000US97218,11949,5889,6060,63791,71324,4608,97218
8600000US97219,34027,16250,17777,97454,128818,5911,97219
8600000US97220,24656,11693,12963,51575,64552,2160,97220
8600000US97221,9600,4620,4980,109119,151127,10986,97221
8600000US97222,29782,14638,15144,58998,70932,2306,97222
8600000US97223,38919,18836,20083,79300,96946,4033,97223
8600000US97224,27127,12705,14422,74498,100467,6901,97224
8600000US97225,21293,10703,10590,81965,110183,4123,97225
8600000US97227,4220,2074,2146,60333,90736,9893,97227
8600000US97229,49188,23943,25245,112456,148736,5420,97229
8600000US97230,31622,15277,16345,51506,64797,2774,97230
8600000US97231,3388,1752,1636,91786,164915,29879,97231
8600000US97232,11151,5401,5750,59807,89620,6252,97232
8600000US97233,29560,14553,15007,39957,50839,2883,97233
8600000US97236,30621,14929,15692,47969,62358,3291,97236
8600000US97239,15031,7204,7827,86455,121579,8397,97239
8600000US97266,27020,13647,13373,48138,60626,2620,97266
8600000US97267,26135,12620,13515,68948,86880,4976,97267
8600000US97301,42731,22890,19841,39670,52194,2489,97301
8600000US97302,29967,14172,15795,63366,83830,5015,97302
8600000US97303,30462,14412,16050,61828,76629,4041,97303
8600000US97304,24029,11535,12494,66438,86017,6347,97304
8600000US97305,31049,15114,15935,49348,59337,3016,97305
8600000US97306,24069,11349,12720,65570,86194,6440,97306
8600000US97317,19591,10532,9059,60099,75750,6256,97317
8600000US97321,20713,9915,10798,70404,83388,4247,97321
8600000US97322,27572,13468,14104,49966,65320,5196,97322
8600000US97324,991,486,505,57440,67056,8627,97324
8600000US97325,5144,2388,2756,58510,72415,8534,97325
8600000US97326,965,505,460,55375,69223,13217,97326
8600000US97327,2659,1233,1426,51898,73701,9551,97327
8600000US97329,179,84,95,,54477,46756,97329
8600000US97330,36158,18153,18005,53610,80126,5046,97330
8600000US97331,2744,1217,1527,,,,97331
8600000US97333,19614,10392,9222,52314,71459,3947,97333
8600000US97338,17068,8038,9030,61430,70429,3457,97338
8600000US97341,2350,1179,1171,46981,64855,10785,97341
8600000US97342,132,68,64,25250,60676,31540,97342
8600000US97343,194,96,98,22500,36535,24121,97343
8600000US97344,1074,541,533,43802,60415,10221,97344
8600000US97345,369,170,199,43229,42877,12030,97345
8600000US97346,809,437,372,63281,62935,8498,97346
8600000US97347,1578,729,849,44183,53380,8808,97347
8600000US97348,1159,543,616,60863,80348,24246,97348
8600000US97350,175,69,106,43906,52215,11494,97350
8600000US97351,7484,3561,3923,47758,58857,4908,97351
8600000US97352,4786,2442,2344,65263,74682,6809,97352
8600000US97355,23283,11249,12034,50021,61518,3018,97355
8600000US97357,168,72,96,54474,63310,15717,97357
8600000US97358,2261,1079,1182,65344,72774,8798,97358
8600000US97360,1683,803,880,39167,47040,8247,97360
8600000US97361,9793,4789,5004,41400,53495,4530,97361
8600000US97362,3597,1767,1830,53813,66582,9075,97362
8600000US97364,472,172,300,53563,64005,17414,97364
8600000US97365,9044,4333,4711,47949,60454,4469,97365
8600000US97366,1482,656,826,50337,72002,10725,97366
8600000US97367,7777,3430,4347,38843,48622,2829,97367
8600000US97368,2885,1549,1336,40662,67250,15838,97368
8600000US97369,215,98,117,,125819,65310,97369
8600000US97370,6594,3231,3363,71992,85703,7187,97370
8600000US97371,549,278,271,121500,152343,41411,97371
8600000US97373,206,206,0,,,,97373
8600000US97374,3652,1851,1801,61800,77203,9142,97374
8600000US97375,1181,539,642,71505,75065,9788,97375
8600000US97376,967,497,470,51696,78119,18552,97376
8600000US97377,884,474,410,60559,87108,39067,97377
8600000US97378,6741,4055,2686,53981,68079,7819,97378
8600000US97380,2152,1015,1137,46053,58434,11698,97380
8600000US97381,12015,5464,6551,67472,91957,9183,97381
8600000US97383,7089,3546,3543,63200,76550,11925,97383
8600000US97384,0,0,0,,,,97384
8600000US97385,2695,1245,1450,73712,81899,13116,97385
8600000US97386,10702,5221,5481,47586,60232,7020,97386
8600000US97388,717,346,371,53346,86958,41757,97388
8600000US97389,1310,633,677,60703,83764,16960,97389
8600000US97390,801,426,375,46792,47965,8386,97390
8600000US97391,4318,2102,2216,52813,67943,8159,97391
8600000US97392,4876,2505,2371,77033,84979,7825,97392
8600000US97394,4354,2054,2300,45174,54907,5696,97394
8600000US97396,2500,1269,1231,51371,56400,4577,97396
8600000US97401,39206,19153,20053,36228,58103,3161,97401
8600000US97402,40705,20382,20323,44762,55134,1533,97402
8600000US97403,11875,5960,5915,45706,77342,8288,97403
8600000US97404,26795,12818,13977,61006,74424,3624,97404
8600000US97405,37858,18119,19739,66925,87836,4176,97405
8600000US97406,13,13,0,,,,97406
8600000US97408,10316,4705,5611,61067,99378,11268,97408
8600000US97410,689,369,320,65329,58876,14461,97410
8600000US97411,6372,3130,3242,36531,52999,7210,97411
8600000US97412,380,175,205,38542,50725,7847,97412
8600000US97413,884,410,474,51316,60880,9288,97413
8600000US97414,202,158,44,9063,10921,6386,97414
8600000US97415,12169,6067,6102,46768,57362,4722,97415
8600000US97416,867,461,406,53397,65919,16876,97416
8600000US97417,1982,984,998,34136,42432,4555,97417
8600000US97419,967,430,537,47326,61460,10148,97419
8600000US97420,22246,10541,11705,46481,63222,4496,97420
8600000US97423,5701,3075,2626,36927,57821,10089,97423
8600000US97424,14341,6959,7382,45766,57383,3264,97424
8600000US97426,7288,3558,3730,59522,69596,5571,97426
8600000US97429,698,374,324,45000,60800,9136,97429
8600000US97430,276,139,137,42115,57173,11874,97430
8600000US97431,1937,902,1035,53864,78779,21651,97431
8600000US97434,751,373,378,36071,44293,9445,97434
8600000US97435,1829,969,860,46042,57980,8084,97435
8600000US97436,718,353,365,51000,75447,14305,97436
8600000US97437,2408,1194,1214,69404,75067,8981,97437
8600000US97438,904,443,461,59479,79988,23392,97438
8600000US97439,12550,5794,6756,42915,58141,4810,97439
8600000US97441,259,133,126,44394,41582,9755,97441
8600000US97442,1618,759,859,32895,44955,8734,97442
8600000US97443,1707,907,800,53707,72710,18103,97443
8600000US97444,4551,2184,2367,48612,68264,11235,97444
8600000US97446,4045,1999,2046,49871,64840,10408,97446
8600000US97447,323,161,162,28011,34353,13034,97447
8600000US97448,10188,5050,5138,53844,66281,4586,97448
8600000US97449,1850,897,953,40917,52252,5786,97449
8600000US97450,292,121,171,47083,50649,19253,97450
8600000US97451,261,144,117,105500,122686,38329,97451
8600000US97452,1292,635,657,59667,74985,11475,97452
8600000US97453,789,397,392,45045,53374,8097,97453
8600000US97454,1139,602,537,78750,89236,10273,97454
8600000US97455,2163,938,1225,76458,82512,16957,97455
8600000US97456,2142,1111,1031,51758,79858,13342,97456
8600000US97457,8158,4069,4089,46355,56102,4232,97457
8600000US97458,3804,1793,2011,39450,52181,5826,97458
8600000US97459,10515,5200,5315,49673,68094,7659,97459
8600000US97461,655,373,282,84185,93838,25275,97461
8600000US97462,3206,1545,1661,46667,60121,6682,97462
8600000US97463,3313,1864,1449,38362,42214,6038,97463
8600000US97465,1805,849,956,35370,52277,13969,97465
8600000US97466,884,382,502,28542,39018,6754,97466
8600000US97467,4078,1907,2171,37705,49338,4603,97467
8600000US97469,2164,1090,1074,47774,48851,4756,97469
8600000US97470,16303,8252,8051,44363,54092,3365,97470
8600000US97471,24729,11560,13169,51003,71380,4844,97471
8600000US97473,254,120,134,51324,51326,7627,97473
8600000US97476,369,198,171,56295,66315,22017,97476
8600000US97477,29787,14675,15112,41493,53674,2929,97477
8600000US97478,30523,14879,15644,54641,70711,4432,97478
8600000US97479,7518,3731,3787,46250,53680,4086,97479
8600000US97480,289,153,136,23802,36977,10922,97480
8600000US97481,617,351,266,66029,81196,22304,97481
8600000US97484,182,97,85,42232,45920,8877,97484
8600000US97486,509,269,240,53393,157376,151460,97486
8600000US97487,6978,3378,3600,51378,63318,5258,97487
8600000US97488,1042,560,482,62019,85473,16374,97488
8600000US97489,760,410,350,71680,97365,35190,97489
8600000US97490,225,121,104,46111,56485,18298,97490
8600000US97492,586,307,279,40069,48213,13478,97492
8600000US97493,313,164,149,52639,63388,16471,97493
8600000US97494,36,15,21,,,,97494
8600000US97495,1475,718,757,80605,82951,15496,97495
8600000US97496,5583,2625,2958,39232,60934,11582,97496
8600000US97497,1236,682,554,32764,46550,11200,97497
8600000US97498,1432,679,753,48788,55519,7866,97498
8600000US97499,1417,653,764,40000,45970,4713,97499
8600000US97501,34699,16719,17980,43037,54811,2566,97501
8600000US97502,21630,10296,11334,55748,78352,9027,97502
8600000US97503,9272,4741,4531,53883,59318,4832,97503
8600000US97504,37157,17963,19194,54199,73820,3517,97504
8600000US97520,20990,9768,11222,53250,82466,5427,97520
8600000US97522,496,258,238,37639,67510,28254,97522
8600000US97523,4726,2247,2479,33380,46195,5698,97523
8600000US97524,11768,5745,6023,63791,82802,10287,97524
8600000US97525,3690,1855,1835,51712,62988,6448,97525
8600000US97526,28106,13285,14821,46507,62695,4161,97526
8600000US97527,28708,13652,15056,43776,59407,4268,97527
8600000US97530,5595,2669,2926,62932,76656,8741,97530
8600000US97531,870,466,404,,68129,60568,97531
8600000US97532,2174,1118,1056,54444,63287,11600,97532
8600000US97534,663,377,286,22038,31410,14613,97534
8600000US97535,4686,2274,2412,39694,48219,5121,97535
8600000US97536,832,454,378,33690,46744,6983,97536
8600000US97537,6502,3029,3473,52135,66084,9389,97537
8600000US97538,1441,804,637,34361,47315,10367,97538
8600000US97539,2862,1455,1407,41353,54708,11321,97539
8600000US97540,6677,2997,3680,43070,53614,4747,97540
8600000US97541,1206,662,544,50857,49351,11404,97541
8600000US97543,516,253,263,31638,51276,18035,97543
8600000US97544,1842,1000,842,37500,48935,10315,97544
8600000US97601,17911,9136,8775,40726,57726,3533,97601
8600000US97603,21996,10414,11582,46919,57758,3435,97603
8600000US97604,152,110,42,,,,97604
8600000US97620,136,70,66,58472,63942,15755,97620
8600000US97621,171,96,75,57713,44937,11255,97621
8600000US97622,417,218,199,43571,41900,8322,97622
8600000US97623,1986,1029,957,42905,53569,7079,97623
8600000US97624,2769,1453,1316,37689,49242,5931,97624
8600000US97625,225,107,118,60536,94381,43881,97625
8600000US97626,32,32,0,,,,97626
8600000US97627,529,264,265,56196,62027,17831,97627
8600000US97630,4117,2257,1860,41291,54779,4804,97630
8600000US97632,1197,564,633,47917,63468,10776,97632
8600000US97633,1000,534,466,45298,60729,9668,97633
8600000US97634,127,60,67,36500,50265,17849,97634
8600000US97635,120,64,56,26250,27910,9656,97635
8600000US97636,323,161,162,45938,50854,7717,97636
8600000US97637,81,39,42,37292,42382,8570,97637
8600000US97638,345,172,173,40417,43409,10772,97638
8600000US97639,695,334,361,40658,93131,69091,97639
8600000US97640,103,49,54,,54427,17890,97640
8600000US97641,1113,641,472,28322,41451,12780,97641
8600000US97701,53475,25689,27786,65211,90896,4638,97701
8600000US97702,37165,18092,19073,66848,88612,4470,97702
8600000US97707,5230,2979,2251,66186,76554,10407,97707
8600000US97710,118,56,62,88750,104606,32068,97710
8600000US97711,43,17,26,53750,64938,29501,97711
8600000US97712,39,22,17,,,,97712
8600000US97720,3532,1784,1748,39205,54052,6151,97720
8600000US97721,156,69,87,41429,64060,27208,97721
8600000US97722,75,37,38,56641,61502,10927,97722
8600000US97730,207,104,103,77917,101110,25880,97730
8600000US97731,309,168,141,29167,40472,18136,97731
8600000US97732,88,47,41,60000,62943,13631,97732
8600000US97733,405,205,200,35795,42807,18022,97733
8600000US97734,2258,1127,1131,55691,66703,6165,97734
8600000US97735,80,33,47,30714,27127,8816,97735
8600000US97736,79,50,29,73333,76850,20227,97736
8600000US97737,569,316,253,39931,49507,9431,97737
8600000US97738,1376,651,725,53438,59316,8580,97738
8600000US97739,10449,5188,5261,49816,55296,4633,97739
8600000US97741,9425,4955,4470,47055,61368,5194,97741
8600000US97750,248,128,120,35625,57951,14013,97750
8600000US97751,64,40,24,,46680,29952,97751
8600000US97752,0,0,0,,,,97752
8600000US97753,2087,1068,1019,92849,105210,21208,97753
8600000US97754,15669,7578,8091,41255,54474,3654,97754
8600000US97756,29684,14439,15245,59077,68465,3204,97756
8600000US97758,64,34,30,21932,56868,30240,97758
8600000US97759,6098,2992,3106,70662,95625,17502,97759
8600000US97760,5913,2972,2941,60688,71309,6841,97760
8600000US97761,2861,1479,1382,42625,51891,4543,97761
8600000US97801,16386,8662,7724,51120,64492,3337,97801
8600000US97810,790,398,392,76667,87540,13201,97810
8600000US97812,651,340,311,57708,68238,11707,97812
8600000US97813,1100,522,578,63107,65228,9535,97813
8600000US97814,9841,5072,4769,44442,63407,5760,97814
8600000US97817,6,3,3,,,,97817
8600000US97818,2939,1515,1424,51928,63723,8328,97818
8600000US97819,28,18,10,53750,122947,146606,97819
8600000US97820,766,413,353,51250,62634,10279,97820
8600000US97823,839,377,462,41182,48863,5753,97823
8600000US97824,1404,729,675,54250,67485,7894,97824
8600000US97825,244,126,118,50000,57904,9457,97825
8600000US97826,782,401,381,40625,63338,10434,97826
8600000US97827,1910,931,979,42107,51554,4770,97827
8600000US97828,2482,1218,1264,45769,61326,5809,97828
8600000US97830,619,310,309,30909,43421,6178,97830
8600000US97833,761,353,408,45625,61018,10438,97833
8600000US97834,779,379,400,41118,52768,9076,97834
8600000US97835,201,100,101,48523,59680,9795,97835
8600000US97836,1464,686,778,49107,61711,7697,97836
8600000US97837,46,24,22,,45425,19553,97837
8600000US97838,18495,9422,9073,55293,67732,6554,97838
8600000US97839,238,115,123,50625,56205,12787,97839
8600000US97840,87,49,38,79732,91397,18431,97840
8600000US97841,434,225,209,76500,79800,11926,97841
8600000US97842,127,65,62,35500,58315,22367,97842
8600000US97843,476,267,209,65208,78586,10537,97843
8600000US97844,2913,1456,1457,60637,66526,7023,97844
8600000US97845,2255,1100,1155,41365,56023,7435,97845
8600000US97846,1519,723,796,57333,74014,12020,97846
8600000US97848,183,102,81,50556,76947,34226,97848
8600000US97850,13370,6410,6960,46800,67953,5370,97850
8600000US97856,285,166,119,57500,57716,6893,97856
8600000US97857,465,222,243,41875,53701,9980,97857
8600000US97859,81,38,43,,59798,37111,97859
8600000US97862,8130,3993,4137,49556,64326,8018,97862
8600000US97864,187,94,93,22292,42184,14942,97864
8600000US97865,999,481,518,50031,58157,9264,97865
8600000US97867,499,238,261,36111,54735,10381,97867
8600000US97868,1542,783,759,54634,74511,12205,97868
8600000US97869,699,355,344,49219,50286,7444,97869
8600000US97870,548,257,291,41071,48880,8671,97870
8600000US97873,220,111,109,45729,56702,15547,97873
8600000US97874,343,164,179,35417,43647,8372,97874
8600000US97875,2382,1120,1262,58508,66210,6917,97875
8600000US97876,674,341,333,70673,78379,9682,97876
8600000US97877,257,145,112,11250,32347,11697,97877
8600000US97880,308,177,131,47500,54340,10888,97880
8600000US97882,6174,4117,2057,42221,52272,7213,97882
8600000US97883,1914,1019,895,54309,62838,5260,97883
8600000US97884,124,67,57,37344,48726,11964,97884
8600000US97885,1053,521,532,39076,53495,8154,97885
8600000US97886,883,437,446,62083,69613,7202,97886
8600000US97901,574,285,289,43646,56879,13184,97901
8600000US97903,85,43,42,74000,117779,64790,97903
8600000US97904,177,96,81,47813,101991,39124,97904
8600000US97905,143,78,65,82500,75073,25458,97905
8600000US97906,207,95,112,47708,62327,12221,97906
8600000US97907,377,203,174,47500,53526,9828,97907
8600000US97908,29,13,16,23750,31694,17180,97908
8600000US97909,71,37,34,,,,97909
8600000US97910,434,244,190,46136,68606,17739,97910
8600000US97911,70,41,29,45000,45990,26478,97911
8600000US97913,3199,1598,1601,44048,52602,5019,97913
8600000US97914,14872,8861,6011,41427,55158,3587,97914
8600000US97918,3029,1401,1628,43158,55840,5495,97918
8600000US97920,96,74,22,,32651,34015,97920
8600000US98001,24711,12379,12332,82581,97847,4340,98001
8600000US98002,25261,12527,12734,54309,64742,3765,98002
8600000US98003,37950,18307,19643,57185,74597,3398,98003
8600000US98004,28708,14106,14602,125190,185707,10477,98004
8600000US98005,14952,7603,7349,113707,157805,13923,98005
8600000US98006,28986,13833,15153,135836,180163,9180,98006
8600000US98007,23525,12719,10806,93534,116530,7724,98007
8600000US98008,19685,9917,9768,104250,142732,7423,98008
8600000US98010,4269,2146,2123,106438,121655,11376,98010
8600000US98011,25995,12985,13010,95896,111105,4648,98011
8600000US98012,47742,23337,24405,101652,118189,3544,98012
8600000US98014,5703,2875,2828,105877,132662,10153,98014
8600000US98019,8718,4154,4564,126250,146630,13037,98019
8600000US98020,16712,7831,8881,91813,127523,7202,98020
8600000US98021,23490,11635,11855,115120,136309,6325,98021
8600000US98022,16696,7971,8725,69206,89064,4866,98022
8600000US98023,38409,19404,19005,77177,93746,4093,98023
8600000US98024,4951,2506,2445,130725,150822,14775,98024
8600000US98026,30270,14787,15483,90424,114536,5455,98026
8600000US98027,23275,11100,12175,110156,136324,6454,98027
8600000US98028,17507,8883,8624,105007,126364,5515,98028
8600000US98029,20934,9531,11403,120533,144747,7436,98029
8600000US98030,27657,13681,13976,60823,75669,3366,98030
8600000US98031,28065,14209,13856,77788,90093,3180,98031
8600000US98032,28830,14540,14290,59717,75984,3847,98032
8600000US98033,31305,15401,15904,125407,167366,7511,98033
8600000US98034,34404,16504,17900,98683,122505,4780,98034
8600000US98036,30955,15297,15658,77514,97765,4848,98036
8600000US98037,23312,11525,11787,71211,84093,4058,98037
8600000US98038,25039,12288,12751,105462,120109,4325,98038
8600000US98039,2382,1173,1209,192120,308709,37354,98039
8600000US98040,19446,9213,10233,142413,219325,13025,98040
8600000US98042,37063,18428,18635,99727,118683,5179,98042
8600000US98043,16841,8020,8821,72669,86251,4657,98043
8600000US98045,11235,5663,5572,106368,132206,11840,98045
8600000US98047,5188,2369,2819,60407,72132,5065,98047
8600000US98050,450,272,178,137165,221754,127464,98050
8600000US98051,3309,1546,1763,89724,102992,12971,98051
8600000US98052,51964,26155,25809,125287,152306,4827,98052
8600000US98053,16594,8198,8396,134272,176364,10861,98053
8600000US98055,19253,9340,9913,70647,85731,4656,98055
8600000US98056,28396,14495,13901,85178,114096,7029,98056
8600000US98057,10427,5146,5281,51439,67486,6492,98057
8600000US98058,33662,16716,16946,89608,105075,5619,98058
8600000US98059,28792,14158,14634,102775,131643,6620,98059
8600000US98065,10539,5140,5399,139829,158506,8588,98065
8600000US98068,360,191,169,96351,113007,21595,98068
8600000US98070,8292,3834,4458,80144,114474,14844,98070
8600000US98072,18432,8897,9535,110375,145416,7770,98072
8600000US98074,19596,10013,9583,170744,202909,8490,98074
8600000US98075,16677,8202,8475,171840,204042,9330,98075
8600000US98077,10449,5433,5016,153807,206687,16837,98077
8600000US98087,29830,14712,15118,74236,88743,4579,98087
8600000US98092,34581,16937,17644,88529,104204,3783,98092
8600000US98101,12420,6943,5477,74394,111380,8670,98101
8600000US98102,23657,12842,10815,87425,123178,7478,98102
8600000US98103,44124,22196,21928,99048,124504,4439,98103
8600000US98104,13660,8445,5215,43601,80724,7809,98104
8600000US98105,43675,22075,21600,57417,112253,7389,98105
8600000US98106,20538,9522,11016,65781,79366,3294,98106
8600000US98107,22788,11422,11366,93943,127197,10084,98107
8600000US98108,18746,9240,9506,58526,78996,3934,98108
8600000US98109,26946,14388,12558,102292,129064,8515,98109
8600000US98110,18303,8877,9426,115230,144566,7478,98110
8600000US98112,21224,10588,10636,115265,199439,21393,98112
8600000US98115,42989,20577,22412,108069,140105,5196,98115
8600000US98116,22193,10730,11463,107276,129880,6787,98116
8600000US98117,27923,13553,14370,111220,137788,7228,98117
8600000US98118,37878,18769,19109,72545,98072,5347,98118
8600000US98119,22475,10784,11691,90994,139617,10172,98119
8600000US98121,17477,10423,7054,111606,134004,14148,98121
8600000US98122,34212,18025,16187,74598,108409,6411,98122
8600000US98125,35232,17090,18142,64429,88319,3457,98125
8600000US98126,18891,8785,10106,80142,105735,6535,98126
8600000US98133,40189,19044,21145,64001,83087,3761,98133
8600000US98134,791,631,160,74773,90177,22608,98134
8600000US98136,13615,6531,7084,106240,131546,8897,98136
8600000US98144,26671,13601,13070,74688,113794,8028,98144
8600000US98146,21499,10916,10583,67556,94109,6097,98146
8600000US98148,8894,4429,4465,56044,73879,5613,98148
8600000US98154,0,0,0,,,,98154
8600000US98155,27968,13313,14655,86525,103799,3904,98155
8600000US98158,0,0,0,,,,98158
8600000US98164,155,75,80,155391,217663,120107,98164
8600000US98166,16927,8894,8033,79623,109375,10094,98166
8600000US98168,25022,12963,12059,56885,72280,4013,98168
8600000US98174,0,0,0,,,,98174
8600000US98177,17460,8244,9216,109571,145796,7486,98177
8600000US98178,21113,10369,10744,75282,94493,8574,98178
8600000US98188,19734,10181,9553,57191,83065,15851,98188
8600000US98195,51,17,34,,,,98195
8600000US98198,29866,14938,14928,63284,84615,4463,98198
8600000US98199,17598,8557,9041,108328,151755,10297,98199
8600000US98201,24350,12688,11662,53309,69878,3446,98201
8600000US98203,27749,14113,13636,70405,87328,3639,98203
8600000US98204,32321,16252,16069,52279,62487,2193,98204
8600000US98205,10440,4846,5594,90825,102023,6760,98205
8600000US98207,1397,1171,226,,,,98207
8600000US98208,44073,21784,22289,87021,99152,3954,98208
8600000US98220,653,321,332,67000,59618,18345,98220
8600000US98221,17703,8392,9311,69367,93052,3223,98221
8600000US98222,71,35,36,94167,153235,55365,98222
8600000US98223,33211,16300,16911,85641,95962,4195,98223
8600000US98224,250,164,86,41250,45779,9732,98224
8600000US98225,44183,22010,22173,45320,64908,3667,98225
8600000US98226,34780,16678,18102,61779,80217,3786,98226
8600000US98229,25774,12555,13219,63458,89471,6429,98229
8600000US98230,13671,6919,6752,67585,79536,6187,98230
8600000US98232,3601,1801,1800,76620,96105,13318,98232
8600000US98233,11711,5896,5815,60844,80022,8573,98233
8600000US98235,74,16,58,,37448,27940,98235
8600000US98236,5196,2514,2682,73535,89867,9584,98236
8600000US98237,3555,1749,1806,52303,64217,6747,98237
8600000US98238,0,0,0,,,,98238
8600000US98239,6325,3155,3170,67750,85026,7464,98239
8600000US98240,2438,1228,1210,65917,76497,15133,98240
8600000US98241,1542,723,819,43151,54368,6814,98241
8600000US98243,565,288,277,91250,85341,11042,98243
8600000US98244,2446,1225,1221,60870,76645,15867,98244
8600000US98245,3175,1491,1684,48657,74018,5292,98245
8600000US98247,7094,3607,3487,59517,74945,7238,98247
8600000US98248,18766,9101,9665,70635,78959,4604,98248
8600000US98249,3585,1747,1838,66494,96592,15697,98249
8600000US98250,6843,3250,3593,66238,96242,5258,98250
8600000US98251,3249,1586,1663,70341,80929,10932,98251
8600000US98252,7456,3902,3554,80917,89797,8057,98252
8600000US98253,1516,847,669,63106,74372,12252,98253
8600000US98255,211,120,91,,72348,34471,98255
8600000US98256,286,154,132,62500,66660,10331,98256
8600000US98257,3370,1546,1824,62218,81962,6284,98257
8600000US98258,23833,11968,11865,91706,102116,3909,98258
8600000US98260,4803,2200,2603,70290,84553,7413,98260
8600000US98261,2311,1126,1185,57361,78708,4658,98261
8600000US98262,776,348,428,67500,88895,14004,98262
8600000US98263,65,31,34,86500,79510,12702,98263
8600000US98264,15294,7149,8145,64572,79531,4668,98264
8600000US98266,2743,1476,1267,28828,45730,10837,98266
8600000US98267,282,95,187,,32390,19591,98267
8600000US98270,37940,18224,19716,77174,86831,2990,98270
8600000US98271,22371,11310,11061,77602,89697,3556,98271
8600000US98272,24020,13475,10545,88684,105584,4931,98272
8600000US98273,22517,11032,11485,57921,71683,3911,98273
8600000US98274,13851,6852,6999,69170,88568,5706,98274
8600000US98275,16634,8052,8582,105146,130512,6363,98275
8600000US98276,386,177,209,64531,71883,14536,98276
8600000US98277,29607,14515,15092,57371,70810,2972,98277
8600000US98278,1716,1227,489,,,,98278
8600000US98279,572,308,264,51964,80158,10299,98279
8600000US98280,386,171,215,51667,116182,66572,98280
8600000US98281,1053,526,527,46964,70548,10246,98281
8600000US98282,13818,6860,6958,78590,100246,7058,98282
8600000US98283,376,171,205,53000,51661,17543,98283
8600000US98284,20739,10527,10212,62436,76692,5053,98284
8600000US98286,164,84,80,72500,133102,69617,98286
8600000US98288,155,79,76,42500,76716,34505,98288
8600000US98290,27771,13659,14112,92239,112729,5273,98290
8600000US98292,17643,8867,8776,78247,96236,6392,98292
8600000US98294,5490,2960,2530,69933,81938,9605,98294
8600000US98295,1972,934,1038,55227,62673,8886,98295
8600000US98296,22321,11267,11054,128915,143844,5720,98296
8600000US98297,29,18,11,26563,30506,13609,98297
8600000US98303,1105,588,517,69919,84583,17390,98303
8600000US98304,562,331,231,37759,46386,13355,98304
8600000US98305,277,115,162,35357,44522,15427,98305
8600000US98310,17300,8695,8605,52848,67954,4078,98310
8600000US98311,21799,11180,10619,75917,83221,3591,98311
8600000US98312,25119,12477,12642,62157,73630,3246,98312
8600000US98314,2321,1961,360,,108194,67761,98314
8600000US98315,4628,3331,1297,54339,56882,5148,98315
8600000US98320,1024,531,493,47240,61299,7054,98320
8600000US98321,11994,5928,6066,88974,97674,5457,98321
8600000US98323,610,325,285,80625,84486,8988,98323
8600000US98325,1335,746,589,51713,61248,12594,98325
8600000US98326,640,428,212,41576,51655,12692,98326
8600000US98327,6403,3201,3202,83273,98244,11706,98327
8600000US98328,7487,3659,3828,67787,80885,6821,98328
8600000US98329,8736,4432,4304,80880,96534,6951,98329
8600000US98330,103,75,28,,,,98330
8600000US98331,4984,2803,2181,38904,52183,5831,98331
8600000US98332,14653,6680,7973,98984,143823,14146,98332
8600000US98333,2981,1442,1539,95761,128897,15798,98333
8600000US98335,19951,9282,10669,92987,119337,6629,98335
8600000US98336,702,368,334,45313,46533,10407,98336
8600000US98337,6026,3400,2626,42422,55873,6790,98337
8600000US98338,20564,10299,10265,76991,89009,4046,98338
8600000US98339,2661,1367,1294,55156,60674,7862,98339
8600000US98340,2455,1105,1350,68571,82155,15170,98340
8600000US98342,1144,538,606,74091,93511,7135,98342
8600000US98345,341,194,147,49509,73481,22512,98345
8600000US98346,8197,4128,4069,84176,95181,7731,98346
8600000US98349,3275,1543,1732,58613,72386,11275,98349
8600000US98350,294,148,146,43125,57129,11471,98350
8600000US98351,874,422,452,49034,82240,36514,98351
8600000US98353,46,30,16,,,,98353
8600000US98354,5663,2768,2895,76270,88154,9213,98354
8600000US98355,706,414,292,21812,42832,16179,98355
8600000US98356,1745,905,840,43426,49839,6843,98356
8600000US98357,1093,564,529,40481,54507,5474,98357
8600000US98358,780,366,414,61900,70959,13319,98358
8600000US98359,3923,2042,1881,76452,93080,9341,98359
8600000US98360,10098,4785,5313,84102,92108,4225,98360
8600000US98361,766,430,336,38226,49836,13890,98361
8600000US98362,19424,9506,9918,48432,66922,3657,98362
8600000US98363,11095,5613,5482,55779,66911,3576,98363
8600000US98364,47,23,24,,,,98364
8600000US98365,4599,2274,2325,58266,83873,13214,98365
8600000US98366,26070,13070,13000,61309,76680,5007,98366
8600000US98367,22879,11430,11449,80951,93082,4514,98367
8600000US98368,13619,6395,7224,54873,73986,6522,98368
8600000US98370,24698,12104,12594,80781,98078,4115,98370
8600000US98371,16922,8225,8697,72626,92092,5621,98371
8600000US98372,19939,10037,9902,73308,88523,4303,98372
8600000US98373,18654,9070,9584,71778,88226,5702,98373
8600000US98374,29955,14315,15640,81053,97041,4421,98374
8600000US98375,21660,10738,10922,84198,91562,3301,98375
8600000US98376,1545,766,779,57679,73064,10929,98376
8600000US98377,1380,701,679,40262,50821,9257,98377
8600000US98380,3528,1899,1629,79386,95213,12708,98380
8600000US98381,281,144,137,57396,72353,11431,98381
8600000US98382,24798,11765,13033,50367,67739,3556,98382
8600000US98383,16910,8682,8228,76322,94362,6152,98383
8600000US98385,263,120,143,59063,68983,16514,98385
8600000US98387,36063,17651,18412,71350,80775,3231,98387
8600000US98388,5349,2776,2573,76912,96332,8014,98388
8600000US98390,8240,3965,4275,63209,81376,6433,98390
8600000US98391,37646,19389,18257,96718,116570,6427,98391
8600000US98392,2376,1095,1281,64097,76629,4033,98392
8600000US98394,1141,614,527,74722,122570,41663,98394
8600000US98396,553,314,239,59444,85380,17579,98396
8600000US98402,5873,2978,2895,50802,67963,6509,98402
8600000US98403,6723,3247,3476,62973,83659,7592,98403
8600000US98404,25303,12812,12491,53162,61658,2821,98404
8600000US98405,18671,8817,9854,50260,62894,2925,98405
8600000US98406,18678,8648,10030,73492,92522,4691,98406
8600000US98407,17308,8281,9027,76342,108273,7471,98407
8600000US98408,16121,8463,7658,55902,66627,4422,98408
8600000US98409,19318,9952,9366,51192,60909,3679,98409
8600000US98416,959,434,525,,,,98416
8600000US98418,7482,3660,3822,50543,60120,5645,98418
8600000US98421,1496,1364,132,,,,98421
8600000US98422,16233,8054,8179,94495,113425,3334,98422
8600000US98424,8289,4100,4189,65425,79962,4003,98424
8600000US98430,0,0,0,,,,98430
8600000US98433,12710,7900,4810,43355,52870,2973,98433
8600000US98438,487,430,57,,,,98438
8600000US98439,3629,1788,1841,41591,47935,4876,98439
8600000US98443,4520,2217,2303,81521,97265,5419,98443
8600000US98444,25977,11915,14062,44942,53139,1894,98444
8600000US98445,24371,11786,12585,63585,76142,4158,98445
8600000US98446,8181,4054,4127,74401,85439,5775,98446
8600000US98447,731,313,418,,,,98447
8600000US98465,5766,3032,2734,52353,70740,8651,98465
8600000US98466,22036,10504,11532,63852,86511,5792,98466
8600000US98467,12172,5793,6379,67923,87768,6594,98467
8600000US98498,23038,11051,11987,63318,79624,3967,98498
8600000US98499,23686,12025,11661,41178,58063,3793,98499
8600000US98501,32849,15681,17168,74220,88837,3365,98501
8600000US98502,28592,13652,14940,66737,88566,6481,98502
8600000US98503,30419,14037,16382,62116,73493,3740,98503
8600000US98506,14533,6711,7822,65248,81991,5706,98506
8600000US98512,24191,12254,11937,72903,87542,3806,98512
8600000US98513,26373,12880,13493,74224,86728,3901,98513
8600000US98516,18856,9282,9574,81194,99376,4879,98516
8600000US98520,18837,10549,8288,46839,60123,4046,98520
8600000US98524,3656,1808,1848,76000,84579,13779,98524
8600000US98526,189,96,93,53542,63709,13770,98526
8600000US98527,276,147,129,38250,39599,10652,98527
8600000US98528,8101,4182,3919,55521,71926,7677,98528
8600000US98530,522,245,277,41875,45913,10047,98530
8600000US98531,19166,9154,10012,43733,58300,3736,98531
8600000US98532,18945,9552,9393,59925,71904,3103,98532
8600000US98533,345,164,181,51948,58091,9686,98533
8600000US98535,518,279,239,,48276,29836,98535
8600000US98536,53,20,33,,,,98536
8600000US98537,1627,862,765,56667,67264,7620,98537
8600000US98538,283,132,151,59250,76115,16680,98538
8600000US98541,7784,3792,3992,48841,62226,6140,98541
8600000US98542,457,245,212,59583,66249,12748,98542
8600000US98544,23,11,12,,,,98544
8600000US98546,2735,1482,1253,64615,79090,10654,98546
8600000US98547,1098,549,549,41208,60810,28371,98547
8600000US98548,2232,1102,1130,40577,48193,6279,98548
8600000US98550,8684,4322,4362,45658,60705,6609,98550
8600000US98552,356,209,147,34500,52398,19265,98552
8600000US98555,329,96,233,,49296,38272,98555
8600000US98557,2642,1319,1323,56198,68413,6806,98557
8600000US98558,195,78,117,,,,98558
8600000US98559,0,0,0,,,,98559
8600000US98560,136,84,52,68375,76633,21302,98560
8600000US98562,0,0,0,,,,98562
8600000US98563,6160,3036,3124,65576,82727,15125,98563
8600000US98564,1931,995,936,49141,60774,7244,98564
8600000US98565,531,256,275,54737,68458,14915,98565
8600000US98568,2185,1037,1148,50265,59579,6865,98568
8600000US98569,5332,2548,2784,43801,52290,5659,98569
8600000US98570,3482,1829,1653,57008,66844,7751,98570
8600000US98571,409,187,222,,60648,41967,98571
8600000US98572,526,297,229,60234,67685,10187,98572
8600000US98575,152,69,83,54444,64634,15198,98575
8600000US98576,3852,1910,1942,65875,77623,8122,98576
8600000US98577,5375,2735,2640,49325,59886,4960,98577
8600000US98579,9877,4934,4943,69873,79804,6087,98579
8600000US98580,8677,4218,4459,62519,76978,7239,98580
8600000US98581,469,210,259,37019,43691,10002,98581
8600000US98582,228,93,135,,60431,24747,98582
8600000US98583,109,61,48,40781,47458,18361,98583
8600000US98584,29121,14923,14198,55526,66214,3456,98584
8600000US98585,521,189,332,77534,78675,22301,98585
8600000US98586,1290,646,644,43188,50443,6297,98586
8600000US98587,545,289,256,36563,47616,6390,98587
8600000US98588,1379,785,594,46372,78080,33290,98588
8600000US98589,6005,2771,3234,62093,75681,7015,98589
8600000US98590,354,170,184,40769,62606,21399,98590
8600000US98591,2713,1399,1314,52398,63006,6596,98591
8600000US98592,1398,714,684,65231,77215,18978,98592
8600000US98593,1047,512,535,48646,51173,7694,98593
8600000US98595,2281,1147,1134,43074,56642,8641,98595
8600000US98596,5745,2767,2978,57019,78042,16482,98596
8600000US98597,17556,8566,8990,66060,73695,3460,98597
8600000US98601,2152,1133,1019,64432,72131,9441,98601
8600000US98602,132,39,93,39130,39411,3949,98602
8600000US98603,911,470,441,68452,83025,13634,98603
8600000US98604,26734,12650,14084,80432,98942,4817,98604
8600000US98605,913,441,472,59375,63114,7647,98605
8600000US98606,6724,3309,3415,99840,119203,8565,98606
8600000US98607,23222,11480,11742,103391,126357,6628,98607
8600000US98610,2303,1158,1145,44866,63563,6701,98610
8600000US98611,7275,3417,3858,63288,71542,4518,98611
8600000US98612,2396,1143,1253,54683,66539,6628,98612
8600000US98613,360,176,184,54750,68007,10986,98613
8600000US98614,154,64,90,,32889,16087,98614
8600000US98616,80,40,40,85833,74873,22017,98616
8600000US98617,1173,593,580,67679,77161,14543,98617
8600000US98619,378,176,202,45982,56174,9163,98619
8600000US98620,5917,3130,2787,47601,52397,5162,98620
8600000US98621,326,163,163,65104,81535,35025,98621
8600000US98624,1267,658,609,43208,62522,11654,98624
8600000US98625,5311,2811,2500,75345,96918,12688,98625
8600000US98626,18322,8981,9341,51170,64702,3766,98626
8600000US98628,362,197,165,35263,48177,11527,98628
8600000US98629,6463,3255,3208,90231,102901,8156,98629
8600000US98631,2942,1378,1564,37063,51177,6462,98631
8600000US98632,39349,19261,20088,44385,62695,2978,98632
8600000US98635,1449,618,831,46936,57728,9616,98635
8600000US98638,1034,534,500,53452,80202,17149,98638
8600000US98639,896,418,478,64013,65280,7245,98639
8600000US98640,4237,2039,2198,41467,51865,7297,98640
8600000US98641,22,12,10,,,,98641
8600000US98642,14400,6975,7425,96014,120913,10955,98642
8600000US98643,321,145,176,65000,68347,16616,98643
8600000US98644,284,186,98,42639,48059,14538,98644
8600000US98645,1016,486,530,60515,67544,9292,98645
8600000US98647,261,147,114,,51276,22354,98647
8600000US98648,2587,1323,1264,56034,63122,4618,98648
8600000US98649,843,411,432,56591,69684,12528,98649
8600000US98650,735,340,395,64896,86093,13211,98650
8600000US98651,729,382,347,59514,89332,15528,98651
8600000US98660,10190,5221,4969,48573,67423,5099,98660
8600000US98661,36221,18097,18124,54964,72639,3949,98661
8600000US98662,24351,11682,12669,61170,74287,3446,98662
8600000US98663,11214,5744,5470,57943,74063,5779,98663
8600000US98664,18188,8672,9516,60753,81382,5124,98664
8600000US98665,20576,10238,10338,62530,82430,6261,98665
8600000US98670,43,16,27,38750,47491,25586,98670
8600000US98671,17630,8646,8984,85708,105474,6295,98671
8600000US98672,5216,2607,2609,62717,75762,7761,98672
8600000US98673,458,216,242,38542,52224,10371,98673
8600000US98674,9688,4959,4729,67190,82633,7585,98674
8600000US98675,5058,2823,2235,66793,96219,13219,98675
8600000US98682,42460,20865,21595,71519,82910,2321,98682
8600000US98683,25984,12074,13910,69225,89841,4910,98683
8600000US98684,22099,10643,11456,65664,81902,4794,98684
8600000US98685,22093,10438,11655,97200,117828,6278,98685
8600000US98686,15117,7451,7666,83840,98746,4784,98686
8600000US98801,32551,15849,16702,57552,79436,4734,98801
8600000US98802,22862,11158,11704,65120,82864,9143,98802
8600000US98811,102,51,51,85234,82355,12433,98811
8600000US98812,3691,1889,1802,46332,51908,6798,98812
8600000US98813,1892,1052,840,47647,51117,5038,98813
8600000US98814,655,313,342,51303,49033,8254,98814
8600000US98815,5540,2607,2933,61159,71349,6077,98815
8600000US98816,4835,2654,2181,53885,69522,7892,98816
8600000US98817,111,54,57,69485,68968,35879,98817
8600000US98819,202,104,98,38194,45300,7602,98819
8600000US98821,313,202,111,,53027,50834,98821
8600000US98822,1539,725,814,44922,58211,8534,98822
8600000US98823,7968,4109,3859,61764,82375,11941,98823
8600000US98824,253,127,126,39643,44587,9487,98824
8600000US98826,6002,2834,3168,55149,73764,10076,98826
8600000US98827,383,276,107,54583,44199,15613,98827
8600000US98828,1968,1098,870,63814,74414,12117,98828
8600000US98829,565,290,275,39107,51730,15304,98829
8600000US98830,493,254,239,52955,59570,8007,98830
8600000US98831,2229,1147,1082,56474,65811,8368,98831
8600000US98832,160,71,89,62500,78846,40088,98832
8600000US98833,138,71,67,,46215,31541,98833
8600000US98834,161,86,75,45000,88563,35181,98834
8600000US98836,830,377,453,40963,58217,22266,98836
8600000US98837,31143,15187,15956,55668,71707,4152,98837
8600000US98840,3271,1560,1711,39988,57885,12552,98840
8600000US98841,6921,3296,3625,47674,61717,8081,98841
8600000US98843,1332,786,546,55804,74209,15375,98843
8600000US98844,3580,1804,1776,41027,51114,6051,98844
8600000US98845,209,100,109,50313,56132,11563,98845
8600000US98846,815,427,388,56597,70090,14204,98846
8600000US98847,1637,823,814,47633,65815,18389,98847
8600000US98848,8467,4419,4048,57838,72527,5751,98848
8600000US98849,856,415,441,38393,46130,7856,98849
8600000US98850,1376,758,618,53386,54936,6905,98850
8600000US98851,3296,1672,1624,46406,54853,7052,98851
8600000US98852,10,3,7,36250,37050,2943,98852
8600000US98853,16,8,8,,,,98853
8600000US98855,4834,2573,2261,41250,49692,5018,98855
8600000US98856,2141,1070,1071,44295,64327,11840,98856
8600000US98857,2539,1352,1187,40461,56303,6170,98857
8600000US98858,1481,770,711,46164,60320,7377,98858
8600000US98859,154,84,70,,32654,19801,98859
8600000US98860,219,111,108,39250,54975,16725,98860
8600000US98862,1866,875,991,62955,73038,9852,98862
8600000US98901,22504,12176,10328,40437,54598,4040,98901
8600000US98902,33192,15969,17223,42379,57421,3279,98902
8600000US98903,10605,5235,5370,49626,65691,7778,98903
8600000US98908,28764,13646,15118,64020,85761,6215,98908
8600000US98921,303,212,91,31403,27632,7296,98921
8600000US98922,5462,3096,2366,57296,75410,11495,98922
8600000US98923,802,439,363,52639,56655,11839,98923
8600000US98925,503,266,237,64934,77505,16489,98925
8600000US98926,27737,13395,14342,53090,64565,2944,98926
8600000US98929,0,0,0,,,,98929
8600000US98930,10752,5410,5342,49155,62490,5073,98930
8600000US98932,3337,1582,1755,49455,58920,6437,98932
8600000US98933,815,393,422,51875,65736,6514,98933
8600000US98934,873,447,426,42115,47679,6434,98934
8600000US98935,2358,1223,1135,46023,51493,5154,98935
8600000US98936,4252,2137,2115,59617,69100,6493,98936
8600000US98937,3066,1549,1517,63642,80977,17000,98937
8600000US98938,2203,1126,1077,61935,70312,17461,98938
8600000US98939,104,62,42,,15922,12138,98939
8600000US98940,266,157,109,1e+05,143489,104243,98940
8600000US98941,519,240,279,53333,63639,12092,98941
8600000US98942,12437,5984,6453,58573,81307,14549,98942
8600000US98943,754,400,354,55000,67133,13833,98943
8600000US98944,14270,6762,7508,43129,60013,6042,98944
8600000US98946,474,236,238,58077,88111,26168,98946
8600000US98947,2066,943,1123,47891,69194,15297,98947
8600000US98948,8633,4573,4060,44565,51924,2666,98948
8600000US98950,77,32,45,,62167,21398,98950
8600000US98951,8629,4390,4239,46530,64124,6720,98951
8600000US98952,1656,878,778,47939,63879,10731,98952
8600000US98953,4830,2351,2479,65349,73854,7029,98953
8600000US99001,5768,4354,1414,47991,55678,4669,99001
8600000US99003,3920,1956,1964,75665,77654,7891,99003
8600000US99004,17269,8494,8775,49100,62615,3722,99004
8600000US99005,6622,3439,3183,93400,105569,9466,99005
8600000US99006,9736,4617,5119,62223,75053,5975,99006
8600000US99008,660,319,341,67899,80131,25239,99008
8600000US99009,2917,1585,1332,66250,73706,9768,99009
8600000US99011,2021,1181,840,67461,67941,6165,99011
8600000US99012,628,345,283,53625,72978,12756,99012
8600000US99013,1291,568,723,51732,56086,8404,99013
8600000US99016,10343,5344,4999,65015,86474,8166,99016
8600000US99017,110,55,55,48750,50172,7622,99017
8600000US99018,150,64,86,51250,55934,12144,99018
8600000US99019,8493,3859,4634,85351,121428,12370,99019
8600000US99020,0,0,0,,,,99020
8600000US99021,7145,3487,3658,66439,88819,7699,99021
8600000US99022,6748,3309,3439,63589,77910,7413,99022
8600000US99023,493,259,234,64900,142458,65258,99023
8600000US99025,3954,2145,1809,72053,82036,7753,99025
8600000US99026,7329,3976,3353,73627,84602,8268,99026
8600000US99027,4913,2333,2580,66576,87659,12435,99027
8600000US99029,818,400,418,64659,70633,10881,99029
8600000US99030,838,476,362,50625,64480,15021,99030
8600000US99031,1022,524,498,62589,74759,17600,99031
8600000US99032,614,306,308,39118,59887,13354,99032
8600000US99033,683,371,312,61389,67322,8708,99033
8600000US99034,1,1,0,,,,99034
8600000US99036,1211,610,601,77188,117570,26835,99036
8600000US99037,11487,5498,5989,58025,81798,8318,99037
8600000US99039,54,29,25,43438,47681,9796,99039
8600000US99040,537,251,286,26979,41724,7425,99040
8600000US99101,1101,605,496,42692,58938,15694,99101
8600000US99102,434,204,230,65625,68355,13943,99102
8600000US99103,398,211,187,63036,73317,8954,99103
8600000US99105,39,15,24,71250,70136,25377,99105
8600000US99109,4144,1981,2163,41000,54039,5550,99109
8600000US99110,1142,545,597,37721,50695,13234,99110
8600000US99111,3550,1880,1670,55547,70112,9063,99111
8600000US99113,592,297,295,60962,67001,8511,99113
8600000US99114,10013,4621,5392,48004,60927,4105,99114
8600000US99115,906,452,454,59554,70010,9928,99115
8600000US99116,1229,658,571,56172,66736,6397,99116
8600000US99117,362,188,174,45357,56951,7180,99117
8600000US99118,627,326,301,38438,57619,13741,99118
8600000US99119,902,481,421,47604,72899,15816,99119
8600000US99121,142,48,94,24712,50561,25328,99121
8600000US99122,2994,1511,1483,54583,67360,5117,99122
8600000US99123,788,419,369,54722,66894,10024,99123
8600000US99124,248,113,135,42578,51154,9764,99124
8600000US99125,487,265,222,43462,59555,9113,99125
8600000US99126,649,308,341,51953,68066,21826,99126
8600000US99128,235,122,113,64063,84176,14211,99128
8600000US99129,631,332,299,41618,48368,8869,99129
8600000US99130,670,317,353,60313,63737,5949,99130
8600000US99131,130,70,60,58125,114828,76890,99131
8600000US99133,1320,666,654,48500,60942,8677,99133
8600000US99134,439,228,211,36477,63547,13756,99134
8600000US99135,209,108,101,70139,71907,13960,99135
8600000US99136,12,7,5,,29300,29253,99136
8600000US99137,319,145,174,40000,47332,7772,99137
8600000US99138,858,387,471,36908,46669,5672,99138
8600000US99139,1033,500,533,53162,72460,13965,99139
8600000US99140,319,149,170,32639,49274,8827,99140
8600000US99141,4127,2073,2054,47967,57245,4385,99141
8600000US99143,605,317,288,51125,65902,9875,99143
8600000US99144,17,7,10,56250,62310,27836,99144
8600000US99146,63,39,24,,38484,22234,99146
8600000US99147,128,59,69,64375,64426,8931,99147
8600000US99148,1611,827,784,55000,73472,12249,99148
8600000US99149,205,95,110,38036,43356,8494,99149
8600000US99150,350,182,168,41250,57827,21420,99150
8600000US99151,128,59,69,31250,36142,8960,99151
8600000US99152,113,63,50,56944,82832,22301,99152
8600000US99153,348,182,166,34682,47941,7534,99153
8600000US99154,22,13,9,,88736,40061,99154
8600000US99155,852,406,446,29602,47163,9667,99155
8600000US99156,6632,3287,3345,48750,59090,3687,99156
8600000US99157,518,249,269,26908,35170,5403,99157
8600000US99158,437,237,200,58611,72608,10331,99158
8600000US99159,1173,609,564,53250,62774,7560,99159
8600000US99160,134,77,57,20385,21885,7706,99160
8600000US99161,1103,555,548,68092,75496,6887,99161
8600000US99163,30127,15081,15046,33079,54041,3012,99163
8600000US99164,0,0,0,,,,99164
8600000US99166,2568,1353,1215,43015,54236,5833,99166
8600000US99167,445,231,214,38917,48244,16159,99167
8600000US99169,1955,990,965,48177,60360,5620,99169
8600000US99170,758,380,378,47593,56838,6643,99170
8600000US99171,858,419,439,53681,58018,5017,99171
8600000US99173,1510,823,687,34924,43417,6339,99173
8600000US99174,43,21,22,,60114,22459,99174
8600000US99176,113,51,62,62875,87410,34652,99176
8600000US99179,385,209,176,78333,103527,25595,99179
8600000US99180,1022,538,484,47021,62367,10397,99180
8600000US99181,1308,660,648,46094,73517,16600,99181
8600000US99185,998,496,502,48824,64783,7867,99185
8600000US99201,11612,6191,5421,30019,46640,7111,99201
8600000US99202,17335,8603,8732,36047,52232,4748,99202
8600000US99203,16319,7728,8591,75389,103402,5795,99203
8600000US99204,5414,2680,2734,34404,55585,9035,99204
8600000US99205,33536,15748,17788,51117,62021,3378,99205
8600000US99206,28767,14070,14697,56540,67479,2875,99206
8600000US99207,22378,10735,11643,38071,46862,2915,99207
8600000US99208,40841,19571,21270,61525,78035,3464,99208
8600000US99212,16047,8060,7987,53599,70686,5144,99212
8600000US99216,20309,9615,10694,44792,58658,3981,99216
8600000US99217,13447,6493,6954,51211,71049,5743,99217
8600000US99218,13016,5865,7151,45405,68213,6461,99218
8600000US99223,23942,11361,12581,67539,95242,6219,99223
8600000US99224,16706,8303,8403,64966,90698,5982,99224
8600000US99301,52601,26828,25773,63020,78325,3480,99301
8600000US99320,7570,3959,3611,60984,70737,4338,99320
8600000US99321,357,222,135,,,,99321
8600000US99322,160,76,84,51250,71951,15397,99322
8600000US99323,2933,1518,1415,77891,93203,9278,99323
8600000US99324,7777,3765,4012,50402,62925,5787,99324
8600000US99326,4688,3254,1434,55949,62703,8752,99326
8600000US99328,2956,1425,1531,51556,71037,7498,99328
8600000US99329,113,57,56,57708,55225,13063,99329
8600000US99330,645,266,379,50296,43515,13154,99330
8600000US99333,23,18,5,,38307,50117,99333
8600000US99335,208,107,101,50357,51885,10659,99335
8600000US99336,36587,17975,18612,45713,57943,2771,99336
8600000US99337,23140,11618,11522,73047,82693,4065,99337
8600000US99338,11149,5694,5455,106374,127582,8670,99338
8600000US99341,611,300,311,42461,51060,7362,99341
8600000US99343,2124,1086,1038,60766,66199,8367,99343
8600000US99344,11051,5661,5390,53125,62622,4505,99344
8600000US99345,114,60,54,61875,102482,23232,99345
8600000US99346,401,185,216,67850,64372,14554,99346
8600000US99347,1711,808,903,52059,56568,5056,99347
8600000US99348,905,476,429,47823,55545,11998,99348
8600000US99349,5442,2757,2685,56195,66314,6230,99349
8600000US99350,10184,4957,5227,59017,71889,7207,99350
8600000US99352,24434,11752,12682,78560,101308,5192,99352
8600000US99353,11008,5496,5512,94233,105833,5219,99353
8600000US99354,17086,8598,8488,69171,88654,3816,99354
8600000US99356,193,106,87,61250,73256,18535,99356
8600000US99357,3035,1857,1178,48854,65135,9551,99357
8600000US99359,138,86,52,35208,53014,22672,99359
8600000US99360,1206,599,607,81343,112668,33640,99360
8600000US99361,1458,731,727,58672,74498,10479,99361
8600000US99362,32910,16994,15916,54849,73791,4074,99362
8600000US99363,153,69,84,38125,32033,9849,99363
8600000US99371,309,137,172,50313,55497,8907,99371
8600000US99401,253,158,95,63804,73053,24107,99401
8600000US99402,1334,592,742,55469,72459,14727,99402
8600000US99403,16141,7773,8368,49559,64460,3707,99403
8600000US99501,14100,7253,6847,57920,89427,9093,99501
8600000US99502,18188,9058,9130,84080,110319,7028,99502
8600000US99503,11013,5876,5137,51604,64509,3952,99503
8600000US99504,31471,16567,14904,78508,92813,4237,99504
8600000US99505,4001,2670,1331,63125,79444,10011,99505
8600000US99506,4914,2785,2129,56869,65454,4882,99506
8600000US99507,29220,14578,14642,85686,111114,5040,99507
8600000US99508,26795,13170,13625,66723,84671,5116,99508
8600000US99510,949,836,113,,,,99510
8600000US99513,0,0,0,,,,99513
8600000US99515,17485,8243,9242,104677,128553,14529,99515
8600000US99516,15429,7481,7948,155637,188894,10513,99516
8600000US99517,13208,6289,6919,77274,100217,5073,99517
8600000US99518,8134,4415,3719,84773,106130,10862,99518
8600000US99519,469,412,57,,,,99519
8600000US99540,252,179,73,103750,98008,39979,99540
8600000US99546,136,70,66,71667,84960,22741,99546
8600000US99547,27,14,13,51875,65385,26232,99547
8600000US99548,41,20,21,32083,40652,15199,99548
8600000US99549,59,38,21,51250,93778,70133,99549
8600000US99550,166,85,81,42917,63929,13785,99550
8600000US99551,339,172,167,38438,50106,6868,99551
8600000US99552,225,123,102,47917,50375,9258,99552
8600000US99553,739,490,249,31250,49295,9446,99553
8600000US99554,471,229,242,36250,50155,7734,99554
8600000US99555,144,78,66,53750,65073,13335,99555
8600000US99556,2125,1153,972,54694,69511,5305,99556
8600000US99557,477,267,210,48958,61182,5871,99557
8600000US99558,70,49,21,43125,52911,16183,99558
8600000US99559,5272,2689,2583,82417,92563,6470,99559
8600000US99561,305,158,147,53750,61624,7818,99561
8600000US99563,747,441,306,38250,44098,9105,99563
8600000US99564,47,25,22,44750,53360,13073,99564
8600000US99565,58,37,21,71250,89058,22921,99565
8600000US99566,79,40,39,16400,27052,12345,99566
8600000US99567,6684,3473,3211,111161,115273,12875,99567
8600000US99568,270,155,115,42604,67689,17149,99568
8600000US99569,32,18,14,18750,26329,11776,99569
8600000US99571,121,76,45,79375,81291,14520,99571
8600000US99572,402,216,186,82734,85098,18155,99572
8600000US99573,399,206,193,47000,65623,14136,99573
8600000US99574,2535,1314,1221,85833,101028,13890,99574
8600000US99575,64,35,29,35625,49761,12934,99575
8600000US99576,1765,912,853,73500,87690,6460,99576
8600000US99577,20188,10448,9740,109936,123572,7343,99577
8600000US99578,310,159,151,38750,47593,7129,99578
8600000US99579,72,57,15,41250,50933,26442,99579
8600000US99580,59,23,36,31875,36580,7025,99580
8600000US99581,480,266,214,40938,53697,6363,99581
8600000US99583,60,41,19,,83244,19785,99583
8600000US99585,178,88,90,29643,48154,12721,99585
8600000US99586,239,139,100,25781,52598,20101,99586
8600000US99587,1726,971,755,105433,123016,22344,99587
8600000US99588,512,306,206,64821,87508,17273,99588
8600000US99589,118,52,66,35000,52296,12585,99589
8600000US99590,112,52,60,28125,32047,9915,99590
8600000US99591,62,34,28,56875,72419,14476,99591
8600000US99602,135,84,51,34375,44257,9388,99602
8600000US99603,8135,3941,4194,63705,81924,4035,99603
8600000US99604,579,285,294,31528,43503,8723,99604
8600000US99605,84,25,59,,110185,68431,99605
8600000US99606,230,125,105,40938,57421,9736,99606
8600000US99607,127,61,66,33125,44188,14786,99607
8600000US99609,348,182,166,44583,47426,5540,99609
8600000US99610,1480,810,670,64643,69452,10124,99610
8600000US99611,11721,6201,5520,61401,82319,7339,99611
8600000US99612,915,531,384,75000,77536,6778,99612
8600000US99613,339,204,135,95500,104176,12129,99613
8600000US99614,385,204,181,36250,42103,4383,99614
8600000US99615,9525,5163,4362,81633,92020,8323,99615
8600000US99620,485,261,224,38750,45952,6996,99620
8600000US99621,411,215,196,42917,50712,9268,99621
8600000US99622,220,109,111,51875,55984,8028,99622
8600000US99624,45,22,23,,61136,23708,99624
8600000US99625,48,27,21,23958,34865,10596,99625
8600000US99626,174,90,84,32813,41445,6741,99626
8600000US99627,217,108,109,49250,61813,12510,99627
8600000US99628,599,334,265,39773,51360,6998,99628
8600000US99630,162,90,72,30000,49835,7676,99630
8600000US99631,311,170,141,75469,102060,34733,99631
8600000US99632,533,328,205,33542,45496,4735,99632
8600000US99633,367,217,150,74167,95301,10478,99633
8600000US99634,270,131,139,26607,34441,5040,99634
8600000US99636,344,172,172,38929,48602,6203,99636
8600000US99637,340,177,163,45893,57345,6887,99637
8600000US99638,19,10,9,36250,41867,21846,99638
8600000US99639,828,477,351,52188,65721,7687,99639
8600000US99640,120,63,57,37917,50125,8879,99640
8600000US99641,521,288,233,36786,45278,7141,99641
8600000US99643,186,89,97,31563,56048,17078,99643
8600000US99644,153,64,89,37917,63492,28097,99644
8600000US99645,22374,11646,10728,80963,96658,2084,99645
8600000US99647,20,12,8,52917,47944,15017,99647
8600000US99648,63,36,27,33750,37246,8728,99648
8600000US99649,72,30,42,46250,55613,12915,99649
8600000US99650,327,169,158,29688,44971,9121,99650
8600000US99651,13,8,5,,47033,33185,99651
8600000US99652,2583,1341,1242,56613,71099,5277,99652
8600000US99653,75,34,41,86250,100022,21839,99653
8600000US99654,44456,23334,21122,80471,93854,2728,99654
8600000US99655,520,273,247,33194,47948,5642,99655
8600000US99656,20,8,12,75833,61775,24389,99656
8600000US99657,184,99,85,35000,46052,14177,99657
8600000US99658,487,262,225,42969,50992,6568,99658
8600000US99659,247,128,119,42917,53956,8548,99659
8600000US99660,348,222,126,60833,70277,15369,99660
8600000US99661,1102,598,504,69688,88533,7053,99661
8600000US99662,307,165,142,30417,42245,7523,99662
8600000US99663,324,173,151,64286,75859,8962,99663
8600000US99664,3705,2246,1459,73056,79567,7498,99664
8600000US99665,57,39,18,,28777,11465,99665
8600000US99666,100,55,45,31250,36615,8884,99666
8600000US99667,81,42,39,82500,84880,33631,99667
8600000US99668,59,33,26,46250,56127,17933,99668
8600000US99669,12473,6312,6161,77528,96237,7917,99669
8600000US99670,39,25,14,38750,73750,39756,99670
8600000US99671,296,176,120,38000,43124,6620,99671
8600000US99672,2696,1427,1269,78241,85524,12164,99672
8600000US99674,1182,568,614,42431,60879,6693,99674
8600000US99676,1019,516,503,63542,68021,8671,99676
8600000US99677,71,28,43,75833,75580,30581,99677
8600000US99678,496,289,207,34583,51306,5447,99678
8600000US99679,255,159,96,27679,39901,6856,99679
8600000US99680,323,175,148,30893,39725,7044,99680
8600000US99681,210,119,91,34750,47103,10230,99681
8600000US99682,387,258,129,38750,64706,25290,99682
8600000US99683,381,232,149,43839,56449,10446,99683
8600000US99684,547,271,276,70875,82782,17688,99684
8600000US99685,3824,2334,1490,93008,109761,5559,99685
8600000US99686,2896,1555,1341,95847,105602,17476,99686
8600000US99688,2021,1117,904,46094,62746,5398,99688
8600000US99689,478,267,211,65833,73088,5348,99689
8600000US99690,115,56,59,46875,43105,9750,99690
8600000US99691,101,69,32,34167,41250,11620,99691
8600000US99692,169,91,78,76458,86495,8216,99692
8600000US99693,227,112,115,54375,64089,8721,99693
8600000US99694,1228,591,637,51786,62881,5216,99694
8600000US99695,0,0,0,,,,99695
8600000US99701,13817,7162,6655,58176,76249,4315,99701
8600000US99702,2156,1362,794,62243,75205,7065,99702
8600000US99703,6059,3921,2138,54225,79148,11473,99703
8600000US99704,39,23,16,,,,99704
8600000US99705,16898,9191,7707,81235,95442,5278,99705
8600000US99706,1,0,1,,,,99706
8600000US99709,23431,12596,10835,88121,101738,5525,99709
8600000US99712,11040,5981,5059,86122,113540,14447,99712
8600000US99714,942,509,433,70357,85882,8291,99714
8600000US99720,127,79,48,24792,36067,7208,99720
8600000US99721,155,84,71,57143,68564,8189,99721
8600000US99722,99,50,49,29688,35951,7121,99722
8600000US99723,2878,1544,1334,83205,100440,14193,99723
8600000US99724,43,26,17,,31232,12539,99724
8600000US99726,77,50,27,85625,97282,41063,99726
8600000US99727,374,213,161,41591,67558,13455,99727
8600000US99729,173,89,84,60536,74042,18483,99729
8600000US99730,49,24,25,,50726,24741,99730
8600000US99732,13,6,7,,,,99732
8600000US99733,42,22,20,,38044,17070,99733
8600000US99734,1458,1159,299,,,,99734
8600000US99736,100,57,43,41667,47548,12740,99736
8600000US99737,3543,2090,1453,79107,85981,6154,99737
8600000US99738,97,47,50,31250,40112,9895,99738
8600000US99739,183,105,78,43438,49548,6762,99739
8600000US99740,380,215,165,38125,53170,6904,99740
8600000US99741,368,184,184,67813,77712,7972,99741
8600000US99742,394,222,172,37917,48385,6049,99742
8600000US99743,844,403,441,87000,93408,9990,99743
8600000US99744,83,49,34,104167,103492,15708,99744
8600000US99745,66,41,25,32917,37700,10132,99745
8600000US99746,241,116,125,39688,49734,6697,99746
8600000US99747,114,66,48,57188,76140,11934,99747
8600000US99748,150,87,63,31250,49471,12066,99748
8600000US99749,183,99,84,46875,62876,15410,99749
8600000US99750,422,218,204,51250,67889,14305,99750
8600000US99751,75,41,34,53750,59210,15115,99751
8600000US99752,2388,1310,1078,84559,100608,7128,99752
8600000US99753,147,74,73,36786,42218,6380,99753
8600000US99754,51,25,26,16500,35824,9272,99754
8600000US99755,840,398,442,81667,95781,41168,99755
8600000US99756,62,28,34,61250,80800,21501,99756
8600000US99757,14,7,7,,49314,23655,99757
8600000US99758,158,85,73,35625,48109,11222,99758
8600000US99759,127,72,55,63750,74975,12596,99759
8600000US99760,413,206,207,56458,71474,9376,99760
8600000US99761,267,141,126,53333,67227,16768,99761
8600000US99762,2964,1587,1377,80434,93499,5642,99762
8600000US99763,351,209,142,48125,61414,8331,99763
8600000US99764,262,158,104,55833,61487,16728,99764
8600000US99765,200,90,110,42321,46986,7091,99765
8600000US99766,363,212,151,64000,78666,16646,99766
8600000US99767,29,12,17,,55325,19602,99767
8600000US99768,124,55,69,29250,38904,6280,99768
8600000US99769,560,301,259,41875,51138,6320,99769
8600000US99770,477,275,202,35938,43893,7411,99770
8600000US99771,177,88,89,57188,67158,10113,99771
8600000US99772,372,196,176,38636,53525,9829,99772
8600000US99773,163,86,77,38333,55415,13962,99773
8600000US99774,9,7,2,,10943,9888,99774
8600000US99775,1294,748,546,46096,47453,13979,99775
8600000US99776,119,61,58,26250,39727,11078,99776
8600000US99777,187,100,87,40000,51549,9767,99777
8600000US99778,162,103,59,27083,41300,8355,99778
8600000US99780,1137,565,572,61316,72325,9127,99780
8600000US99781,104,53,51,32500,41874,13195,99781
8600000US99782,321,189,132,66563,75292,8023,99782
8600000US99783,99,65,34,35000,41573,11343,99783
8600000US99784,134,65,69,51875,49027,10608,99784
8600000US99785,239,116,123,40000,49688,8174,99785
8600000US99786,201,95,106,43214,64877,9709,99786
8600000US99788,91,59,32,25313,34805,12624,99788
8600000US99789,315,144,171,80000,91777,15328,99789
8600000US99790,10,6,4,,,,99790
8600000US99791,101,54,47,83125,81943,17372,99791
8600000US99801,23582,11975,11607,89005,108327,8360,99801
8600000US99820,435,254,181,44375,76402,20735,99820
8600000US99824,1766,920,846,76713,98432,8163,99824
8600000US99825,63,32,31,66250,95928,35562,99825
8600000US99826,363,172,191,80000,85948,10106,99826
8600000US99827,2006,1101,905,63882,75810,9658,99827
8600000US99829,649,355,294,63750,72278,5033,99829
8600000US99830,473,270,203,53625,54618,4543,99830
8600000US99832,121,49,72,93125,87327,18657,99832
8600000US99833,2521,1285,1236,66907,87391,7903,99833
8600000US99835,6799,3429,3370,71534,89940,5785,99835
8600000US99836,67,28,39,69375,67491,18369,99836
8600000US99840,876,477,399,72237,83881,4565,99840
8600000US99841,125,73,52,55833,67688,20609,99841
8600000US99901,10738,5542,5196,70356,86145,3943,99901
8600000US99903,0,0,0,,,,99903
8600000US99918,139,72,67,55500,65135,16795,99918
8600000US99919,547,302,245,51875,65140,9946,99919
8600000US99921,1542,875,667,58571,75958,5104,99921
8600000US99922,232,123,109,34028,47619,7839,99922
8600000US99923,15,0,15,,,,99923
8600000US99925,707,391,316,57375,67353,6335,99925
8600000US99926,1162,617,545,53409,65971,6951,99926
8600000US99927,38,20,18,,18114,13060,99927
8600000US99929,1991,1043,948,57583,70025,6013,99929
